county,administered_date,total_doses,cumulative_total_doses,pfizer_doses,cumulative_pfizer_doses,moderna_doses,cumulative_moderna_doses,jj_doses,cumulative_jj_doses,partially_vaccinated,total_partially_vaccinated,fully_vaccinated,cumulative_fully_vaccinated,at_least_one_dose,cumulative_at_least_one_dose,california_flag
All CA Counties,2020-12-15,1242,1242,1242,1242,0,0,0,0,1242,1242,0,0,1242,1242,
All CA Counties,2020-12-16,9144,10386,9144,10386,0,0,0,0,9144,10386,0,0,9144,10386,
All CA Counties,2020-12-17,27517,37903,27517,37903,0,0,0,0,27519,37905,0,0,27519,37905,
All CA Counties,2020-12-18,46242,84145,46164,84067,78,78,0,0,46242,84146,1,1,46242,84147,
All CA Counties,2020-12-19,25864,110009,25832,109899,32,110,0,0,25861,110004,3,4,25861,110008,
All CA Counties,2020-12-20,19350,129359,19295,129194,55,165,0,0,19348,129350,2,6,19348,129356,
All CA Counties,2020-12-21,50495,179854,50379,179573,116,281,0,0,50495,179842,4,10,50496,179852,
All CA Counties,2020-12-22,50983,230837,48736,228309,2247,2528,0,0,50973,230805,10,20,50973,230825,
All CA Counties,2020-12-23,51505,282342,42436,270745,9069,11597,0,0,51498,282299,7,27,51501,282326,
All CA Counties,2020-12-24,24401,306743,16504,287249,7897,19494,0,0,24394,306689,6,33,24396,306722,
All CA Counties,2020-12-25,2418,309161,2081,289330,337,19831,0,0,2417,309105,1,34,2417,309139,
All CA Counties,2020-12-26,14849,324010,9576,298906,5273,25104,0,0,14847,323950,2,36,14847,323986,
All CA Counties,2020-12-27,9623,333633,5679,304585,3944,29048,0,0,9620,333567,3,39,9620,333606,
All CA Counties,2020-12-28,46923,380556,30025,334610,16898,45946,0,0,46915,380474,8,47,46915,380521,
All CA Counties,2020-12-29,53014,433570,29721,364331,23293,69239,0,0,53007,433476,5,52,53007,433528,
All CA Counties,2020-12-30,64776,498346,36672,401003,28104,97343,0,0,64764,498233,10,62,64767,498295,
All CA Counties,2020-12-31,30024,528370,11082,412085,18942,116285,0,0,29999,528211,22,84,30000,528295,
All CA Counties,2021-01-01,5851,534221,2752,414837,3099,119384,0,0,5829,534029,11,95,5829,534124,
All CA Counties,2021-01-02,18781,553002,10382,425219,8399,127783,0,0,18770,552797,2,97,18770,552894,
All CA Counties,2021-01-03,6363,559365,3575,428794,2788,130571,0,0,6330,559115,12,109,6330,559224,
All CA Counties,2021-01-04,44341,603706,22332,451126,22009,152580,0,0,44253,603326,42,151,44253,603477,
All CA Counties,2021-01-05,57698,661404,30520,481646,27178,179758,0,0,51740,649291,5887,6038,51852,655329,
All CA Counties,2021-01-06,74907,736311,41474,523120,33433,213191,0,0,58392,691424,16320,22358,58453,713782,
All CA Counties,2021-01-07,94296,830607,53814,576934,40482,253673,0,0,61767,720924,32343,54701,61843,775625,
All CA Counties,2021-01-08,109383,939990,65824,642758,43559,297232,0,0,66209,744225,43014,97715,66315,841940,
All CA Counties,2021-01-09,45180,985170,26026,668784,19154,316386,0,0,28240,755593,16910,114625,28278,870218,
All CA Counties,2021-01-10,24740,1009910,15107,683891,9633,326019,0,0,13339,757579,11378,126003,13364,883582,
All CA Counties,2021-01-11,106434,1116344,70920,754811,35514,361533,0,0,61568,774542,44808,170811,61771,945353,
All CA Counties,2021-01-12,115952,1232296,68742,823553,47210,408743,0,0,73663,806304,42200,213011,73962,1019315,
All CA Counties,2021-01-13,121268,1353564,63043,886596,58225,466968,0,0,86783,858826,34380,247391,86902,1106217,
All CA Counties,2021-01-14,126437,1480001,50791,937387,75646,542614,0,0,106210,945163,20097,267488,106434,1212651,
All CA Counties,2021-01-15,144216,1624217,52650,990037,91566,634180,0,0,128653,1058654,15431,282919,128922,1341573,
All CA Counties,2021-01-16,82170,1706387,27804,1017841,54366,688546,0,0,74280,1125134,7856,290775,74336,1415909,
All CA Counties,2021-01-17,48495,1754882,16887,1034728,31608,720154,0,0,44550,1165796,3932,294707,44594,1460503,
All CA Counties,2021-01-18,89299,1844181,46617,1081345,42682,762836,0,0,69486,1215760,19733,314440,69697,1530200,
All CA Counties,2021-01-19,144524,1988705,74805,1156150,69719,832555,0,0,111998,1295688,32413,346853,112341,1642541,
All CA Counties,2021-01-20,165442,2154147,85329,1241479,80113,912668,0,0,130468,1391747,34705,381558,130764,1773305,
All CA Counties,2021-01-21,178293,2332440,79764,1321243,98529,1011197,0,0,157906,1529966,20128,401686,158347,1931652,
All CA Counties,2021-01-22,172650,2505090,70419,1391662,102231,1113428,0,0,157633,1672909,14864,416550,157807,2089459,
All CA Counties,2021-01-23,113139,2618229,49728,1441390,63411,1176839,0,0,100355,1760690,12713,429263,100494,2189953,
All CA Counties,2021-01-24,62006,2680235,29625,1471015,32381,1209220,0,0,57213,1813232,4752,434015,57294,2247247,
All CA Counties,2021-01-25,147805,2828040,66449,1537464,81356,1290576,0,0,111617,1889253,36022,470037,112043,2359290,
All CA Counties,2021-01-26,172043,3000083,84361,1621825,87682,1378258,0,0,133134,1983944,38744,508781,133435,2492725,
All CA Counties,2021-01-27,185808,3185891,89155,1710980,96653,1474911,0,0,144914,2088613,40547,549328,145216,2637941,
All CA Counties,2021-01-28,192164,3378055,88513,1799493,103651,1578562,0,0,156647,2210406,35182,584510,156975,2794916,
All CA Counties,2021-01-29,187495,3565550,89606,1889099,97889,1676451,0,0,151444,2326731,35395,619905,151720,2946636,
All CA Counties,2021-01-30,126350,3691900,56156,1945255,70194,1746645,0,0,110406,2421643,15753,635658,110665,3057301,
All CA Counties,2021-01-31,71082,3762982,39351,1984606,31731,1778376,0,0,65893,2482496,5113,640771,65966,3123267,
All CA Counties,2021-02-01,165293,3928275,77071,2061677,88222,1866598,0,0,122985,2563580,42055,682826,123139,3246406,
All CA Counties,2021-02-02,189099,4117374,79696,2141373,109403,1976001,0,0,143126,2661359,45599,728425,143378,3389784,
All CA Counties,2021-02-03,214172,4331546,96594,2237967,117578,2093579,0,0,158071,2764239,55531,783956,158411,3548195,
All CA Counties,2021-02-04,231641,4563187,101134,2339101,130507,2224086,0,0,169052,2871799,61968,845924,169528,3717723,
All CA Counties,2021-02-05,250273,4813460,107206,2446307,143067,2367153,0,0,169207,2961550,80153,926077,169904,3887627,
All CA Counties,2021-02-06,157607,4971067,75430,2521737,82177,2449330,0,0,122017,3048816,35345,961422,122611,4010238,
All CA Counties,2021-02-07,67865,5038932,43877,2565614,23988,2473318,0,0,51039,3083617,16714,978136,51515,4061753,
All CA Counties,2021-02-08,184261,5223193,90479,2656093,93782,2567100,0,0,121176,3143044,62543,1040679,121970,4183723,
All CA Counties,2021-02-09,214775,5437968,103573,2759666,111202,2678302,0,0,127885,3185920,86315,1126994,129191,4312914,
All CA Counties,2021-02-10,253044,5691012,121520,2881186,131524,2809826,0,0,138610,3212632,113475,1240469,140187,4453101,
All CA Counties,2021-02-11,270220,5961232,133288,3014474,136932,2946758,0,0,145631,3236899,123256,1363725,147523,4600624,
All CA Counties,2021-02-12,277700,6238932,121310,3135784,156390,3103148,0,0,149261,3261197,127394,1491119,151692,4752316,
All CA Counties,2021-02-13,170159,6409091,78522,3214306,91637,3194785,0,0,93422,3280339,76276,1567395,95418,4847734,
All CA Counties,2021-02-14,97060,6506151,48276,3262582,48784,3243569,0,0,52094,3289296,44741,1612136,53698,4901432,
All CA Counties,2021-02-15,145118,6651269,63615,3326197,81503,3325072,0,0,79763,3307392,64859,1676995,82955,4984387,
All CA Counties,2021-02-16,253648,6904917,120338,3446535,133310,3458382,0,0,134560,3326534,118563,1795558,137705,5122092,
All CA Counties,2021-02-17,264139,7169056,131480,3578015,132659,3591041,0,0,130307,3326991,133087,1928645,133544,5255636,
All CA Counties,2021-02-18,278476,7447532,145287,3723302,133189,3724230,0,0,133534,3320832,143970,2072615,137811,5393447,
All CA Counties,2021-02-19,259516,7707048,150404,3873706,109112,3833342,0,0,132768,3329682,125975,2198590,134825,5528272,
All CA Counties,2021-02-20,158817,7865865,101384,3975090,57433,3890775,0,0,86061,3345484,72342,2270932,88144,5616416,
All CA Counties,2021-02-21,88560,7954425,71394,4046484,17166,3907941,0,0,44688,3348346,43495,2314427,46357,5662773,
All CA Counties,2021-02-22,175019,8129444,117171,4163655,57848,3965789,0,0,86294,3348355,88103,2402530,88112,5750885,
All CA Counties,2021-02-23,239341,8368785,126431,4290086,112910,4078699,0,0,110036,3336184,128286,2530816,116115,5867000,
All CA Counties,2021-02-24,298385,8667170,151105,4441191,147280,4225979,0,0,139919,3326383,157405,2688221,147604,6014604,
All CA Counties,2021-02-25,338751,9005921,167559,4608750,171192,4397171,0,0,175474,3348472,162159,2850380,184248,6198852,
All CA Counties,2021-02-26,373276,9379197,174119,4782869,199157,4596328,0,0,205826,3395580,166079,3016459,213187,6412039,
All CA Counties,2021-02-27,266164,9645361,129345,4912214,136783,4733111,36,36,149102,3433118,116098,3132557,153636,6565675,
All CA Counties,2021-02-28,142858,9788219,85020,4997234,57823,4790934,15,51,81664,3457196,60532,3193089,84610,6650285,
All CA Counties,2021-03-01,257141,10045360,136648,5133882,120230,4911164,263,314,147162,3500063,108753,3301842,151620,6801905,
All CA Counties,2021-03-02,306022,10351382,154202,5288084,151765,5062929,55,369,181867,3565721,123363,3425205,189021,6990926,
All CA Counties,2021-03-03,348223,10699605,173087,5461171,175027,5237956,109,478,199890,3625884,147332,3572537,207495,7198421,
All CA Counties,2021-03-04,367880,11067485,186018,5647189,181751,5419707,111,589,213788,3693933,153004,3725541,221053,7419474,
All CA Counties,2021-03-05,354485,11421970,173492,5820681,179813,5599520,1180,1769,217716,3784601,135613,3861154,226281,7645755,
All CA Counties,2021-03-06,265488,11687458,136082,5956763,121429,5720949,7977,9746,163768,3859875,101090,3962244,176364,7822119,
All CA Counties,2021-03-07,135305,11822763,80152,6036915,48155,5769104,6998,16744,82689,3900839,52326,4014570,93290,7915409,
All CA Counties,2021-03-08,227644,12050407,110579,6147494,105929,5875033,11136,27880,148040,3985800,79052,4093622,164013,8079422,
All CA Counties,2021-03-09,299022,12349429,142415,6289909,140175,6015208,16432,44312,166782,4041327,131509,4225131,187036,8266458,
All CA Counties,2021-03-10,331137,12680566,164402,6454311,141778,6156986,24957,69269,178168,4096296,152039,4377170,207008,8473466,
All CA Counties,2021-03-11,384206,13064772,185948,6640259,164392,6321378,33866,103135,196006,4143022,186956,4564126,233682,8707148,
All CA Counties,2021-03-12,402518,13467290,179800,6820059,175958,6497336,46760,149895,196261,4184443,205114,4769240,246535,8953683,
All CA Counties,2021-03-13,288827,13756117,126300,6946359,131021,6628357,31506,181401,155868,4243299,132328,4901568,191184,9144867,
All CA Counties,2021-03-14,157716,13913833,84049,7030408,58488,6686845,15179,196580,78998,4261241,78311,4979879,96253,9241120,
All CA Counties,2021-03-15,295107,14208940,141096,7171504,133163,6820008,20848,217428,159158,4309542,134894,5114773,183195,9424315,
All CA Counties,2021-03-16,375804,14584744,176833,7348337,181365,7001373,17606,235034,215783,4386934,158994,5273767,236386,9660701,
All CA Counties,2021-03-17,391928,14976672,194412,7542749,178659,7180032,18857,253891,241232,4499720,149554,5423321,262340,9923041,
All CA Counties,2021-03-18,408895,15385567,209597,7752346,180707,7360739,18591,272482,239548,4591824,167958,5591279,260062,10183103,
All CA Counties,2021-03-19,417727,15803294,219923,7972269,175763,7536502,22041,294523,239231,4677722,177206,5768485,263104,10446207,
All CA Counties,2021-03-20,300527,16103821,157786,8130055,126576,7663078,16165,310688,188073,4771747,111546,5880031,205571,10651778,
All CA Counties,2021-03-21,146839,16250660,101117,8231172,38118,7701196,7604,318292,87386,4809161,58894,5938925,96308,10748086,
All CA Counties,2021-03-22,278123,16528783,162020,8393192,104781,7805977,11322,329614,178860,4904102,98199,6037124,193140,10941226,
All CA Counties,2021-03-23,364068,16892851,200831,8594023,151994,7957971,11243,340857,219953,4994897,142931,6180055,233726,11174952,
All CA Counties,2021-03-24,394208,17287059,225489,8819512,155991,8113962,12728,353585,225153,5067272,167478,6347533,239853,11414805,
All CA Counties,2021-03-25,425193,17712252,234373,9053885,175651,8289613,15169,368754,236196,5133386,187337,6534870,253451,11668256,
All CA Counties,2021-03-26,442820,18155072,236236,9290121,190240,8479853,16344,385098,234777,5180814,206418,6741288,253846,11922102,
All CA Counties,2021-03-27,318224,18473296,168872,9458993,137435,8617288,11917,397015,158239,5194242,158902,6900190,172330,12094432,
All CA Counties,2021-03-28,172114,18645410,110659,9569652,57809,8675097,3646,400661,88502,5205739,83002,6983192,94499,12188931,
All CA Counties,2021-03-29,317516,18962926,170198,9739850,138079,8813176,9239,409900,173787,5248742,142649,7125841,185652,12374583,
All CA Counties,2021-03-30,406130,19369056,205348,9945198,182298,8995474,18484,428384,225422,5314694,179614,7305455,245566,12620149,
All CA Counties,2021-03-31,433325,19802381,235124,10180322,175960,9171434,22241,450625,238510,5382928,193416,7498871,261650,12881799,
All CA Counties,2021-04-01,501699,20304080,256267,10436589,203999,9375433,41433,492058,273349,5471785,226275,7725146,315132,13196931,
All CA Counties,2021-04-02,481567,20785647,234225,10670814,203434,9578867,43908,535966,258560,5553839,221411,7946557,303465,13500396,
All CA Counties,2021-04-03,333636,21119283,170109,10840923,121557,9700424,41970,577936,165785,5595187,166996,8113553,208344,13708740,
All CA Counties,2021-04-04,133577,21252860,69713,10910636,44633,9745057,19231,597167,58102,5597248,75043,8188596,77104,13785844,
All CA Counties,2021-04-05,360411,21613271,184962,11095598,134725,9879782,40724,637891,175370,5631238,184075,8372671,218065,14003909,
All CA Counties,2021-04-06,464507,22077778,235181,11330779,162967,10042749,66359,704250,223640,5682971,239639,8612310,291372,14295281,
All CA Counties,2021-04-07,479954,22557732,249123,11579902,159937,10202686,70894,775144,231798,5739226,246890,8859200,303145,14598426,
All CA Counties,2021-04-08,506509,23064241,255364,11835266,165589,10368275,85556,860700,237707,5796630,267261,9126461,324665,14923091,
All CA Counties,2021-04-09,502362,23566603,249808,12085074,171393,10539668,81161,941861,230309,5839756,270662,9397123,313788,15236879,
All CA Counties,2021-04-10,374360,23940963,170651,12255725,128226,10667894,75483,1017344,157160,5858288,216219,9613342,234751,15471630,
All CA Counties,2021-04-11,190192,24131155,106300,12362025,49206,10717100,34686,1052030,78313,5862407,111398,9724740,115517,15587147,
All CA Counties,2021-04-12,345407,24476562,177245,12539270,129275,10846375,38887,1090917,158947,5878354,185211,9909951,201158,15788305,
All CA Counties,2021-04-13,439207,24915769,245765,12785035,192459,11038834,983,1091900,244043,5932581,193840,10103791,248067,16036372,
All CA Counties,2021-04-14,459308,25375077,257784,13042819,201188,11240022,336,1092236,238087,5955824,219720,10323511,242963,16279335,
All CA Counties,2021-04-15,498664,25873741,290213,13333032,208094,11448116,357,1092593,276596,6015490,220203,10543714,279869,16559204,
All CA Counties,2021-04-16,484439,26358180,272044,13605076,212062,11660178,333,1092926,256642,6048814,226121,10769835,259445,16818649,
All CA Counties,2021-04-17,348799,26706979,195012,13800088,153715,11813893,72,1092998,197039,6098507,150636,10920471,200329,17018978,
All CA Counties,2021-04-18,163832,26870811,105575,13905663,58224,11872117,33,1093031,83231,6104823,80025,11000496,86341,17105319,
All CA Counties,2021-04-19,324891,27195702,186570,14092233,138207,12010324,114,1093145,151902,6086944,171782,11172278,153903,17259222,
All CA Counties,2021-04-20,420844,27616546,227050,14319283,193694,12204018,100,1093245,206493,6083776,212894,11385172,209726,17468948,
All CA Counties,2021-04-21,444705,28061251,257067,14576350,187316,12391334,322,1093567,212117,6069142,230559,11615731,215925,17684873,
All CA Counties,2021-04-22,462523,28523774,266107,14842457,196311,12587645,105,1093672,205175,6022216,255461,11871192,208535,17893408,
All CA Counties,2021-04-23,455383,28979157,261504,15103961,193773,12781418,106,1093778,205310,5982783,248285,12119477,208852,18102260,
All CA Counties,2021-04-24,332757,29311914,208768,15312729,123784,12905202,205,1093983,168096,5991019,163411,12282888,171647,18273907,
All CA Counties,2021-04-25,152884,29464798,100159,15412888,52642,12957844,83,1094066,81329,6003009,70922,12353810,82912,18356819,
All CA Counties,2021-04-26,309548,29774346,180101,15592989,127848,13085692,1599,1095665,134175,5969246,174089,12527899,140326,18497145,
All CA Counties,2021-04-27,377634,30151980,209615,15802604,161300,13246992,6719,1102384,151503,5905979,224705,12752604,161438,18658583,
All CA Counties,2021-04-28,364797,30516777,210769,16013373,145955,13392947,8073,1110457,149571,5852274,213753,12966357,160048,18818631,
All CA Counties,2021-04-29,375090,30891867,217681,16231054,149333,13542280,8076,1118533,137217,5763180,236283,13202640,147189,18965820,
All CA Counties,2021-04-30,387808,31279675,223330,16454384,155379,13697659,9099,1127632,146947,5682088,239128,13441768,158036,19123856,
All CA Counties,2021-05-01,254676,31534351,162100,16616484,86310,13783969,6266,1133898,92545,5622303,160828,13602596,101043,19224899,
All CA Counties,2021-05-02,118527,31652878,82969,16699453,31622,13815591,3936,1137834,41295,5591184,76713,13679309,45594,19270493,
All CA Counties,2021-05-03,258892,31911770,159365,16858818,90629,13906220,8898,1146732,78052,5499284,179716,13859025,87816,19358309,
All CA Counties,2021-05-04,338071,32249841,207750,17066568,120358,14026578,9963,1156695,99148,5371992,237552,14096577,110260,19468569,
All CA Counties,2021-05-05,343142,32592983,214794,17281362,118159,14144737,10189,1166884,96022,5233710,245571,14342148,107289,19575858,
All CA Counties,2021-05-06,361240,32954223,237373,17518735,113188,14257925,10679,1177563,90701,5069051,268527,14610675,103868,19679726,
All CA Counties,2021-05-07,357375,33311598,224480,17743215,122926,14380851,9969,1187532,96379,4917393,259257,14869932,107599,19787325,
All CA Counties,2021-05-08,237098,33548696,151307,17894522,78728,14459579,7063,1194595,64973,4819910,170979,15040911,73496,19860821,
All CA Counties,2021-05-09,96597,33645293,73110,17967632,20473,14480052,3014,1197609,24985,4777145,71205,15112116,28440,19889261,
All CA Counties,2021-05-10,209946,33855239,120475,18088107,81464,14561516,8007,1205616,51487,4680499,157400,15269516,60754,19950015,
All CA Counties,2021-05-11,279418,34134657,159977,18248084,110661,14672177,8780,1214396,73171,4559226,205055,15474571,83782,20033797,
All CA Counties,2021-05-12,275937,34410594,160619,18408703,106073,14778250,9245,1223641,73587,4442298,201024,15675595,84096,20117893,
All CA Counties,2021-05-13,322067,34732661,207669,18616372,106901,14885151,7497,1231138,120657,4373157,200042,15875637,130901,20248794,
All CA Counties,2021-05-14,345697,35078358,221405,18837777,115255,15000406,9037,1240175,134254,4308599,209937,16085574,145379,20394173,
All CA Counties,2021-05-15,284167,35362525,198376,19036153,79693,15080099,6098,1246273,116774,4266224,166275,16251849,123900,20518073,
All CA Counties,2021-05-16,142866,35505391,109555,19145708,30330,15110429,2981,1249254,58171,4243674,84126,16335975,61576,20579649,
All CA Counties,2021-05-17,242771,35748162,159675,19305383,75579,15186008,7517,1256771,95715,4201814,145985,16481960,104125,20683774,
All CA Counties,2021-05-18,284661,36032823,173421,19478804,103731,15289739,7509,1264280,110568,4148515,172803,16654763,119504,20803278,
All CA Counties,2021-05-19,279047,36311870,174109,19652913,97250,15386989,7688,1271968,113750,4107036,164037,16818800,122558,20925836,
All CA Counties,2021-05-20,268404,36580274,160487,19813400,99623,15486612,8294,1280262,102016,4053861,165030,16983830,111855,21037691,
All CA Counties,2021-05-21,286996,36867270,176435,19989835,102460,15589072,8101,1288363,107652,3993030,177835,17161665,117004,21154695,
All CA Counties,2021-05-22,207595,37074865,137547,20127382,63774,15652846,6274,1294637,88105,3970045,118524,17280189,95539,21250234,
All CA Counties,2021-05-23,91234,37166099,63462,20190844,25062,15677908,2710,1297347,38843,3960091,51910,17332099,41956,21292190,
All CA Counties,2021-05-24,173715,37339814,101945,20292789,63342,15741250,8428,1305775,65581,3927788,107154,17439253,74851,21367041,
All CA Counties,2021-05-25,192568,37532382,112988,20405777,71403,15812653,8177,1313952,72674,3891110,118650,17557903,81972,21449013,
All CA Counties,2021-05-26,186943,37719325,107461,20513238,71494,15884147,7988,1321940,72339,3858779,113360,17671263,81029,21530042,
All CA Counties,2021-05-27,174324,37893649,99667,20612905,66089,15950236,8568,1330508,69721,3834536,103606,17774869,79363,21609405,
All CA Counties,2021-05-28,192010,38085659,110814,20723719,73953,16024189,7243,1337751,82521,3817110,108320,17883189,90894,21700299,
All CA Counties,2021-05-29,108298,38193957,66495,20790214,37930,16062119,3873,1341624,50187,3814247,57447,17940636,54584,21754883,
All CA Counties,2021-05-30,47558,38241515,31402,20821616,13674,16075793,2482,1344106,20705,3811111,26539,17967175,23403,21778286,
All CA Counties,2021-05-31,20205,38261720,11935,20833551,7276,16083069,994,1345100,6564,3805383,13398,17980573,7670,21785956,
All CA Counties,2021-06-01,170802,38432522,99610,20933161,63928,16146997,7264,1352364,60152,3764261,109395,18089968,68273,21854229,
All CA Counties,2021-06-02,144815,38577337,85730,21018891,51868,16198865,7217,1359581,54562,3737504,89217,18179185,62460,21916689,
All CA Counties,2021-06-03,173362,38750699,118576,21137467,47600,16246465,7186,1366767,52466,3678250,119936,18299121,60682,21977371,
All CA Counties,2021-06-04,202534,38953233,142667,21280134,53584,16300049,6283,1373050,60466,3606043,140820,18439941,68613,22045984,
All CA Counties,2021-06-05,159296,39112529,120199,21400333,33399,16333448,5698,1378748,43893,3542087,114540,18554481,50584,22096568,
All CA Counties,2021-06-06,64507,39177036,54354,21454687,7916,16341364,2237,1380985,16905,3514803,47263,18601744,19979,22116547,
All CA Counties,2021-06-07,138227,39315263,101464,21556151,30776,16372140,5987,1386972,40895,3465795,96607,18698351,47599,22164146,
All CA Counties,2021-06-08,159346,39474609,115589,21671740,36897,16409037,6860,1393832,47015,3409384,111347,18809698,54936,22219082,
All CA Counties,2021-06-09,153564,39628173,111603,21783343,35119,16444156,6842,1400674,42385,3349255,110276,18919974,50147,22269229,
All CA Counties,2021-06-10,148183,39776356,106599,21889942,34154,16478310,7430,1408104,42722,3295922,104645,19024619,51312,22320541,
All CA Counties,2021-06-11,161635,39937991,113596,22003538,41224,16519534,6815,1414919,50231,3243493,110396,19135015,57967,22378508,
All CA Counties,2021-06-12,116707,40054698,88430,22091968,24501,16544035,3776,1418695,33046,3197970,83047,19218062,37524,22416032,
All CA Counties,2021-06-13,45158,40099856,33704,22125672,9383,16553418,2071,1420766,11181,3177917,33708,19251770,13655,22429687,
All CA Counties,2021-06-14,117106,40216962,83321,22208993,26917,16580335,6868,1427634,38458,3145891,77957,19329727,45931,22475618,
All CA Counties,2021-06-15,133961,40350923,90474,22299467,34604,16614939,8883,1436517,44614,3111961,88326,19418053,54396,22530014,
All CA Counties,2021-06-16,123089,40474012,86815,22386282,28453,16643392,7821,1444338,42357,3083020,79868,19497921,50927,22580941,
All CA Counties,2021-06-17,115907,40589919,80341,22466623,27613,16671005,7953,1452291,40859,3058246,74221,19572142,49447,22630388,
All CA Counties,2021-06-18,130352,40720271,90366,22556989,32429,16703434,7557,1459848,46409,3029983,82967,19655109,54704,22685092,
All CA Counties,2021-06-19,77391,40797662,56266,22613255,17079,16720513,4046,1463894,28664,3015129,48100,19703209,33246,22718338,
All CA Counties,2021-06-20,30931,40828593,23304,22636559,6265,16726778,1362,1465256,11584,3009192,19107,19722316,13170,22731508,
All CA Counties,2021-06-21,72087,40900680,45200,22681759,20796,16747574,6091,1471347,36716,3017643,34930,19757246,43381,22774889,
All CA Counties,2021-06-22,101522,41002202,70828,22752587,24688,16772262,6006,1477353,39249,3001966,61592,19818838,45915,22820804,
All CA Counties,2021-06-23,94866,41097068,66932,22819519,22086,16794348,5848,1483201,38368,2990928,55848,19874686,44810,22865614,
All CA Counties,2021-06-24,92330,41189398,64434,22883953,22211,16816559,5685,1488886,37161,2979890,54440,19929126,43402,22909016,
All CA Counties,2021-06-25,106677,41296075,75479,22959432,25794,16842353,5404,1494290,43303,2966547,62661,19991787,49318,22958334,
All CA Counties,2021-06-26,68939,41365014,52022,23011454,13752,16856105,3165,1497455,28370,2958564,40106,20031893,32123,22990457,
All CA Counties,2021-06-27,31975,41396989,24626,23036080,5794,16861899,1555,1499010,13555,2955714,18197,20050090,15347,23005804,
All CA Counties,2021-06-28,73217,41470206,56692,23092772,12037,16873936,4488,1503498,31872,2951814,40737,20090827,36837,23042641,
All CA Counties,2021-06-29,85588,41555794,60751,23153523,20495,16894431,4342,1507840,36144,2944039,48826,20139653,41051,23083692,
All CA Counties,2021-06-30,81174,41636968,58216,23211739,19024,16913455,3934,1511774,36438,2940946,44044,20183697,40951,23124643,
All CA Counties,2021-07-01,76044,41713012,54789,23266528,17195,16930650,4060,1515834,33444,2936962,42010,20225707,38026,23162669,
All CA Counties,2021-07-02,86537,41799549,61872,23328400,20698,16951348,3967,1519801,38278,2932091,47625,20273332,42754,23205423,
All CA Counties,2021-07-03,47389,41846938,34531,23362931,11105,16962453,1753,1521554,21471,2930130,25506,20298838,23545,23228968,
All CA Counties,2021-07-04,3526,41850464,2064,23364995,1184,16963637,278,1521832,1558,2930094,1927,20300765,1891,23230859,
All CA Counties,2021-07-05,41402,41891866,30705,23395700,9096,16972733,1601,1523433,19097,2929088,22000,20322765,20994,23251853,
All CA Counties,2021-07-06,88424,41980290,64674,23460374,19592,16992325,4158,1527591,33844,2913819,53883,20376648,38614,23290467,
All CA Counties,2021-07-07,74771,42055061,53942,23514316,16683,17009008,4146,1531737,30819,2906026,43355,20420003,35562,23326029,
All CA Counties,2021-07-08,71571,42126632,51380,23565696,16231,17025239,3960,1535697,29676,2898855,41288,20461291,34117,23360146,
All CA Counties,2021-07-09,83808,42210440,59769,23625465,19452,17044691,4587,1540284,35912,2892566,47276,20508567,40987,23401133,
All CA Counties,2021-07-10,52638,42263078,38987,23664452,11105,17055796,2546,1542830,22985,2889198,29259,20537826,25891,23427024,
All CA Counties,2021-07-11,23627,42286705,17674,23682126,4924,17060720,1029,1543859,10985,2888913,12448,20550274,12163,23439187,
All CA Counties,2021-07-12,66654,42353359,49319,23731445,13784,17074504,3551,1547410,27968,2882641,38257,20588531,31985,23471172,
All CA Counties,2021-07-13,70922,42424281,50727,23782172,16926,17091430,3269,1550679,31913,2879802,38487,20627018,35648,23506820,
All CA Counties,2021-07-14,67996,42492277,48887,23831059,15858,17107288,3251,1553930,30338,2876684,37167,20664185,34049,23540869,
All CA Counties,2021-07-15,68519,42560796,50234,23881293,15436,17122724,2849,1556779,31901,2875802,36114,20700299,35232,23576101,
All CA Counties,2021-07-16,83558,42644354,60539,23941832,19613,17142337,3406,1560185,40240,2877147,42779,20743078,44124,23620225,
All CA Counties,2021-07-17,54231,42698585,40043,23981875,12132,17154469,2056,1562241,26229,2878133,27596,20770674,28582,23648807,
All CA Counties,2021-07-18,25776,42724361,19555,24001430,5170,17159639,1051,1563292,12849,2879457,12718,20783392,14042,23662849,
All CA Counties,2021-07-19,67813,42792174,50471,24051901,14213,17173852,3129,1566421,33382,2882448,33955,20817347,36946,23699795,
All CA Counties,2021-07-20,77090,42869264,54983,24106884,18783,17192635,3324,1569745,39236,2888242,37250,20854597,43044,23742839,
All CA Counties,2021-07-21,75064,42944328,54393,24161277,17191,17209826,3480,1573225,38199,2894082,36291,20890888,42131,23784970,
All CA Counties,2021-07-22,75242,43019570,54426,24215703,17462,17227288,3354,1576579,39992,2903200,34628,20925516,43746,23828716,
All CA Counties,2021-07-23,89426,43108996,64310,24280013,21380,17248668,3736,1580315,48678,2916020,40048,20965564,52868,23881584,
All CA Counties,2021-07-24,54758,43163754,39778,24319791,13005,17261673,1975,1582290,30709,2925346,23598,20989162,32924,23914508,
All CA Counties,2021-07-25,24893,43188647,18484,24338275,5774,17267447,635,1582925,18168,2937758,6518,20995680,18930,23933438,
All CA Counties,2021-07-26,69829,43258476,49886,24388161,16752,17284199,3191,1586116,43400,2958798,25869,21021549,46909,23980347,
All CA Counties,2021-07-27,82740,43341216,60101,24448262,19112,17303311,3527,1589643,47718,2976005,34368,21055917,51575,24031922,
All CA Counties,2021-07-28,81524,43422740,58856,24507118,19138,17322449,3530,1593173,48094,2995268,32742,21088659,52005,24083927,
All CA Counties,2021-07-29,79075,43501815,57392,24564510,18203,17340652,3480,1596653,47498,3015787,30831,21119490,51350,24135277,
All CA Counties,2021-07-30,93937,43595752,67857,24632367,22316,17362968,3764,1600417,55485,3038041,37439,21156929,59693,24194970,
All CA Counties,2021-07-31,58110,43653862,42847,24675214,13132,17376100,2131,1602548,34822,3052618,22644,21179573,37221,24232191,
All CA Counties,2021-08-01,29030,43682892,22437,24697651,5877,17381977,716,1603264,18897,3062564,9837,21189410,19783,24251974,
All CA Counties,2021-08-02,77474,43760366,58299,24755950,15996,17397973,3179,1606443,48576,3086379,28243,21217653,52058,24304032,
All CA Counties,2021-08-03,86842,43847208,63710,24819660,19263,17417236,3869,1610312,53039,3110529,33049,21250702,57199,24361231,
All CA Counties,2021-08-04,81827,43929035,60481,24880141,17881,17435117,3465,1613777,50036,3133211,31065,21281767,53747,24414978,
All CA Counties,2021-08-05,83506,44012541,61927,24942068,17781,17452898,3798,1617575,50890,3156351,31817,21313584,54957,24469935,
All CA Counties,2021-08-06,101480,44114021,75021,25017089,22387,17475285,4072,1621647,61038,3182305,39463,21353047,65417,24535352,
All CA Counties,2021-08-07,61936,44175957,46743,25063832,13001,17488286,2192,1623839,37152,3197629,24213,21377260,39537,24574889,
All CA Counties,2021-08-08,33928,44209885,25699,25089531,7360,17495646,869,1624708,21072,3207210,12479,21389739,22060,24596949,
All CA Counties,2021-08-09,84763,44294648,64770,25154301,16498,17512144,3495,1628203,49846,3226708,34164,21423903,53662,24650611,
All CA Counties,2021-08-10,87582,44382230,64880,25219181,19160,17531304,3542,1631745,50316,3244425,36450,21460353,54167,24704778,
All CA Counties,2021-08-11,78572,44460802,58330,25277511,16613,17547917,3629,1635374,44747,3260060,32960,21493313,48595,24753373,
All CA Counties,2021-08-12,85364,44546166,61739,25339250,19638,17567555,3987,1639361,48550,3277083,35733,21529046,52756,24806129,
All CA Counties,2021-08-13,107023,44653189,77615,25416865,25219,17592774,4189,1643550,59789,3295959,45434,21574480,64310,24870439,
All CA Counties,2021-08-14,70063,44723252,51404,25468269,16490,17609264,2169,1645719,37629,3307309,28731,21603211,40081,24910520,
All CA Counties,2021-08-15,36363,44759615,26739,25495008,8770,17618034,854,1646573,19085,3312944,14477,21617688,20112,24930632,
All CA Counties,2021-08-16,93492,44853107,65538,25560546,24406,17642440,3548,1650121,46694,3324052,39478,21657166,50586,24981218,
All CA Counties,2021-08-17,98150,44951257,68454,25629000,25894,17668334,3802,1653923,47105,3332613,42714,21699880,51275,25032493,
All CA Counties,2021-08-18,97529,45048786,67975,25696975,25982,17694316,3572,1657495,45546,3339956,42151,21742031,49494,25081987,
All CA Counties,2021-08-19,97043,45145829,66703,25763678,26410,17720726,3930,1661425,44971,3348004,41174,21783205,49222,25131209,
All CA Counties,2021-08-20,121248,45267077,84767,25848445,32511,17753237,3970,1665395,54418,3353433,53367,21836572,58796,25190005,
All CA Counties,2021-08-21,72709,45339786,53018,25901463,17622,17770859,2069,1667464,32028,3354812,33010,21869582,34389,25224394,
All CA Counties,2021-08-22,40370,45380156,29254,25930717,10336,17781195,780,1668244,18841,3357246,17380,21886962,19814,25244208,
All CA Counties,2021-08-23,101217,45481373,73053,26003770,25052,17806247,3112,1671356,44807,3360484,45379,21932341,48617,25292825,
All CA Counties,2021-08-24,101774,45583147,74981,26078751,23527,17829774,3266,1674622,43616,3360857,47073,21979414,47446,25340271,
All CA Counties,2021-08-25,97171,45680318,71875,26150626,22295,17852069,3001,1677623,42093,3361929,44586,22024000,45658,25385929,
All CA Counties,2021-08-26,97846,45778164,71449,26222075,23065,17875134,3332,1680955,41764,3362779,44737,22068737,45587,25431516,
All CA Counties,2021-08-27,120093,45898257,89199,26311274,27605,17902739,3289,1684244,48913,3357895,57856,22126593,52972,25484488,
All CA Counties,2021-08-28,73187,45971444,55182,26366456,16416,17919155,1589,1685833,29582,3353156,36382,22162975,31643,25516131,
All CA Counties,2021-08-29,40224,46011668,30057,26396513,9634,17928789,533,1686366,16798,3351367,19422,22182397,17633,25533764,
All CA Counties,2021-08-30,59654,46071322,40913,26437426,16156,17944945,2585,1688951,21190,3345739,29698,22212095,24070,25557834,
All CA and Non-CA Counties,2020-12-15,1256,1256,1256,1256,0,0,0,0,1256,1256,0,0,1256,1256,
All CA and Non-CA Counties,2020-12-16,9400,10656,9400,10656,0,0,0,0,9400,10656,0,0,9400,10656,
All CA and Non-CA Counties,2020-12-17,28946,39602,28946,39602,0,0,0,0,28946,39602,0,0,28946,39602,
All CA and Non-CA Counties,2020-12-18,48445,88047,48361,87963,84,84,0,0,48444,88045,1,1,48444,88046,
All CA and Non-CA Counties,2020-12-19,26784,114831,26752,114715,32,116,0,0,26781,114823,3,4,26781,114827,
All CA and Non-CA Counties,2020-12-20,19987,134818,19928,134643,59,175,0,0,19985,134806,2,6,19985,134812,
All CA and Non-CA Counties,2020-12-21,52535,187353,52415,187058,120,295,0,0,52531,187334,4,10,52532,187344,
All CA and Non-CA Counties,2020-12-22,52926,240279,50605,237663,2321,2616,0,0,52916,240240,10,20,52916,240260,
All CA and Non-CA Counties,2020-12-23,52964,293243,43751,281414,9213,11829,0,0,52956,293191,8,28,52959,293219,
All CA and Non-CA Counties,2020-12-24,25174,318417,17086,298500,8088,19917,0,0,25167,318354,6,34,25169,318388,
All CA and Non-CA Counties,2020-12-25,2447,320864,2105,300605,342,20259,0,0,2446,320799,1,35,2446,320834,
All CA and Non-CA Counties,2020-12-26,15150,336014,9773,310378,5377,25636,0,0,15148,335945,2,37,15148,335982,
All CA and Non-CA Counties,2020-12-27,9818,345832,5758,316136,4060,29696,0,0,9815,345757,3,40,9815,345797,
All CA and Non-CA Counties,2020-12-28,48268,394100,30865,347001,17403,47099,0,0,48260,394009,8,48,48260,394057,
All CA and Non-CA Counties,2020-12-29,54550,448650,30691,377692,23859,70958,0,0,54544,448548,5,53,54544,448601,
All CA and Non-CA Counties,2020-12-30,66658,515308,37889,415581,28769,99727,0,0,66646,515187,10,63,66649,515250,
All CA and Non-CA Counties,2020-12-31,31120,546428,11649,427230,19471,119198,0,0,31094,546259,23,86,31095,546345,
All CA and Non-CA Counties,2021-01-01,5980,552408,2785,430015,3195,122393,0,0,5958,552206,11,97,5958,552303,
All CA and Non-CA Counties,2021-01-02,19037,571445,10521,440536,8516,130909,0,0,19025,571228,3,100,19025,571328,
All CA and Non-CA Counties,2021-01-03,6567,578012,3672,444208,2895,133804,0,0,6532,577747,13,113,6532,577860,
All CA and Non-CA Counties,2021-01-04,45498,623510,22850,467058,22648,156452,0,0,45404,623107,44,157,45404,623264,
All CA and Non-CA Counties,2021-01-05,59250,682760,31325,498383,27925,184377,0,0,53108,670260,6069,6226,53222,676486,
All CA and Non-CA Counties,2021-01-06,77423,760183,42923,541306,34500,218877,0,0,60299,713694,16927,23153,60361,736847,
All CA and Non-CA Counties,2021-01-07,98142,858325,56128,597434,42014,260891,0,0,64213,744245,33740,56893,64291,801138,
All CA and Non-CA Counties,2021-01-08,113537,971862,68432,665866,45105,305996,0,0,68710,768409,44657,101550,68821,869959,
All CA and Non-CA Counties,2021-01-09,46424,1018286,26553,692419,19871,325867,0,0,29164,780384,17228,118778,29203,899162,
All CA and Non-CA Counties,2021-01-10,25050,1043336,15295,707714,9755,335622,0,0,13527,782436,11500,130278,13552,912714,
All CA and Non-CA Counties,2021-01-11,109545,1152881,72824,780538,36721,372343,0,0,63415,799983,46072,176350,63619,976333,
All CA and Non-CA Counties,2021-01-12,119660,1272541,70936,851474,48724,421067,0,0,75878,832526,43688,220038,76231,1052564,
All CA and Non-CA Counties,2021-01-13,124770,1397311,64770,916244,60000,481067,0,0,89156,886297,35508,255546,89279,1141843,
All CA and Non-CA Counties,2021-01-14,129983,1527294,52044,968288,77939,559006,0,0,109128,974941,20711,276257,109355,1251198,
All CA and Non-CA Counties,2021-01-15,148203,1675497,53629,1021917,94574,653580,0,0,132194,1091539,15865,292122,132463,1383661,
All CA and Non-CA Counties,2021-01-16,84723,1760220,28203,1050120,56520,710100,0,0,76660,1160228,8027,300149,76716,1460377,
All CA and Non-CA Counties,2021-01-17,49027,1809247,17052,1067172,31975,742075,0,0,45023,1201304,3991,304140,45067,1505444,
All CA and Non-CA Counties,2021-01-18,90493,1899740,47397,1114569,43096,785171,0,0,70234,1251572,20178,324318,70446,1575890,
All CA and Non-CA Counties,2021-01-19,148571,2048311,76145,1190714,72426,857597,0,0,115181,1333823,33276,357594,115527,1691417,
All CA and Non-CA Counties,2021-01-20,169867,2218178,86787,1277501,83080,940677,0,0,133931,1432389,35662,393256,134228,1825645,
All CA and Non-CA Counties,2021-01-21,182398,2400576,80935,1358436,101463,1042140,0,0,161451,1573607,20674,413930,161892,1987537,
All CA and Non-CA Counties,2021-01-22,177132,2577708,71534,1429970,105598,1147738,0,0,161714,1720240,15257,429187,161890,2149427,
All CA and Non-CA Counties,2021-01-23,115319,2693027,50090,1480060,65229,1212967,0,0,102363,1809860,12882,442069,102502,2251929,
All CA and Non-CA Counties,2021-01-24,62567,2755594,29877,1509937,32690,1245657,0,0,57695,1862805,4831,446900,57776,2309705,
All CA and Non-CA Counties,2021-01-25,152170,2907764,68288,1578225,83882,1329539,0,0,115113,1941463,36882,483782,115540,2425245,
All CA and Non-CA Counties,2021-01-26,177693,3085457,86965,1665190,90728,1420267,0,0,137919,2040080,39611,523393,138228,2563473,
All CA and Non-CA Counties,2021-01-27,190527,3275984,91498,1756688,99029,1519296,0,0,148970,2148152,41203,564596,149275,2712748,
All CA and Non-CA Counties,2021-01-28,196943,3472927,90984,1847672,105959,1625255,0,0,160823,2273525,35779,600375,161152,2873900,
All CA and Non-CA Counties,2021-01-29,192112,3665039,92396,1940068,99716,1724971,0,0,155253,2392856,36201,636576,155532,3029432,
All CA and Non-CA Counties,2021-01-30,130368,3795407,58170,1998238,72198,1797169,0,0,114175,2491288,16004,652580,114436,3143868,
All CA and Non-CA Counties,2021-01-31,73802,3869209,41667,2039905,32135,1829304,0,0,68546,2554731,5179,657759,68622,3212490,
All CA and Non-CA Counties,2021-02-01,170722,4039931,79477,2119382,91245,1920549,0,0,127686,2639795,42776,700535,127840,3340330,
All CA and Non-CA Counties,2021-02-02,195709,4235640,81660,2201042,114049,2034598,0,0,148985,2742697,46335,746870,149237,3489567,
All CA and Non-CA Counties,2021-02-03,221335,4456975,98436,2299478,122899,2157497,0,0,164349,2850977,56411,803281,164691,3654258,
All CA and Non-CA Counties,2021-02-04,238289,4695264,103055,2402533,135234,2292731,0,0,174633,2963067,63020,866301,175110,3829368,
All CA and Non-CA Counties,2021-02-05,257003,4952267,109344,2511877,147659,2440390,0,0,174798,3057278,81284,947585,175495,4004863,
All CA and Non-CA Counties,2021-02-06,161792,5114059,77390,2589267,84402,2524792,0,0,125723,3147785,35814,983399,126321,4131184,
All CA and Non-CA Counties,2021-02-07,69833,5183892,45443,2634710,24390,2549182,0,0,52912,3184368,16808,1000207,53391,4184575,
All CA and Non-CA Counties,2021-02-08,188954,5372846,93204,2727914,95750,2644932,0,0,124784,3246328,63619,1063826,125579,4310154,
All CA and Non-CA Counties,2021-02-09,218954,5591800,105364,2833278,113590,2758522,0,0,130704,3290689,87650,1151476,132011,4442165,
All CA and Non-CA Counties,2021-02-10,258320,5850120,123175,2956453,135145,2893667,0,0,141454,3317876,115857,1267333,143044,4585209,
All CA and Non-CA Counties,2021-02-11,274812,6124932,135287,3091740,139525,3033192,0,0,148874,3344073,124587,1391920,150784,4735993,
All CA and Non-CA Counties,2021-02-12,282935,6407867,123191,3214931,159744,3192936,0,0,152591,3369821,129277,1521197,155025,4891018,
All CA and Non-CA Counties,2021-02-13,172522,6580389,79204,3294135,93318,3286254,0,0,95160,3390095,76896,1598093,97170,4988188,
All CA and Non-CA Counties,2021-02-14,98369,6678758,48645,3342780,49724,3335978,0,0,53116,3399797,45020,1643113,54722,5042910,
All CA and Non-CA Counties,2021-02-15,147674,6826432,65097,3407877,82577,3418555,0,0,81030,3417890,66131,1709244,84224,5127134,
All CA and Non-CA Counties,2021-02-16,260064,7086496,122964,3530841,137100,3555655,0,0,137097,3435711,122425,1831669,140246,5267380,
All CA and Non-CA Counties,2021-02-17,269768,7356264,134136,3664977,135632,3691287,0,0,132089,3434120,136922,1968591,135331,5402711,
All CA and Non-CA Counties,2021-02-18,284562,7640826,148556,3813533,136006,3827293,0,0,135470,3425781,148086,2116677,139747,5542458,
All CA and Non-CA Counties,2021-02-19,265010,7905836,154120,3967653,110890,3938183,0,0,135118,3433851,129107,2245784,137177,5679635,
All CA and Non-CA Counties,2021-02-20,161939,8067775,103806,4071459,58133,3996316,0,0,87328,3449073,74189,2319973,89411,5769046,
All CA and Non-CA Counties,2021-02-21,91149,8158924,73726,4145185,17423,4013739,0,0,45571,3451128,45185,2365158,47240,5816286,
All CA and Non-CA Counties,2021-02-22,178591,8337515,119700,4264885,58891,4072630,0,0,87984,3450960,89975,2455133,89807,5906093,
All CA and Non-CA Counties,2021-02-23,245872,8583387,129860,4394745,116012,4188642,0,0,112565,3437423,132195,2587328,118658,6024751,
All CA and Non-CA Counties,2021-02-24,305161,8888548,154642,4549387,150519,4339161,0,0,142511,3426082,161542,2748870,150201,6174952,
All CA and Non-CA Counties,2021-02-25,346126,9234674,171105,4720492,175021,4514182,0,0,178783,3447469,166177,2915047,187564,6362516,
All CA and Non-CA Counties,2021-02-26,380812,9615486,177960,4898452,202852,4717034,0,0,209228,3493949,170110,3085157,216590,6579106,
All CA and Non-CA Counties,2021-02-27,272270,9887756,132260,5030712,139973,4857007,37,37,151210,3529630,120067,3205224,155748,6734854,
All CA and Non-CA Counties,2021-02-28,145396,10033152,86822,5117534,58558,4915565,16,53,82581,3553022,62138,3267362,85530,6820384,
All CA and Non-CA Counties,2021-03-01,262168,10295320,139628,5257162,122275,5037840,265,318,148764,3594086,112164,3379526,153228,6973612,
All CA and Non-CA Counties,2021-03-02,313740,10609060,156912,5414074,156773,5194613,55,373,184318,3656965,128597,3508123,191476,7165088,
All CA and Non-CA Counties,2021-03-03,356676,10965736,176144,5590218,180419,5375032,113,486,202972,3714878,152674,3660797,210587,7375675,
All CA and Non-CA Counties,2021-03-04,375182,11340918,188863,5779081,186200,5561232,119,605,216475,3781042,157588,3818385,223752,7599427,
All CA and Non-CA Counties,2021-03-05,360236,11701154,176204,5955285,182831,5744063,1201,1806,220736,3872045,138327,3956712,229330,7828757,
All CA and Non-CA Counties,2021-03-06,270264,11971418,138204,6093489,123919,5867982,8141,9947,166220,3947623,103405,4060117,178983,8007740,
All CA and Non-CA Counties,2021-03-07,136995,12108413,81120,6174609,48722,5916704,7153,17100,83674,3989034,53025,4113142,94436,8102176,
All CA and Non-CA Counties,2021-03-08,230860,12339273,112484,6287093,106994,6023698,11382,28482,150283,4075543,79993,4193135,166502,8268678,
All CA and Non-CA Counties,2021-03-09,303753,12643026,144855,6431948,142170,6165868,16728,45210,169579,4132243,133428,4326563,190128,8458806,
All CA and Non-CA Counties,2021-03-10,335587,12978613,166540,6598488,143585,6309453,25462,70672,180882,4188702,153763,4480326,210222,8669028,
All CA and Non-CA Counties,2021-03-11,390469,13369082,189141,6787629,166791,6476244,34537,105209,199315,4236465,189894,4670220,237657,8906685,
All CA and Non-CA Counties,2021-03-12,409071,13778153,183741,6971370,177863,6654107,47467,152676,199845,4279211,208069,4878289,250815,9157500,
All CA and Non-CA Counties,2021-03-13,292637,14070790,128485,7099855,132190,6786297,31962,184638,158449,4339879,133547,5011836,194215,9351715,
All CA and Non-CA Counties,2021-03-14,159511,14230301,84986,7184841,59016,6845313,15509,200147,79976,4358313,79119,5090955,97553,9449268,
All CA and Non-CA Counties,2021-03-15,299231,14529532,143267,7328108,134647,6979960,21317,221464,161358,4407373,136801,5227756,185861,9635129,
All CA and Non-CA Counties,2021-03-16,383483,14913015,181264,7509372,184204,7164164,18015,239479,220015,4485973,162419,5390175,241019,9876148,
All CA and Non-CA Counties,2021-03-17,400464,15313479,199918,7709290,181303,7345467,19243,258722,246317,4600787,152992,5543167,267806,10143954,
All CA and Non-CA Counties,2021-03-18,417309,15730788,214792,7924082,183384,7528851,19133,277855,244361,4694655,171544,5714711,265412,10409366,
All CA and Non-CA Counties,2021-03-19,425179,16155967,224350,8148432,178244,7707095,22585,300440,243610,4782419,180264,5894975,268028,10677394,
All CA and Non-CA Counties,2021-03-20,305378,16461345,160978,8309410,128135,7835230,16265,316705,191698,4878962,112754,6007729,209297,10886691,
All CA and Non-CA Counties,2021-03-21,149006,16610351,102600,8412010,38712,7873942,7694,324399,89088,4917705,59354,6067083,98097,10984788,
All CA and Non-CA Counties,2021-03-22,281574,16891925,164107,8576117,106045,7979987,11422,335821,181179,5013941,99317,6166400,195553,11180341,
All CA and Non-CA Counties,2021-03-23,370418,17262343,204083,8780200,154772,8134759,11563,347384,224128,5107088,145071,6311471,238218,11418559,
All CA and Non-CA Counties,2021-03-24,401710,17664053,229339,9009539,159196,8293955,13175,360559,230244,5182602,169872,6481343,245386,11663945,
All CA and Non-CA Counties,2021-03-25,433659,18097712,238284,9247823,179670,8473625,15705,376264,242276,5252966,189701,6671044,260065,11924010,
All CA and Non-CA Counties,2021-03-26,449716,18547428,239846,9487669,193336,8666961,16534,392798,239256,5302674,208803,6879847,258511,12182521,
All CA and Non-CA Counties,2021-03-27,323912,18871340,172039,9659708,139727,8806688,12146,404944,161790,5317752,161028,7040875,176106,12358627,
All CA and Non-CA Counties,2021-03-28,175253,19046593,112328,9772036,59117,8865805,3808,408752,90524,5330326,84108,7124983,96682,12455309,
All CA and Non-CA Counties,2021-03-29,322920,19369513,172622,9944658,140712,9006517,9586,418338,176869,5374446,144962,7269945,189082,12644391,
All CA and Non-CA Counties,2021-03-30,413214,19782727,209059,10153717,185085,9191602,19070,437408,229580,5442233,182525,7452470,250312,12894703,
All CA and Non-CA Counties,2021-03-31,439916,20222643,239055,10392772,177831,9369433,23030,460438,242042,5511724,196465,7648935,265956,13160659,
All CA and Non-CA Counties,2021-04-01,509540,20732183,260958,10653730,206475,9575908,42107,502545,277879,5602473,229569,7878504,320318,13480977,
All CA and Non-CA Counties,2021-04-02,490251,21222434,238848,10892578,206358,9782266,45045,547590,263067,5685998,225569,8104073,309094,13790071,
All CA and Non-CA Counties,2021-04-03,340081,21562515,173963,11066541,122994,9905260,43124,590714,169245,5728974,169972,8274045,212948,14003019,
All CA and Non-CA Counties,2021-04-04,135444,21697959,70636,11137177,45339,9950599,19469,610183,59114,5731423,75894,8349939,78343,14081362,
All CA and Non-CA Counties,2021-04-05,364794,22062753,187100,11324277,136274,10086873,41420,651603,177459,5765906,186355,8536294,220838,14302200,
All CA and Non-CA Counties,2021-04-06,471927,22534680,239186,11563463,164720,10251593,68021,719624,226665,5817945,244008,8780302,296047,14598247,
All CA and Non-CA Counties,2021-04-07,488470,23023150,253915,11817378,161925,10413518,72630,792254,235180,5874180,252006,9032308,308241,14906488,
All CA and Non-CA Counties,2021-04-08,515020,23538170,259855,12077233,167631,10581149,87534,879788,241149,5931918,272314,9304622,330052,15236540,
All CA and Non-CA Counties,2021-04-09,510179,24048349,253848,12331081,173200,10754349,83131,962919,233374,5975326,275395,9580017,318803,15555343,
All CA and Non-CA Counties,2021-04-10,380650,24428999,173779,12504860,129526,10883875,77345,1040264,158980,5993068,220675,9800692,238417,15793760,
All CA and Non-CA Counties,2021-04-11,193157,24622156,107936,12612796,49873,10933748,35348,1075612,79338,5996932,113330,9914022,117194,15910954,
All CA and Non-CA Counties,2021-04-12,349795,24971951,179711,12792507,130607,11064355,39477,1115089,160899,6012992,187637,10101659,203697,16114651,
All CA and Non-CA Counties,2021-04-13,445212,25417163,249566,13042073,194638,11258993,1008,1116097,247134,6067431,196743,10298402,251182,16365833,
All CA and Non-CA Counties,2021-04-14,465028,25882191,261437,13303510,203251,11462244,340,1116437,241191,6091180,222323,10520725,246072,16611905,
All CA and Non-CA Counties,2021-04-15,505022,26387213,294203,13597713,210455,11672699,364,1116801,279973,6151308,223125,10743850,283253,16895158,
All CA and Non-CA Counties,2021-04-16,490574,26877787,275564,13873277,214668,11887367,342,1117143,260033,6185309,228847,10972697,262848,17158006,
All CA and Non-CA Counties,2021-04-17,354519,27232306,198609,14071886,155837,12043204,73,1117216,200317,6235858,153059,11125756,203608,17361614,
All CA and Non-CA Counties,2021-04-18,166114,27398420,106902,14178788,59178,12102382,34,1117250,84347,6242135,81184,11206940,87461,17449075,
All CA and Non-CA Counties,2021-04-19,329214,27727634,188668,14367456,140430,12242812,116,1117366,154085,6224319,173907,11380847,156091,17605166,
All CA and Non-CA Counties,2021-04-20,426541,28154175,229704,14597160,196735,12439547,102,1117468,208804,6220096,216263,11597110,212040,17817206,
All CA and Non-CA Counties,2021-04-21,451578,28605753,260088,14857248,191160,12630707,330,1117798,214578,6203539,234950,11832060,218393,18035599,
All CA and Non-CA Counties,2021-04-22,469775,29075528,269838,15127086,199829,12830536,108,1117906,207824,6154689,260041,12092101,211191,18246790,
All CA and Non-CA Counties,2021-04-23,461606,29537134,264749,15391835,196749,13027285,108,1118014,207831,6114107,251960,12344061,211378,18458168,
All CA and Non-CA Counties,2021-04-24,337663,29874797,212001,15603836,125453,13152738,209,1118223,170049,6121363,166350,12510411,173606,18631774,
All CA and Non-CA Counties,2021-04-25,155210,30030007,101478,15705314,53648,13206386,84,1118307,82554,6133485,72019,12582430,84141,18715915,
All CA and Non-CA Counties,2021-04-26,313933,30343940,182101,15887415,130204,13336590,1628,1119935,136134,6099301,176500,12758930,142316,18858231,
All CA and Non-CA Counties,2021-04-27,383620,30727560,211955,16099370,164576,13501166,7089,1127024,153587,6034611,228591,12987521,163901,19022132,
All CA and Non-CA Counties,2021-04-28,369981,31097541,213073,16312443,148437,13649603,8471,1135495,151543,5980084,216940,13204461,162413,19184545,
All CA and Non-CA Counties,2021-04-29,380227,31477768,220145,16532588,151564,13801167,8518,1144013,139132,5890148,239482,13443943,149546,19334091,
All CA and Non-CA Counties,2021-04-30,393041,31870809,225918,16758506,157586,13958753,9537,1153550,148875,5808136,242416,13686359,160404,19494495,
All CA and Non-CA Counties,2021-05-01,258033,32128842,164051,16922557,87283,14046036,6699,1160249,93856,5748072,162854,13849213,102790,19597285,
All CA and Non-CA Counties,2021-05-02,120461,32249303,84124,17006681,32277,14078313,4060,1164309,42117,5716803,77813,13927026,46544,19643829,
All CA and Non-CA Counties,2021-05-03,261991,32511294,161089,17167770,91706,14170019,9196,1173505,79240,5624485,181619,14108645,89301,19733130,
All CA and Non-CA Counties,2021-05-04,342253,32853547,210039,17377809,121798,14291817,10416,1183921,100497,5496173,240372,14349017,112060,19845190,
All CA and Non-CA Counties,2021-05-05,347888,33201435,217494,17595303,119821,14411638,10573,1194494,97692,5356881,248636,14597653,109344,19954534,
All CA and Non-CA Counties,2021-05-06,365987,33567422,240311,17835614,114654,14526292,11022,1205516,92316,5191060,271647,14869300,105826,20060360,
All CA and Non-CA Counties,2021-05-07,362242,33929664,227322,18062936,124556,14650848,10364,1215880,98022,5038235,262461,15131761,109636,20169996,
All CA and Non-CA Counties,2021-05-08,240502,34170166,153628,18216564,79554,14730402,7320,1223200,66075,4939825,173265,15305026,74855,20244851,
All CA and Non-CA Counties,2021-05-09,98038,34268204,74079,18290643,20819,14751221,3140,1226340,25559,4896898,72066,15377092,29139,20273990,
All CA and Non-CA Counties,2021-05-10,212653,34480857,121754,18412397,82558,14833779,8341,1234681,52425,4799767,159158,15536250,62027,20336017,
All CA and Non-CA Counties,2021-05-11,282733,34763590,161657,18574054,111987,14945766,9089,1243770,74357,4677870,207174,15743424,85277,20421294,
All CA and Non-CA Counties,2021-05-12,279317,35042907,162270,18736324,107467,15053233,9580,1253350,74863,4560454,203121,15946545,85705,20506999,
All CA and Non-CA Counties,2021-05-13,325431,35368338,209640,18945964,108076,15161309,7715,1261065,122069,4490999,201987,16148532,132532,20639531,
All CA and Non-CA Counties,2021-05-14,349414,35717752,223518,19169482,116614,15277923,9282,1270347,135869,4426211,212029,16360561,147241,20786772,
All CA and Non-CA Counties,2021-05-15,286941,36004693,200029,19369511,80669,15358592,6243,1276590,117941,4383552,167874,16528435,125215,20911987,
All CA and Non-CA Counties,2021-05-16,144582,36149275,110683,19480194,30853,15389445,3046,1279636,58949,4360911,85062,16613497,62421,20974408,
All CA and Non-CA Counties,2021-05-17,245931,36395206,161384,19641578,76795,15466240,7752,1287388,97040,4318784,147810,16761307,105683,21080091,
All CA and Non-CA Counties,2021-05-18,287998,36683204,175123,19816701,105057,15571297,7818,1295206,112020,4265377,174673,16935980,121266,21201357,
All CA and Non-CA Counties,2021-05-19,282498,36965702,175852,19992553,98684,15669981,7962,1303168,115206,4223644,166020,17102000,124287,21325644,
All CA and Non-CA Counties,2021-05-20,271687,37237389,162319,20154872,100824,15770805,8544,1311712,103463,4170346,166854,17268854,113556,21439200,
All CA and Non-CA Counties,2021-05-21,290258,37527647,178254,20333126,103649,15874454,8355,1320067,109002,4109221,179733,17448587,118608,21557808,
All CA and Non-CA Counties,2021-05-22,210481,37738128,139450,20472576,64556,15939010,6475,1326542,89631,4086617,119871,17568458,97267,21655075,
All CA and Non-CA Counties,2021-05-23,92840,37830968,64506,20537082,25545,15964555,2789,1329331,39647,4076747,52709,17621167,42839,21697914,
All CA and Non-CA Counties,2021-05-24,176230,38007198,103164,20640246,64290,16028845,8776,1338107,66661,4044447,108579,17729746,76279,21774193,
All CA and Non-CA Counties,2021-05-25,195043,38202241,114153,20754399,72371,16101216,8519,1346626,73709,4007716,120077,17849823,83346,21857539,
All CA and Non-CA Counties,2021-05-26,189378,38391619,108602,20863001,72433,16173649,8343,1354969,73334,3975308,114788,17964611,82380,21939919,
All CA and Non-CA Counties,2021-05-27,176577,38568196,100786,20963787,66920,16240569,8871,1363840,70725,3951129,104847,18069458,80668,22020587,
All CA and Non-CA Counties,2021-05-28,194544,38762740,112099,21075886,74841,16315410,7604,1371444,83653,3933800,109715,18179173,92386,22112973,
All CA and Non-CA Counties,2021-05-29,110028,38872768,67368,21143254,38427,16353837,4233,1375677,50916,3931030,58443,18237616,55673,22168646,
All CA and Non-CA Counties,2021-05-30,48510,38921278,31996,21175250,13904,16367741,2610,1378287,21182,3928030,27008,18264624,24008,22192654,
All CA and Non-CA Counties,2021-05-31,20650,38941928,12132,21187382,7486,16375227,1032,1379319,6752,3922281,13645,18278269,7896,22200550,
All CA and Non-CA Counties,2021-06-01,173026,39114954,100798,21288180,64650,16439877,7578,1386897,61167,3881288,110596,18388865,69603,22270153,
All CA and Non-CA Counties,2021-06-02,146855,39261809,86755,21374935,52536,16492413,7564,1394461,55461,3854652,90345,18479210,63709,22333862,
All CA and Non-CA Counties,2021-06-03,175569,39437378,119786,21494721,48281,16540694,7502,1401963,53450,3795486,121148,18600358,61982,22395844,
All CA and Non-CA Counties,2021-06-04,205124,39642502,144113,21638834,54400,16595094,6611,1408574,61562,3723218,142302,18742660,70034,22465878,
All CA and Non-CA Counties,2021-06-05,161039,39803541,121414,21760248,33763,16628857,5862,1414436,44658,3659220,115508,18858168,51510,22517388,
All CA and Non-CA Counties,2021-06-06,65448,39868989,55057,21815305,8069,16636926,2322,1416758,17342,3631957,47764,18905932,20501,22537889,
All CA and Non-CA Counties,2021-06-07,140196,40009185,102538,21917843,31336,16668262,6322,1423080,41702,3582932,97764,19003696,48739,22586628,
All CA and Non-CA Counties,2021-06-08,161431,40170616,116788,22034631,37440,16705702,7203,1430283,47817,3526387,112624,19116320,56079,22642707,
All CA and Non-CA Counties,2021-06-09,155549,40326165,112795,22147426,35625,16741327,7129,1437412,43176,3466150,111459,19227779,51222,22693929,
All CA and Non-CA Counties,2021-06-10,150172,40476337,107757,22255183,34674,16776001,7741,1445153,43550,3412796,105803,19333582,52449,22746378,
All CA and Non-CA Counties,2021-06-11,163826,40640163,114851,22370034,41824,16817825,7151,1452304,51134,3360326,111676,19445258,59206,22805584,
All CA and Non-CA Counties,2021-06-12,118346,40758509,89652,22459686,24782,16842607,3912,1456216,33672,3314556,84056,19529314,38286,22843870,
All CA and Non-CA Counties,2021-06-13,46082,40804591,34331,22494017,9583,16852190,2168,1458384,11565,3294447,34244,19563558,14135,22858005,
All CA and Non-CA Counties,2021-06-14,118882,40923473,84326,22578343,27385,16879575,7171,1465555,39188,3262415,78994,19642552,46962,22904967,
All CA and Non-CA Counties,2021-06-15,135748,41059221,91461,22669804,35125,16914700,9162,1474717,45388,3228533,89331,19731883,55449,22960416,
All CA and Non-CA Counties,2021-06-16,124805,41184026,87841,22757645,28917,16943617,8047,1482764,43162,3199724,80767,19812650,51958,23012374,
All CA and Non-CA Counties,2021-06-17,117745,41301771,81355,22839000,28075,16971692,8315,1491079,41671,3175103,75242,19887892,50621,23062995,
All CA and Non-CA Counties,2021-06-18,132334,41434105,91460,22930460,32862,17004554,8012,1499091,47231,3146964,84117,19972009,55978,23118973,
All CA and Non-CA Counties,2021-06-19,78456,41512561,56976,22987436,17337,17021891,4143,1503234,29206,3132230,48616,20020625,33882,23152855,
All CA and Non-CA Counties,2021-06-20,31716,41544277,23873,23011309,6434,17028325,1409,1504643,12036,3126465,19433,20040058,13668,23166523,
All CA and Non-CA Counties,2021-06-21,73374,41617651,45847,23057156,21125,17049450,6402,1511045,37403,3135321,35523,20075581,44379,23210902,
All CA and Non-CA Counties,2021-06-22,103170,41720821,71868,23129024,25049,17074499,6253,1517298,40108,3119970,62372,20137953,47021,23257923,
All CA and Non-CA Counties,2021-06-23,96551,41817372,67861,23196885,22535,17097034,6155,1523453,39169,3109162,56725,20194678,45917,23303840,
All CA and Non-CA Counties,2021-06-24,93907,41911279,65352,23262237,22590,17119624,5965,1529418,37980,3098467,55196,20249874,44501,23348341,
All CA and Non-CA Counties,2021-06-25,108453,42019732,76501,23338738,26192,17145816,5760,1535178,44140,3085383,63592,20313466,50508,23398849,
All CA and Non-CA Counties,2021-06-26,70100,42089832,52779,23391517,13972,17159788,3349,1538527,28956,3077599,40677,20354143,32893,23431742,
All CA and Non-CA Counties,2021-06-27,32742,42122574,25222,23416739,5905,17165693,1615,1540142,13998,3074930,18518,20372661,15849,23447591,
All CA and Non-CA Counties,2021-06-28,74656,42197230,57554,23474293,12314,17178007,4788,1544930,32609,3071371,41434,20414095,37875,23485466,
All CA and Non-CA Counties,2021-06-29,87043,42284273,61638,23535931,20825,17198832,4580,1549510,36910,3063917,49507,20463602,42053,23527519,
All CA and Non-CA Counties,2021-06-30,82589,42366862,59042,23594973,19401,17218233,4146,1553656,37195,3061142,44695,20508297,41920,23569439,
All CA and Non-CA Counties,2021-07-01,77485,42444347,55625,23650598,17559,17235792,4301,1557957,34227,3057535,42655,20550952,39048,23608487,
All CA and Non-CA Counties,2021-07-02,87938,42532285,62678,23713276,21053,17256845,4207,1562164,38981,3052917,48315,20599267,43697,23652184,
All CA and Non-CA Counties,2021-07-03,48222,42580507,35125,23748401,11257,17268102,1840,1564004,21992,3051252,25817,20625084,24152,23676336,
All CA and Non-CA Counties,2021-07-04,3629,42584136,2125,23750526,1210,17269312,294,1564298,1619,3051253,1967,20627051,1968,23678304,
All CA and Non-CA Counties,2021-07-05,42443,42626579,31356,23781882,9412,17278724,1675,1565973,19710,3050512,22423,20649474,21682,23699986,
All CA and Non-CA Counties,2021-07-06,89875,42716454,65525,23847407,19914,17298638,4436,1570409,34517,3035423,54654,20704128,39565,23739551,
All CA and Non-CA Counties,2021-07-07,76309,42792763,54752,23902159,17054,17315692,4503,1574912,31569,3027952,44134,20748262,36663,23776214,
All CA and Non-CA Counties,2021-07-08,72894,42865657,52106,23954265,16535,17332227,4253,1579165,30300,3021007,41975,20790237,35030,23811244,
All CA and Non-CA Counties,2021-07-09,85161,42950818,60532,24014797,19799,17352026,4830,1583995,36556,3014905,47975,20838212,41873,23853117,
All CA and Non-CA Counties,2021-07-10,53523,43004341,39624,24054421,11280,17363306,2619,1586614,23501,3011765,29620,20867832,26480,23879597,
All CA and Non-CA Counties,2021-07-11,24255,43028596,18144,24072565,5037,17368343,1074,1587688,11351,3011632,12707,20880539,12574,23892171,
All CA and Non-CA Counties,2021-07-12,67952,43096548,50093,24122658,14077,17382420,3782,1591470,28614,3005594,38900,20919439,32862,23925033,
All CA and Non-CA Counties,2021-07-13,72230,43168778,51533,24174191,17254,17399674,3443,1594913,32550,3002902,39151,20958590,36459,23961492,
All CA and Non-CA Counties,2021-07-14,69393,43238171,49642,24223833,16273,17415947,3478,1598391,31075,3000095,37818,20996408,35011,23996503,
All CA and Non-CA Counties,2021-07-15,69907,43308078,51040,24274873,15763,17431710,3104,1601495,32575,2999430,36827,21033235,36162,24032665,
All CA and Non-CA Counties,2021-07-16,84993,43393071,61339,24336212,19956,17451666,3698,1605193,40957,3001074,43490,21076725,45134,24077799,
All CA and Non-CA Counties,2021-07-17,55156,43448227,40663,24376875,12335,17464001,2158,1607351,26766,3002317,27978,21104703,29221,24107020,
All CA and Non-CA Counties,2021-07-18,26405,43474632,19996,24396871,5307,17469308,1102,1608453,13224,3003817,12970,21117673,14470,24121490,
All CA and Non-CA Counties,2021-07-19,69098,43543730,51286,24448157,14469,17483777,3343,1611796,34096,3007174,34515,21152188,37872,24159362,
All CA and Non-CA Counties,2021-07-20,78581,43622311,55789,24503946,19135,17502912,3657,1615453,39997,3013338,37974,21190162,44138,24203500,
All CA and Non-CA Counties,2021-07-21,76586,43698897,55199,24559145,17625,17520537,3762,1619215,39011,3019571,36993,21227155,43226,24246726,
All CA and Non-CA Counties,2021-07-22,76828,43775725,55340,24614485,17906,17538443,3582,1622797,40900,3029153,35299,21262454,44881,24291607,
All CA and Non-CA Counties,2021-07-23,90985,43866710,65213,24679698,21811,17560254,3961,1626758,49608,3042509,40665,21303119,54021,24345628,
All CA and Non-CA Counties,2021-07-24,55664,43922374,40389,24720087,13217,17573471,2058,1628816,31279,3052159,23927,21327046,33577,24379205,
All CA and Non-CA Counties,2021-07-25,25471,43947845,18896,24738983,5907,17579378,668,1629484,18600,3064899,6655,21333701,19395,24398600,
All CA and Non-CA Counties,2021-07-26,71348,44019193,50741,24789724,17141,17596519,3466,1632950,44261,3086422,26520,21360221,48043,24446643,
All CA and Non-CA Counties,2021-07-27,84220,44103413,60918,24850642,19546,17616065,3756,1636706,48612,3104173,34943,21395164,52694,24499337,
All CA and Non-CA Counties,2021-07-28,83094,44186507,59696,24910338,19646,17635711,3752,1640458,49066,3124039,33332,21428496,53198,24552535,
All CA and Non-CA Counties,2021-07-29,80593,44267100,58245,24968583,18616,17654327,3732,1644190,48389,3145083,31449,21459945,52493,24605028,
All CA and Non-CA Counties,2021-07-30,95531,44362631,68761,25037344,22801,17677128,3969,1648159,56485,3167964,38017,21497962,60898,24665926,
All CA and Non-CA Counties,2021-07-31,59186,44421817,43552,25080896,13392,17690520,2242,1650401,35504,3182948,23030,21520992,38014,24703940,
All CA and Non-CA Counties,2021-08-01,29697,44451514,22952,25103848,5995,17696515,750,1651151,19376,3193224,10020,21531012,20296,24724236,
All CA and Non-CA Counties,2021-08-02,78812,44530326,59150,25162998,16351,17712866,3311,1654462,49450,3217594,28695,21559707,53065,24777301,
All CA and Non-CA Counties,2021-08-03,88431,44618757,64622,25227620,19700,17732566,4109,1658571,53990,3242309,33674,21593381,58389,24835690,
All CA and Non-CA Counties,2021-08-04,83242,44701999,61268,25288888,18365,17750931,3609,1662180,50988,3265641,31510,21624891,54842,24890532,
All CA and Non-CA Counties,2021-08-05,84994,44786993,62800,25351688,18180,17769111,4014,1666194,51832,3289405,32351,21657242,56115,24946647,
All CA and Non-CA Counties,2021-08-06,103113,44890106,75998,25427686,22857,17791968,4258,1670452,62088,3316025,40031,21697273,66651,25013298,
All CA and Non-CA Counties,2021-08-07,63001,44953107,47439,25475125,13265,17805233,2297,1672749,37867,3331828,24554,21721827,40357,25053655,
All CA and Non-CA Counties,2021-08-08,34699,44987806,26242,25501367,7544,17812777,913,1673662,21629,3341802,12686,21734513,22660,25076315,
All CA and Non-CA Counties,2021-08-09,86355,45074161,65796,25567163,16840,17829617,3719,1677381,50803,3361858,34785,21769298,54841,25131156,
All CA and Non-CA Counties,2021-08-10,89108,45163269,65842,25633005,19564,17849181,3702,1681083,51266,3380120,37016,21806314,55278,25186434,
All CA and Non-CA Counties,2021-08-11,80174,45243443,59247,25692252,17085,17866266,3842,1684925,45728,3396343,33565,21839879,49788,25236222,
All CA and Non-CA Counties,2021-08-12,86997,45330440,62709,25754961,20134,17886400,4154,1689079,49582,3413979,36319,21876198,53955,25290177,
All CA and Non-CA Counties,2021-08-13,108719,45439159,78608,25833569,25725,17912125,4386,1693465,60794,3433396,46094,21922292,65511,25355688,
All CA and Non-CA Counties,2021-08-14,71219,45510378,52102,25885671,16834,17928959,2283,1695748,38348,3445196,29115,21951407,40915,25396603,
All CA and Non-CA Counties,2021-08-15,37108,45547486,27270,25912941,8947,17937906,891,1696639,19530,3451061,14729,21966136,20594,25417197,
All CA and Non-CA Counties,2021-08-16,95059,45642545,66501,25979442,24847,17962753,3711,1700350,47640,3462727,40029,22006165,51695,25468892,
All CA and Non-CA Counties,2021-08-17,99848,45742393,69410,26048852,26403,17989156,4035,1704385,48035,3471779,43381,22049546,52433,25521325,
All CA and Non-CA Counties,2021-08-18,99420,45841813,68994,26117846,26653,18015809,3773,1708158,46586,3479619,42894,22092440,50734,25572059,
All CA and Non-CA Counties,2021-08-19,98878,45940691,67643,26185489,27087,18042896,4148,1712306,46041,3488286,41840,22134280,50507,25622566,
All CA and Non-CA Counties,2021-08-20,123052,46063743,85805,26271294,33079,18075975,4168,1716474,55419,3494232,54047,22188327,59993,25682559,
All CA and Non-CA Counties,2021-08-21,73824,46137567,53746,26325040,17915,18093890,2163,1718637,32648,3495901,33434,22221761,35103,25717662,
All CA and Non-CA Counties,2021-08-22,41207,46178774,29838,26354878,10541,18104431,828,1719465,19336,3498573,17687,22239448,20359,25738021,
All CA and Non-CA Counties,2021-08-23,102951,46281725,74116,26428994,25555,18129986,3280,1722745,45792,3502348,45995,22285443,49770,25787791,
All CA and Non-CA Counties,2021-08-24,103458,46385183,76004,26504998,24052,18154038,3402,1726147,44568,3503195,47688,22333131,48535,25836326,
All CA and Non-CA Counties,2021-08-25,99248,46484431,73076,26578074,23013,18177051,3159,1729306,43182,3504783,45314,22378445,46902,25883228,
All CA and Non-CA Counties,2021-08-26,99767,46584198,72486,26650560,23758,18200809,3523,1732829,42665,3506073,45390,22423835,46680,25929908,
All CA and Non-CA Counties,2021-08-27,122090,46706288,90280,26740840,28386,18229195,3424,1736253,49911,3501633,58546,22482381,54106,25984014,
All CA and Non-CA Counties,2021-08-28,74445,46780733,55959,26796799,16815,18246010,1671,1737924,30237,3497187,36826,22519207,32380,26016394,
All CA and Non-CA Counties,2021-08-29,41063,46821796,30655,26827454,9848,18255858,560,1738484,17304,3495665,19690,22538897,18168,26034562,
All CA and Non-CA Counties,2021-08-30,61217,46883013,41661,26869115,16706,18272564,2850,1741334,21791,3490254,30346,22569243,24935,26059497,
Alpine,2020-12-15,0,0,0,0,0,0,0,0,0,0,0,0,0,0,
Alpine,2020-12-16,0,0,0,0,0,0,0,0,0,0,0,0,0,0,
Alpine,2020-12-17,0,0,0,0,0,0,0,0,0,0,0,0,0,0,
Alpine,2020-12-20,0,4,0,4,0,0,0,0,0,4,0,0,0,4,
Alpine,2020-12-22,0,5,0,5,0,0,0,0,0,5,0,0,0,5,
Alpine,2020-12-23,0,5,0,5,0,0,0,0,0,5,0,0,0,5,
Alpine,2020-12-24,0,5,0,5,0,0,0,0,0,5,0,0,0,5,
Alpine,2020-12-25,0,5,0,5,0,0,0,0,0,5,0,0,0,5,
Alpine,2020-12-26,0,5,0,5,0,0,0,0,0,5,0,0,0,5,
Alpine,2020-12-27,0,5,0,5,0,0,0,0,0,5,0,0,0,5,
Alpine,2020-12-28,0,5,0,5,0,0,0,0,0,5,0,0,0,5,
Alpine,2021-01-03,0,23,0,6,0,17,0,0,0,23,0,0,0,23,
Alpine,2021-01-10,0,86,0,10,0,76,0,0,0,78,0,4,0,82,
Alpine,2021-01-12,0,118,0,11,0,107,0,0,0,108,0,5,0,113,
Alpine,2021-01-16,0,155,0,11,0,144,0,0,0,145,0,5,0,150,
Alpine,2021-01-17,0,155,0,11,0,144,0,0,0,145,0,5,0,150,
Alpine,2021-01-19,0,156,0,12,0,144,0,0,0,146,0,5,0,151,
Alpine,2021-01-24,0,212,0,13,0,199,0,0,0,200,0,6,0,206,
Alpine,2021-01-27,0,229,0,13,0,216,0,0,0,215,0,7,0,222,
Alpine,2021-01-30,0,231,0,13,0,218,0,0,0,215,0,8,0,223,
Alpine,2021-01-31,0,231,0,13,0,218,0,0,0,215,0,8,0,223,
Alpine,2021-02-02,0,256,0,13,0,243,0,0,0,204,0,26,0,230,
Alpine,2021-02-06,0,329,0,14,0,315,0,0,0,179,0,75,0,254,
Alpine,2021-02-07,0,329,0,14,0,315,0,0,0,179,0,75,0,254,
Alpine,2021-02-09,0,361,0,14,0,347,0,0,0,155,0,103,0,258,
Alpine,2021-02-13,0,402,0,14,0,388,0,0,0,120,0,141,0,261,
Alpine,2021-02-14,0,402,0,14,0,388,0,0,0,120,0,141,0,261,
Alpine,2021-02-15,0,402,0,14,0,388,0,0,0,120,0,141,0,261,
Alpine,2021-02-16,0,402,0,14,0,388,0,0,0,120,0,141,0,261,
Alpine,2021-02-20,0,461,0,15,0,446,0,0,0,73,0,194,0,267,
Alpine,2021-02-21,0,461,0,15,0,446,0,0,0,73,0,194,0,267,
Alpine,2021-02-23,0,488,0,15,0,473,0,0,0,62,0,213,0,275,
Alpine,2021-02-24,0,488,0,15,0,473,0,0,0,62,0,213,0,275,
Alpine,2021-02-28,0,524,0,16,0,508,0,0,0,96,0,214,0,310,
Alpine,2021-03-02,0,560,0,16,0,544,0,0,0,112,0,224,0,336,
Alpine,2021-03-06,0,627,0,16,0,611,0,0,0,143,0,242,0,385,
Alpine,2021-03-07,0,627,0,16,0,611,0,0,0,143,0,242,0,385,
Alpine,2021-03-09,0,658,0,16,0,642,0,0,0,170,0,244,0,414,
Alpine,2021-03-13,0,785,0,16,0,769,0,0,0,285,0,250,0,535,
Alpine,2021-03-14,0,785,0,16,0,769,0,0,0,285,0,250,0,535,
Alpine,2021-03-16,0,805,0,16,0,789,0,0,0,303,0,251,0,554,
Alpine,2021-03-20,0,865,0,17,0,847,0,1,0,352,0,257,0,609,
Alpine,2021-03-21,0,865,0,17,0,847,0,1,0,352,0,257,0,609,
Alpine,2021-03-23,0,889,0,17,0,871,0,1,0,358,0,266,0,624,
Alpine,2021-03-26,0,942,0,17,0,923,0,2,0,377,0,283,0,660,
Alpine,2021-03-30,0,963,0,18,0,942,0,3,0,363,0,301,0,664,
Alpine,2021-03-31,0,963,0,18,0,942,0,3,0,363,0,301,0,664,
Alpine,2021-04-03,0,1080,0,18,0,1059,0,3,0,353,0,364,0,717,
Alpine,2021-04-04,0,1080,0,18,0,1059,0,3,0,353,0,364,0,717,
Alpine,2021-04-10,0,1239,0,19,0,1216,0,4,0,282,0,479,0,761,
Alpine,2021-04-11,0,1239,0,19,0,1216,0,4,0,282,0,479,0,761,
Alpine,2021-04-12,0,1239,0,19,0,1216,0,4,0,282,0,479,0,761,
Alpine,2021-04-13,0,1239,0,19,0,1216,0,4,0,282,0,479,0,761,
Alpine,2021-04-16,0,1321,0,19,0,1298,0,4,0,226,0,548,0,774,
Alpine,2021-04-17,0,1321,0,19,0,1298,0,4,0,226,0,548,0,774,
Alpine,2021-04-18,0,1321,0,19,0,1298,0,4,0,226,0,548,0,774,
Alpine,2021-04-20,0,1322,0,19,0,1299,0,4,0,227,0,548,0,775,
Alpine,2021-04-23,0,1377,0,19,0,1354,0,4,0,204,0,587,0,791,
Alpine,2021-04-24,0,1377,0,19,0,1354,0,4,0,204,0,587,0,791,
Alpine,2021-04-26,0,1378,0,20,0,1354,0,4,0,203,0,588,0,791,
Alpine,2021-05-01,0,1423,0,21,0,1397,0,5,0,175,0,625,0,800,
Alpine,2021-05-03,0,1424,0,21,0,1397,0,6,0,175,0,626,0,801,
Alpine,2021-05-04,0,1424,0,21,0,1397,0,6,0,175,0,626,0,801,
Alpine,2021-05-08,0,1450,0,21,0,1423,0,6,0,157,0,648,0,805,
Alpine,2021-05-09,0,1450,0,21,0,1423,0,6,0,157,0,648,0,805,
Alpine,2021-05-11,0,1451,0,21,0,1424,0,6,0,158,0,648,0,806,
Alpine,2021-05-14,0,1455,0,21,0,1427,0,7,0,155,0,652,0,807,
Alpine,2021-05-15,0,1455,0,21,0,1427,0,7,0,155,0,652,0,807,
Alpine,2021-05-16,0,1455,0,21,0,1427,0,7,0,155,0,652,0,807,
Alpine,2021-05-20,0,1473,0,21,0,1445,0,7,0,141,0,668,0,809,
Alpine,2021-05-22,0,1474,0,22,0,1445,0,7,0,140,0,669,0,809,
Alpine,2021-05-23,0,1474,0,22,0,1445,0,7,0,140,0,669,0,809,
Alpine,2021-05-24,0,1474,0,22,0,1445,0,7,0,140,0,669,0,809,
Alpine,2021-05-26,0,1475,0,22,0,1446,0,7,0,139,0,670,0,809,
Alpine,2021-05-30,0,1481,0,25,0,1449,0,7,0,145,0,670,0,815,
Alpine,2021-05-31,0,1481,0,25,0,1449,0,7,0,145,0,670,0,815,
Alpine,2021-06-01,0,1481,0,25,0,1449,0,7,0,145,0,670,0,815,
Alpine,2021-06-03,0,1489,0,25,0,1457,0,7,0,139,0,677,0,816,
Alpine,2021-06-05,0,1490,0,25,0,1458,0,7,0,140,0,677,0,817,
Alpine,2021-06-06,0,1490,0,25,0,1458,0,7,0,140,0,677,0,817,
Alpine,2021-06-08,0,1491,0,25,0,1459,0,7,0,139,0,678,0,817,
Alpine,2021-06-09,0,1491,0,25,0,1459,0,7,0,139,0,678,0,817,
Alpine,2021-06-11,0,1492,0,26,0,1459,0,7,0,140,0,678,0,818,
Alpine,2021-06-12,0,1492,0,26,0,1459,0,7,0,140,0,678,0,818,
Alpine,2021-06-13,0,1492,0,26,0,1459,0,7,0,140,0,678,0,818,
Alpine,2021-06-14,0,1492,0,26,0,1459,0,7,0,140,0,678,0,818,
Alpine,2021-06-16,0,1493,0,26,0,1460,0,7,0,139,0,679,0,818,
Alpine,2021-06-17,0,1493,0,26,0,1460,0,7,0,139,0,679,0,818,
Alpine,2021-06-20,0,1496,0,29,0,1460,0,7,0,136,0,682,0,818,
Alpine,2021-06-21,0,1496,0,29,0,1460,0,7,0,136,0,682,0,818,
Alpine,2021-06-22,0,1496,0,29,0,1460,0,7,0,136,0,682,0,818,
Alpine,2021-06-23,0,1496,0,29,0,1460,0,7,0,136,0,682,0,818,
Alpine,2021-06-24,0,1496,0,29,0,1460,0,7,0,136,0,682,0,818,
Alpine,2021-06-26,0,1497,0,29,0,1461,0,7,0,135,0,683,0,818,
Alpine,2021-06-27,0,1497,0,29,0,1461,0,7,0,135,0,683,0,818,
Alpine,2021-06-28,0,1497,0,29,0,1461,0,7,0,135,0,683,0,818,
Alpine,2021-07-02,0,1500,0,30,0,1463,0,7,0,134,0,685,0,819,
Alpine,2021-07-03,0,1500,0,30,0,1463,0,7,0,134,0,685,0,819,
Alpine,2021-07-04,0,1500,0,30,0,1463,0,7,0,134,0,685,0,819,
Alpine,2021-07-05,0,1500,0,30,0,1463,0,7,0,134,0,685,0,819,
Alpine,2021-07-08,0,1503,0,30,0,1466,0,7,0,137,0,685,0,822,
Alpine,2021-07-09,0,1503,0,30,0,1466,0,7,0,137,0,685,0,822,
Alpine,2021-07-10,0,1503,0,30,0,1466,0,7,0,137,0,685,0,822,
Alpine,2021-07-11,0,1503,0,30,0,1466,0,7,0,137,0,685,0,822,
Alpine,2021-07-12,0,1503,0,30,0,1466,0,7,0,137,0,685,0,822,
Alpine,2021-07-13,0,1503,0,30,0,1466,0,7,0,137,0,685,0,822,
Alpine,2021-07-14,0,1503,0,30,0,1466,0,7,0,137,0,685,0,822,
Alpine,2021-07-15,0,1503,0,30,0,1466,0,7,0,137,0,685,0,822,
Alpine,2021-07-17,0,1504,0,30,0,1467,0,7,0,138,0,685,0,823,
Alpine,2021-07-18,0,1504,0,30,0,1467,0,7,0,138,0,685,0,823,
Alpine,2021-07-19,0,1504,0,30,0,1467,0,7,0,138,0,685,0,823,
Alpine,2021-07-21,0,1505,0,30,0,1468,0,7,0,139,0,685,0,824,
Alpine,2021-07-22,0,1505,0,30,0,1468,0,7,0,139,0,685,0,824,
Alpine,2021-07-23,0,1505,0,30,0,1468,0,7,0,139,0,685,0,824,
Alpine,2021-07-25,0,1506,0,30,0,1469,0,7,0,140,0,685,0,825,
Alpine,2021-07-26,0,1506,0,30,0,1469,0,7,0,140,0,685,0,825,
Alpine,2021-07-27,0,1506,0,30,0,1469,0,7,0,140,0,685,0,825,
Alpine,2021-07-28,0,1506,0,30,0,1469,0,7,0,140,0,685,0,825,
Alpine,2021-07-29,0,1506,0,30,0,1469,0,7,0,140,0,685,0,825,
Alpine,2021-07-31,0,1507,0,30,0,1470,0,7,0,139,0,686,0,825,
Alpine,2021-08-01,0,1507,0,30,0,1470,0,7,0,139,0,686,0,825,
Alpine,2021-08-02,0,1507,0,30,0,1470,0,7,0,139,0,686,0,825,
Alpine,2021-08-05,0,1510,0,30,0,1473,0,7,0,138,0,688,0,826,
Alpine,2021-08-06,0,1510,0,30,0,1473,0,7,0,138,0,688,0,826,
Alpine,2021-08-07,0,1510,0,30,0,1473,0,7,0,138,0,688,0,826,
Alpine,2021-08-08,0,1510,0,30,0,1473,0,7,0,138,0,688,0,826,
Alpine,2021-08-09,0,1510,0,30,0,1473,0,7,0,138,0,688,0,826,
Alpine,2021-08-10,0,1510,0,30,0,1473,0,7,0,138,0,688,0,826,
Alpine,2021-08-12,0,1511,0,30,0,1474,0,7,0,139,0,688,0,827,
Alpine,2021-08-14,0,1512,0,30,0,1475,0,7,0,140,0,688,0,828,
Alpine,2021-08-15,0,1512,0,30,0,1475,0,7,0,140,0,688,0,828,
Alpine,2021-08-16,0,1512,0,30,0,1475,0,7,0,140,0,688,0,828,
Alpine,2021-08-18,0,1513,0,30,0,1476,0,7,0,139,0,689,0,828,
Alpine,2021-08-19,0,1513,0,30,0,1476,0,7,0,139,0,689,0,828,
Alpine,2021-08-20,0,1513,0,30,0,1476,0,7,0,139,0,689,0,828,
Alpine,2021-08-21,0,1513,0,30,0,1476,0,7,0,139,0,689,0,828,
Alpine,2021-08-22,0,1513,0,30,0,1476,0,7,0,139,0,689,0,828,
Alpine,2021-08-26,0,1520,0,32,0,1481,0,7,0,144,0,689,0,833,
Alpine,2021-08-27,0,1520,0,32,0,1481,0,7,0,144,0,689,0,833,
Alpine,2021-08-28,0,1520,0,32,0,1481,0,7,0,144,0,689,0,833,
Alpine,2021-08-30,0,1521,0,32,0,1482,0,7,0,144,0,689,0,833,
Amador,2020-12-15,0,0,0,0,0,0,0,0,0,0,0,0,0,0,
Amador,2020-12-25,0,188,0,183,0,5,0,0,0,188,0,0,0,188,
Butte,2020-12-15,0,0,0,0,0,0,0,0,0,0,0,0,0,0,
Butte,2020-12-25,0,2364,0,2342,0,22,0,0,0,2364,0,0,0,2364,
Calaveras,2020-12-15,0,0,0,0,0,0,0,0,0,0,0,0,0,0,
Calaveras,2020-12-25,0,281,0,269,0,12,0,0,0,282,0,0,0,282,
Calaveras,2021-01-01,0,607,0,542,0,65,0,0,0,606,0,1,0,607,
Colusa,2020-12-15,0,0,0,0,0,0,0,0,0,0,0,0,0,0,
Colusa,2020-12-16,0,0,0,0,0,0,0,0,0,0,0,0,0,0,
Colusa,2020-12-17,0,0,0,0,0,0,0,0,0,0,0,0,0,0,
Colusa,2020-12-19,0,1,0,1,0,0,0,0,0,1,0,0,0,1,
Colusa,2020-12-20,0,1,0,1,0,0,0,0,0,1,0,0,0,1,
Colusa,2020-12-25,0,26,0,25,0,1,0,0,0,26,0,0,0,26,
Colusa,2020-12-26,0,26,0,25,0,1,0,0,0,26,0,0,0,26,
Colusa,2021-01-01,0,112,0,51,0,61,0,0,0,112,0,0,0,112,
Colusa,2021-01-02,0,112,0,51,0,61,0,0,0,112,0,0,0,112,
Colusa,2021-01-03,0,112,0,51,0,61,0,0,0,112,0,0,0,112,
Colusa,2021-01-24,0,663,0,329,0,334,0,0,0,559,0,52,0,611,
Del Norte,2020-12-15,0,0,0,0,0,0,0,0,0,0,0,0,0,0,
Del Norte,2020-12-16,0,0,0,0,0,0,0,0,0,0,0,0,0,0,
Del Norte,2020-12-17,0,0,0,0,0,0,0,0,0,0,0,0,0,0,
Del Norte,2020-12-18,0,0,0,0,0,0,0,0,0,0,0,0,0,0,
Del Norte,2020-12-19,0,0,0,0,0,0,0,0,0,0,0,0,0,0,
Del Norte,2020-12-20,0,0,0,0,0,0,0,0,0,0,0,0,0,0,
Del Norte,2020-12-24,0,127,0,117,0,10,0,0,0,125,0,0,0,125,
Del Norte,2020-12-25,0,127,0,117,0,10,0,0,0,125,0,0,0,125,
Del Norte,2020-12-26,0,127,0,117,0,10,0,0,0,125,0,0,0,125,
Del Norte,2020-12-27,0,127,0,117,0,10,0,0,0,125,0,0,0,125,
Del Norte,2021-01-01,0,251,0,226,0,25,0,0,0,249,0,0,0,249,
Del Norte,2021-01-02,0,251,0,226,0,25,0,0,0,249,0,0,0,249,
Del Norte,2021-01-03,0,251,0,226,0,25,0,0,0,249,0,0,0,249,
Del Norte,2021-01-09,0,563,0,302,0,261,0,0,0,560,0,1,0,561,
Del Norte,2021-01-10,0,563,0,302,0,261,0,0,0,560,0,1,0,561,
Del Norte,2021-01-16,0,902,0,430,0,472,0,0,0,712,0,95,0,807,
Del Norte,2021-01-31,0,1802,0,792,0,1010,0,0,0,1191,0,305,0,1496,
Glenn,2020-12-15,0,0,0,0,0,0,0,0,0,0,0,0,0,0,
Glenn,2020-12-16,0,0,0,0,0,0,0,0,0,0,0,0,0,0,
Glenn,2020-12-18,0,1,0,1,0,0,0,0,0,1,0,0,0,1,
Glenn,2020-12-19,0,1,0,1,0,0,0,0,0,1,0,0,0,1,
Glenn,2020-12-25,0,110,0,110,0,0,0,0,0,110,0,0,0,110,
Glenn,2021-01-01,0,382,0,331,0,51,0,0,0,382,0,0,0,382,
Glenn,2021-01-03,0,386,0,335,0,51,0,0,0,386,0,0,0,386,
Glenn,2021-01-09,0,540,0,376,0,164,0,0,0,538,0,1,0,539,
Glenn,2021-02-21,0,5090,0,1758,0,3332,0,0,0,2410,0,1340,0,3750,
Humboldt,2021-01-03,0,2149,0,1634,0,515,0,0,0,2153,0,0,0,2153,
Imperial,2020-12-15,0,0,0,0,0,0,0,0,0,0,0,0,0,0,
Imperial,2020-12-19,0,22,0,22,0,0,0,0,0,22,0,0,0,22,
Inyo,2020-12-15,0,0,0,0,0,0,0,0,0,0,0,0,0,0,
Inyo,2020-12-16,0,0,0,0,0,0,0,0,0,0,0,0,0,0,
Inyo,2020-12-17,0,0,0,0,0,0,0,0,0,0,0,0,0,0,
Inyo,2020-12-18,0,0,0,0,0,0,0,0,0,0,0,0,0,0,
Inyo,2020-12-27,0,493,0,482,0,11,0,0,0,493,0,0,0,493,
Inyo,2021-01-02,0,647,0,590,0,57,0,0,0,647,0,0,0,647,
Inyo,2021-01-17,0,1529,0,1113,0,416,0,0,0,579,0,476,0,1055,
Inyo,2021-01-24,0,2074,0,1390,0,684,0,0,0,889,0,593,0,1482,
Inyo,2021-03-21,0,8953,0,3987,0,4911,0,55,0,1465,0,3765,0,5230,
Inyo,2021-04-18,0,12158,0,4352,0,7435,0,371,0,1807,0,5350,0,7157,
Inyo,2021-05-31,0,15889,0,5731,0,9689,0,469,0,1040,0,7645,0,8685,
Inyo,2021-06-06,0,16030,0,5771,0,9770,0,489,0,1020,0,7735,0,8755,
Inyo,2021-06-20,0,16559,0,6085,0,9954,0,520,0,757,0,8144,0,8901,
Inyo,2021-07-04,0,16813,0,6244,0,10037,0,532,0,749,0,8281,0,9030,
Inyo,2021-07-18,0,16994,0,6361,0,10097,0,536,0,768,0,8363,0,9131,
Inyo,2021-08-22,0,17745,0,6774,0,10423,0,548,0,978,0,8630,0,9608,
Kings,2020-12-15,0,0,0,0,0,0,0,0,0,0,0,0,0,0,
Kings,2020-12-25,0,496,0,478,0,18,0,0,0,601,0,0,0,601,
Lake,2020-12-15,0,0,0,0,0,0,0,0,0,0,0,0,0,0,
Lake,2020-12-16,0,0,0,0,0,0,0,0,0,0,0,0,0,0,
Lake,2020-12-25,0,345,0,331,0,14,0,0,0,345,0,0,0,345,
Lake,2021-01-03,0,669,0,623,0,46,0,0,0,669,0,0,0,669,
Lassen,2020-12-15,0,0,0,0,0,0,0,0,0,0,0,0,0,0,
Lassen,2020-12-25,0,50,0,50,0,0,0,0,0,50,0,0,0,50,
Lassen,2020-12-26,0,50,0,50,0,0,0,0,0,50,0,0,0,50,
Lassen,2020-12-27,0,50,0,50,0,0,0,0,0,50,0,0,0,50,
Lassen,2021-01-01,0,161,0,151,0,10,0,0,0,161,0,0,0,161,
Lassen,2021-01-03,0,162,0,151,0,11,0,0,0,162,0,0,0,162,
Lassen,2021-01-10,0,551,0,247,0,304,0,0,0,542,0,5,0,547,
Lassen,2021-01-23,0,1471,0,558,0,913,0,0,0,1150,0,151,0,1301,
Lassen,2021-01-30,0,1724,0,581,0,1143,0,0,0,1363,0,171,0,1534,
Lassen,2021-01-31,0,1724,0,581,0,1143,0,0,0,1363,0,171,0,1534,
Madera,2020-12-15,0,0,0,0,0,0,0,0,0,0,0,0,0,0,
Madera,2020-12-25,0,381,0,374,0,7,0,0,0,381,0,0,0,381,
Marin,2021-07-04,0,379076,0,239107,0,128714,0,11255,0,14897,0,187041,0,201938,
Mariposa,2020-12-15,0,0,0,0,0,0,0,0,0,0,0,0,0,0,
Mariposa,2020-12-16,0,0,0,0,0,0,0,0,0,0,0,0,0,0,
Mariposa,2020-12-19,0,94,0,94,0,0,0,0,0,97,0,0,0,97,
Mariposa,2020-12-25,0,169,0,168,0,1,0,0,0,175,0,1,0,176,
Mariposa,2021-01-03,0,256,0,181,0,75,0,0,0,262,0,1,0,263,
Mariposa,2021-01-09,0,466,0,329,0,137,0,0,0,202,0,136,0,338,
Mariposa,2021-01-10,0,466,0,329,0,137,0,0,0,202,0,136,0,338,
Mariposa,2021-01-31,0,1289,0,448,0,841,0,0,0,794,0,257,0,1051,
Mariposa,2021-04-25,0,10063,0,1484,0,8215,0,364,0,3089,0,3674,0,6763,
Mariposa,2021-07-11,0,12810,0,2467,0,9830,0,513,0,2742,0,5283,0,8025,
Mariposa,2021-07-25,0,13008,0,2580,0,9906,0,522,0,2790,0,5362,0,8152,
Mendocino,2020-12-15,0,0,0,0,0,0,0,0,0,0,0,0,0,0,
Mendocino,2020-12-16,0,0,0,0,0,0,0,0,0,0,0,0,0,0,
Mendocino,2021-01-03,0,1465,0,906,0,559,0,0,0,1309,0,0,0,1309,
Merced,2020-12-15,0,0,0,0,0,0,0,0,0,0,0,0,0,0,
Modoc,2020-12-15,0,0,0,0,0,0,0,0,0,0,0,0,0,0,
Modoc,2020-12-17,0,2,0,2,0,0,0,0,0,2,0,0,0,2,
Modoc,2020-12-18,0,2,0,2,0,0,0,0,0,2,0,0,0,2,
Modoc,2020-12-19,0,2,0,2,0,0,0,0,0,2,0,0,0,2,
Modoc,2020-12-20,0,2,0,2,0,0,0,0,0,2,0,0,0,2,
Modoc,2020-12-25,0,120,0,120,0,0,0,0,0,120,0,0,0,120,
Modoc,2020-12-26,0,120,0,120,0,0,0,0,0,120,0,0,0,120,
Modoc,2020-12-27,0,120,0,120,0,0,0,0,0,120,0,0,0,120,
Modoc,2020-12-31,0,140,0,125,0,15,0,0,0,140,0,0,0,140,
Modoc,2021-01-01,0,140,0,125,0,15,0,0,0,140,0,0,0,140,
Modoc,2021-01-03,0,143,0,126,0,17,0,0,0,143,0,0,0,143,
Modoc,2021-01-09,0,338,0,132,0,206,0,0,0,334,0,2,0,336,
Modoc,2021-01-17,0,685,0,253,0,432,0,0,0,471,0,107,0,578,
Modoc,2021-01-23,0,873,0,266,0,607,0,0,0,651,0,111,0,762,
Modoc,2021-01-24,0,873,0,266,0,607,0,0,0,651,0,111,0,762,
Modoc,2021-01-30,0,1201,0,276,0,925,0,0,0,947,0,127,0,1074,
Modoc,2021-01-31,0,1201,0,276,0,925,0,0,0,947,0,127,0,1074,
Modoc,2021-02-06,0,1585,0,309,0,1276,0,0,0,1023,0,281,0,1304,
Modoc,2021-02-07,0,1585,0,309,0,1276,0,0,0,1023,0,281,0,1304,
Modoc,2021-02-14,0,2015,0,331,0,1684,0,0,0,931,0,542,0,1473,
Modoc,2021-02-15,0,2015,0,331,0,1684,0,0,0,931,0,542,0,1473,
Modoc,2021-02-21,0,2382,0,348,0,2034,0,0,0,915,0,734,0,1649,
Modoc,2021-02-28,0,2759,0,365,0,2394,0,0,0,670,0,1045,0,1715,
Modoc,2021-03-14,0,3540,0,402,0,2988,0,150,0,585,0,1552,0,2137,
Modoc,2021-03-28,0,4016,0,424,0,3391,0,201,0,551,0,1832,0,2383,
Modoc,2021-04-04,0,4273,0,439,0,3604,0,230,0,460,0,2019,0,2479,
Modoc,2021-05-01,0,4844,0,507,0,4074,0,263,0,313,0,2393,0,2706,
Modoc,2021-05-30,0,5217,0,615,0,4290,0,312,0,253,0,2634,0,2887,
Modoc,2021-06-05,0,5266,0,620,0,4327,0,319,0,233,0,2671,0,2904,
Modoc,2021-06-06,0,5266,0,620,0,4327,0,319,0,233,0,2671,0,2904,
Modoc,2021-06-13,0,5323,0,637,0,4365,0,321,0,237,0,2698,0,2935,
Modoc,2021-06-20,0,5431,0,685,0,4411,0,335,0,259,0,2749,0,3008,
Modoc,2021-06-26,0,5490,0,704,0,4441,0,345,0,280,0,2773,0,3053,
Modoc,2021-06-27,0,5490,0,704,0,4441,0,345,0,280,0,2773,0,3053,
Modoc,2021-07-04,0,5541,0,721,0,4463,0,357,0,297,0,2796,0,3093,
Modoc,2021-07-05,0,5541,0,721,0,4463,0,357,0,297,0,2796,0,3093,
Modoc,2021-07-12,0,5634,0,762,0,4507,0,365,0,274,0,2858,0,3132,
Modoc,2021-07-17,0,5694,0,783,0,4543,0,368,0,251,0,2901,0,3152,
Modoc,2021-07-18,0,5694,0,783,0,4543,0,368,0,251,0,2901,0,3152,
Modoc,2021-07-25,0,5754,0,808,0,4574,0,372,0,247,0,2936,0,3183,
Modoc,2021-08-01,0,5835,0,849,0,4608,0,378,0,254,0,2976,0,3230,
Modoc,2021-08-15,0,5992,0,907,0,4691,0,394,0,307,0,3035,0,3342,
Modoc,2021-08-29,0,6149,0,969,0,4772,0,408,0,326,0,3101,0,3427,
Mono,2020-12-15,0,0,0,0,0,0,0,0,0,0,0,0,0,0,
Mono,2020-12-16,0,0,0,0,0,0,0,0,0,0,0,0,0,0,
Mono,2020-12-17,0,0,0,0,0,0,0,0,0,0,0,0,0,0,
Mono,2020-12-25,0,183,0,145,0,38,0,0,0,183,0,0,0,183,
Mono,2021-01-03,0,399,0,284,0,115,0,0,0,399,0,0,0,399,
Mono,2021-01-17,0,1250,0,538,0,712,0,0,0,960,0,145,0,1105,
Mono,2021-02-14,0,6150,0,4479,0,1671,0,0,0,2178,0,1985,0,4163,
Mono,2021-03-21,0,10643,0,7002,0,3584,0,57,0,2327,0,4176,0,6503,
Mono,2021-03-28,0,11119,0,7377,0,3661,0,81,0,2657,0,4260,0,6917,
Mono,2021-04-11,0,13299,0,7801,0,5323,0,175,0,959,0,6244,0,7203,
Mono,2021-05-30,0,15643,0,8821,0,6567,0,255,0,1032,0,7416,0,8448,
Mono,2021-05-31,0,15643,0,8821,0,6567,0,255,0,1032,0,7416,0,8448,
Mono,2021-07-03,0,16347,0,9247,0,6797,0,303,0,680,0,7967,0,8647,
Mono,2021-07-04,0,16347,0,9247,0,6797,0,303,0,680,0,7967,0,8647,
Mono,2021-07-11,0,16390,0,9266,0,6815,0,309,0,682,0,7990,0,8672,
Mono,2021-07-18,0,16448,0,9297,0,6842,0,309,0,698,0,8010,0,8708,
Mono,2021-07-25,0,16570,0,9364,0,6889,0,317,0,752,0,8047,0,8799,
Mono,2021-08-01,0,16623,0,9379,0,6926,0,318,0,787,0,8056,0,8843,
Mono,2021-08-15,0,16893,0,9538,0,7027,0,328,0,852,0,8160,0,9012,
Mono,2021-08-22,0,16988,0,9585,0,7074,0,329,0,875,0,8189,0,9064,
Mono,2021-08-29,0,17129,0,9683,0,7115,0,331,0,898,0,8238,0,9136,
Monterey,2020-12-15,0,0,0,0,0,0,0,0,0,0,0,0,0,0,
Napa,2020-12-15,0,0,0,0,0,0,0,0,0,0,0,0,0,0,
Napa,2020-12-25,0,1839,0,1655,0,184,0,0,0,1841,0,0,0,1841,
Nevada,2020-12-15,0,0,0,0,0,0,0,0,0,0,0,0,0,0,
Nevada,2021-07-04,0,101703,0,54013,0,45132,0,2558,0,6287,0,48658,0,54945,
Plumas,2020-12-15,0,0,0,0,0,0,0,0,0,0,0,0,0,0,
Plumas,2020-12-16,0,0,0,0,0,0,0,0,0,0,0,0,0,0,
Plumas,2020-12-17,0,0,0,0,0,0,0,0,0,0,0,0,0,0,
Plumas,2020-12-20,0,5,0,5,0,0,0,0,0,5,0,0,0,5,
Plumas,2020-12-25,0,203,0,203,0,0,0,0,0,203,0,0,0,203,
Plumas,2020-12-26,0,203,0,203,0,0,0,0,0,203,0,0,0,203,
Plumas,2020-12-27,0,203,0,203,0,0,0,0,0,203,0,0,0,203,
Plumas,2021-01-03,0,279,0,231,0,48,0,0,0,279,0,0,0,279,
Plumas,2021-01-10,0,495,0,247,0,248,0,0,0,482,0,7,0,489,
Plumas,2021-01-17,0,985,0,460,0,525,0,0,0,593,0,197,0,790,
Plumas,2021-02-07,0,1848,0,559,0,1289,0,0,0,903,0,473,0,1376,
Plumas,2021-04-25,0,13364,0,941,0,11709,0,714,0,1414,0,6308,0,7722,
Plumas,2021-06-27,0,16246,0,1655,0,13613,0,978,0,761,0,8187,0,8948,
Plumas,2021-07-04,0,16370,0,1728,0,13650,0,992,0,752,0,8259,0,9011,
Plumas,2021-07-05,0,16370,0,1728,0,13650,0,992,0,752,0,8259,0,9011,
Plumas,2021-07-18,0,16625,0,1863,0,13743,0,1019,0,755,0,8398,0,9153,
Plumas,2021-07-25,0,16742,0,1934,0,13773,0,1035,0,744,0,8470,0,9214,
San Benito,2020-12-15,0,0,0,0,0,0,0,0,0,0,0,0,0,0,
San Benito,2021-01-01,0,721,0,596,0,125,0,0,0,721,0,0,0,721,
Santa Barbara,2020-12-25,0,2533,0,2361,0,172,0,0,0,2531,0,0,0,2531,
Shasta,2020-12-25,0,1176,0,1165,0,11,0,0,0,1176,0,0,0,1176,
Sierra,2020-12-15,0,0,0,0,0,0,0,0,0,0,0,0,0,0,
Sierra,2020-12-16,0,0,0,0,0,0,0,0,0,0,0,0,0,0,
Sierra,2020-12-17,0,0,0,0,0,0,0,0,0,0,0,0,0,0,
Sierra,2020-12-19,0,1,0,1,0,0,0,0,0,1,0,0,0,1,
Sierra,2020-12-20,0,1,0,1,0,0,0,0,0,1,0,0,0,1,
Sierra,2020-12-24,0,19,0,19,0,0,0,0,0,19,0,0,0,19,
Sierra,2020-12-25,0,19,0,19,0,0,0,0,0,19,0,0,0,19,
Sierra,2020-12-26,0,19,0,19,0,0,0,0,0,19,0,0,0,19,
Sierra,2020-12-27,0,19,0,19,0,0,0,0,0,19,0,0,0,19,
Sierra,2021-01-02,0,85,0,27,0,58,0,0,0,85,0,0,0,85,
Sierra,2021-01-03,0,85,0,27,0,58,0,0,0,85,0,0,0,85,
Sierra,2021-01-04,0,85,0,27,0,58,0,0,0,85,0,0,0,85,
Sierra,2021-01-08,0,171,0,32,0,139,0,0,0,169,0,1,0,170,
Sierra,2021-01-09,0,171,0,32,0,139,0,0,0,169,0,1,0,170,
Sierra,2021-01-10,0,171,0,32,0,139,0,0,0,169,0,1,0,170,
Sierra,2021-01-16,0,253,0,53,0,200,0,0,0,215,0,19,0,234,
Sierra,2021-01-17,0,253,0,53,0,200,0,0,0,215,0,19,0,234,
Sierra,2021-01-24,0,348,0,54,0,294,0,0,0,307,0,21,0,328,
Sierra,2021-01-31,0,471,0,63,0,408,0,0,0,324,0,74,0,398,
Sierra,2021-02-06,0,640,0,71,0,569,0,0,0,314,0,163,0,477,
Sierra,2021-02-07,0,640,0,71,0,569,0,0,0,314,0,163,0,477,
Sierra,2021-02-08,0,640,0,71,0,569,0,0,0,314,0,163,0,477,
Sierra,2021-02-13,0,911,0,73,0,838,0,0,0,453,0,229,0,682,
Sierra,2021-02-14,0,911,0,73,0,838,0,0,0,453,0,229,0,682,
Sierra,2021-02-21,0,1110,0,78,0,1032,0,0,0,464,0,322,0,786,
Sierra,2021-02-22,0,1110,0,78,0,1032,0,0,0,464,0,322,0,786,
Sierra,2021-02-27,0,1248,0,83,0,1165,0,0,0,463,0,391,0,854,
Sierra,2021-02-28,0,1248,0,83,0,1165,0,0,0,463,0,391,0,854,
Sierra,2021-03-01,0,1248,0,83,0,1165,0,0,0,463,0,391,0,854,
Sierra,2021-03-03,0,1307,0,83,0,1224,0,0,0,482,0,411,0,893,
Sierra,2021-03-06,0,1427,0,83,0,1344,0,0,0,500,0,462,0,962,
Sierra,2021-03-07,0,1427,0,83,0,1344,0,0,0,500,0,462,0,962,
Sierra,2021-03-14,0,1710,0,85,0,1625,0,0,0,387,0,660,0,1047,
Sierra,2021-03-21,0,1913,0,85,0,1825,0,3,0,362,0,775,0,1137,
Sierra,2021-03-22,0,1913,0,85,0,1825,0,3,0,362,0,775,0,1137,
Sierra,2021-03-28,0,2049,0,86,0,1960,0,3,0,369,0,839,0,1208,
Sierra,2021-04-03,0,2183,0,89,0,2091,0,3,0,320,0,928,0,1248,
Sierra,2021-04-05,0,2184,0,89,0,2092,0,3,0,320,0,928,0,1248,
Sierra,2021-04-11,0,2287,0,93,0,2186,0,8,0,263,0,1010,0,1273,
Sierra,2021-04-16,0,2384,0,95,0,2280,0,9,0,184,0,1098,0,1282,
Sierra,2021-04-25,0,2502,0,100,0,2393,0,9,0,108,0,1194,0,1302,
Sierra,2021-05-02,0,2567,0,105,0,2453,0,9,0,87,0,1236,0,1323,
Sierra,2021-05-07,0,2597,0,109,0,2478,0,10,0,79,0,1255,0,1334,
Sierra,2021-05-09,0,2598,0,109,0,2478,0,11,0,79,0,1256,0,1335,
Sierra,2021-05-10,0,2598,0,109,0,2478,0,11,0,79,0,1256,0,1335,
Sierra,2021-05-16,0,2628,0,112,0,2496,0,20,0,84,0,1273,0,1357,
Sierra,2021-05-23,0,2654,0,125,0,2507,0,22,0,86,0,1286,0,1372,
Sierra,2021-05-31,0,2684,0,130,0,2531,0,23,0,86,0,1302,0,1388,
Sierra,2021-06-05,0,2713,0,133,0,2555,0,25,0,62,0,1329,0,1391,
Sierra,2021-06-06,0,2713,0,133,0,2555,0,25,0,62,0,1329,0,1391,
Sierra,2021-06-07,0,2713,0,133,0,2555,0,25,0,62,0,1329,0,1391,
Sierra,2021-06-13,0,2737,0,146,0,2564,0,27,0,56,0,1345,0,1401,
Sierra,2021-06-19,0,2759,0,155,0,2573,0,31,0,55,0,1358,0,1413,
Sierra,2021-06-20,0,2759,0,155,0,2573,0,31,0,55,0,1358,0,1413,
Sierra,2021-06-25,0,2776,0,157,0,2585,0,34,0,53,0,1369,0,1422,
Sierra,2021-06-29,0,2779,0,159,0,2585,0,35,0,55,0,1370,0,1425,
Sierra,2021-07-04,0,2788,0,165,0,2587,0,36,0,53,0,1376,0,1429,
Sierra,2021-07-05,0,2788,0,165,0,2587,0,36,0,53,0,1376,0,1429,
Sierra,2021-07-06,0,2788,0,165,0,2587,0,36,0,53,0,1376,0,1429,
Sierra,2021-07-10,0,2798,0,174,0,2588,0,36,0,53,0,1381,0,1434,
Sierra,2021-07-11,0,2798,0,174,0,2588,0,36,0,53,0,1381,0,1434,
Sierra,2021-07-17,0,2811,0,180,0,2593,0,38,0,53,0,1388,0,1441,
Sierra,2021-07-19,0,2814,0,183,0,2593,0,38,0,54,0,1389,0,1443,
Sierra,2021-07-20,0,2814,0,183,0,2593,0,38,0,54,0,1389,0,1443,
Sierra,2021-07-24,0,2828,0,189,0,2601,0,38,0,58,0,1394,0,1452,
Sierra,2021-07-25,0,2828,0,189,0,2601,0,38,0,58,0,1394,0,1452,
Sierra,2021-07-28,0,2831,0,191,0,2602,0,38,0,58,0,1395,0,1453,
Sierra,2021-07-31,0,2839,0,195,0,2606,0,38,0,58,0,1399,0,1457,
Sierra,2021-08-01,0,2839,0,195,0,2606,0,38,0,58,0,1399,0,1457,
Sierra,2021-08-07,0,2859,0,208,0,2609,0,42,0,70,0,1405,0,1475,
Sierra,2021-08-08,0,2859,0,208,0,2609,0,42,0,70,0,1405,0,1475,
Sierra,2021-08-13,0,2875,0,220,0,2611,0,44,0,72,0,1413,0,1485,
Sierra,2021-08-14,0,2875,0,220,0,2611,0,44,0,72,0,1413,0,1485,
Sierra,2021-08-15,0,2875,0,220,0,2611,0,44,0,72,0,1413,0,1485,
Sierra,2021-08-21,0,2899,0,234,0,2619,0,46,0,79,0,1422,0,1501,
Sierra,2021-08-22,0,2899,0,234,0,2619,0,46,0,79,0,1422,0,1501,
Sierra,2021-08-28,0,2940,0,264,0,2627,0,49,0,86,0,1441,0,1527,
Sierra,2021-08-29,0,2940,0,264,0,2627,0,49,0,86,0,1441,0,1527,
Siskiyou,2020-12-15,0,0,0,0,0,0,0,0,0,0,0,0,0,0,
Siskiyou,2020-12-25,0,454,0,453,0,1,0,0,0,454,0,0,0,454,
Siskiyou,2021-01-01,0,592,0,465,0,127,0,0,0,592,0,0,0,592,
Siskiyou,2021-01-10,0,1267,0,490,0,777,0,0,0,1247,0,10,0,1257,
Siskiyou,2021-01-24,0,3537,0,2193,0,1344,0,0,0,2616,0,461,0,3077,
Siskiyou,2021-05-30,0,30489,0,12055,0,17621,0,813,0,2996,0,14124,0,17120,
Siskiyou,2021-06-27,0,32606,0,13164,0,18544,0,898,0,2360,0,15525,0,17885,
Siskiyou,2021-07-04,0,32863,0,13297,0,18658,0,908,0,2360,0,15658,0,18018,
Stanislaus,2020-12-25,0,3071,0,3022,0,49,0,0,0,3069,0,2,0,3071,
Sutter,2020-12-25,0,522,0,511,0,11,0,0,0,522,0,0,0,522,
Tehama,2020-12-15,0,0,0,0,0,0,0,0,0,0,0,0,0,0,
Tehama,2020-12-19,0,30,0,30,0,0,0,0,0,30,0,0,0,30,
Tehama,2020-12-20,0,30,0,30,0,0,0,0,0,30,0,0,0,30,
Tehama,2020-12-25,0,216,0,200,0,16,0,0,0,216,0,0,0,216,
Tehama,2021-01-02,0,408,0,346,0,62,0,0,0,407,0,0,0,407,
Tehama,2021-01-03,0,408,0,346,0,62,0,0,0,407,0,0,0,407,
Trinity,2020-12-15,0,0,0,0,0,0,0,0,0,0,0,0,0,0,
Trinity,2020-12-16,0,0,0,0,0,0,0,0,0,0,0,0,0,0,
Trinity,2020-12-19,0,5,0,5,0,0,0,0,0,5,0,0,0,5,
Trinity,2020-12-20,0,5,0,5,0,0,0,0,0,5,0,0,0,5,
Trinity,2020-12-24,0,53,0,52,0,1,0,0,0,53,0,0,0,53,
Trinity,2020-12-25,0,53,0,52,0,1,0,0,0,53,0,0,0,53,
Trinity,2020-12-26,0,53,0,52,0,1,0,0,0,53,0,0,0,53,
Trinity,2020-12-27,0,53,0,52,0,1,0,0,0,53,0,0,0,53,
Trinity,2021-01-01,0,103,0,98,0,5,0,0,0,103,0,0,0,103,
Trinity,2021-01-02,0,103,0,98,0,5,0,0,0,103,0,0,0,103,
Trinity,2021-01-03,0,103,0,98,0,5,0,0,0,103,0,0,0,103,
Trinity,2021-01-07,0,156,0,103,0,53,0,0,0,147,0,4,0,151,
Trinity,2021-01-09,0,204,0,104,0,100,0,0,0,194,0,5,0,199,
Trinity,2021-01-10,0,204,0,104,0,100,0,0,0,194,0,5,0,199,
Trinity,2021-01-17,0,274,0,153,0,121,0,0,0,174,0,50,0,224,
Trinity,2021-01-24,0,390,0,214,0,176,0,0,0,196,0,97,0,293,
Trinity,2021-01-31,0,457,0,229,0,228,0,0,0,251,0,103,0,354,
Trinity,2021-02-28,0,2351,0,377,0,1974,0,0,0,1631,0,360,0,1991,
Tulare,2020-12-25,0,2147,0,2134,0,13,0,0,0,2164,0,0,0,2164,
Tuolumne,2020-12-15,0,0,0,0,0,0,0,0,0,0,0,0,0,0,
Tuolumne,2020-12-24,0,649,0,630,0,19,0,0,0,647,0,1,0,648,
Tuolumne,2020-12-27,0,652,0,633,0,19,0,0,0,650,0,1,0,651,
Unknown,2020-12-15,0,0,0,0,0,0,0,0,0,0,0,0,0,0,
Unknown,2020-12-16,0,0,0,0,0,0,0,0,0,0,0,0,0,0,
Unknown,2020-12-19,0,3,0,3,0,0,0,0,0,0,0,0,0,0,
Unknown,2020-12-20,0,3,0,3,0,0,0,0,0,0,0,0,0,0,
Unknown,2020-12-22,0,7,0,7,0,0,0,0,0,0,0,0,0,0,
Unknown,2020-12-23,0,7,0,7,0,0,0,0,0,0,0,0,0,0,
Unknown,2020-12-24,0,7,0,7,0,0,0,0,0,0,0,0,0,0,
Unknown,2020-12-25,0,7,0,7,0,0,0,0,0,0,0,0,0,0,
Unknown,2020-12-26,0,7,0,7,0,0,0,0,0,0,0,0,0,0,
Unknown,2020-12-27,0,7,0,7,0,0,0,0,0,0,0,0,0,0,
Unknown,2020-12-28,0,7,0,7,0,0,0,0,0,0,0,0,0,0,
Unknown,2021-01-01,0,65,0,63,0,2,0,0,0,59,0,0,0,59,
Unknown,2021-01-03,0,66,0,63,0,3,0,0,0,60,0,0,0,60,
Unknown,2021-01-05,0,67,0,64,0,3,0,0,0,61,0,0,0,61,
Unknown,2021-01-08,0,139,0,134,0,5,0,0,1,133,0,0,1,133,
Unknown,2021-01-10,0,140,0,135,0,5,0,0,0,134,0,0,0,134,
Unknown,2021-01-17,0,185,0,178,0,7,0,0,0,176,0,1,0,177,
Unknown,2021-07-04,0,2935,0,1930,0,827,0,178,0,465,0,1309,0,1774,
Yuba,2020-12-15,0,0,0,0,0,0,0,0,0,0,0,0,0,0,
Yuba,2021-01-01,0,517,0,349,0,168,0,0,0,517,0,0,0,517,
Outside California,2020-12-15,14,14,14,14,0,0,0,0,14,14,0,0,14,14,Not in California
Outside California,2020-12-16,256,270,256,270,0,0,0,0,256,270,0,0,256,270,Not in California
Outside California,2020-12-17,1427,1697,1427,1697,0,0,0,0,1427,1697,0,0,1427,1697,Not in California
Outside California,2020-12-18,2202,3899,2196,3893,6,6,0,0,2202,3899,0,0,2202,3899,Not in California
Outside California,2020-12-19,920,4819,920,4813,0,6,0,0,920,4819,0,0,920,4819,Not in California
Outside California,2020-12-20,637,5456,633,5446,4,10,0,0,637,5456,0,0,637,5456,Not in California
Outside California,2020-12-21,2036,7492,2032,7478,4,14,0,0,2036,7492,0,0,2036,7492,Not in California
Outside California,2020-12-22,1943,9435,1869,9347,74,88,0,0,1943,9435,0,0,1943,9435,Not in California
Outside California,2020-12-23,1459,10894,1315,10662,144,232,0,0,1458,10892,1,1,1458,10893,Not in California
Outside California,2020-12-24,773,11667,582,11244,191,423,0,0,773,11665,0,1,773,11666,Not in California
Outside California,2020-12-25,29,11696,24,11268,5,428,0,0,29,11694,0,1,29,11695,Not in California
Outside California,2020-12-26,301,11997,197,11465,104,532,0,0,301,11995,0,1,301,11996,Not in California
Outside California,2020-12-27,195,12192,79,11544,116,648,0,0,195,12190,0,1,195,12191,Not in California
Outside California,2020-12-28,1345,13537,840,12384,505,1153,0,0,1345,13535,0,1,1345,13536,Not in California
Outside California,2020-12-29,1533,15070,968,13352,565,1718,0,0,1533,15068,0,1,1533,15069,Not in California
Outside California,2020-12-30,1828,16898,1163,14515,665,2383,0,0,1828,16896,0,1,1828,16897,Not in California
Outside California,2020-12-31,1095,17993,567,15082,528,2911,0,0,1094,17989,1,2,1094,17991,Not in California
Outside California,2021-01-01,129,18122,33,15115,96,3007,0,0,129,18118,0,2,129,18120,Not in California
Outside California,2021-01-02,255,18377,139,15254,116,3123,0,0,254,18371,1,3,254,18374,Not in California
Outside California,2021-01-03,204,18581,97,15351,107,3230,0,0,202,18572,1,4,202,18576,Not in California
Outside California,2021-01-04,1156,19737,517,15868,639,3869,0,0,1150,19720,2,6,1150,19726,Not in California
Outside California,2021-01-05,1552,21289,805,16673,747,4616,0,0,1368,20908,182,188,1370,21096,Not in California
Outside California,2021-01-06,2512,23801,1447,18120,1065,5681,0,0,1903,22205,607,795,1904,23000,Not in California
Outside California,2021-01-07,3778,27579,2246,20366,1532,7213,0,0,2379,23189,1397,2192,2381,25381,Not in California
Outside California,2021-01-08,4154,31733,2608,22974,1546,8759,0,0,2500,24051,1643,3835,2505,27886,Not in California
Outside California,2021-01-09,1243,32976,526,23500,717,9476,0,0,923,24657,318,4153,924,28810,Not in California
Outside California,2021-01-10,310,33286,188,23688,122,9598,0,0,188,24723,122,4275,188,28998,Not in California
Outside California,2021-01-11,3091,36377,1884,25572,1207,10805,0,0,1826,25286,1264,5539,1827,30825,Not in California
Outside California,2021-01-12,3700,40077,2187,27759,1513,12318,0,0,2209,26061,1487,7026,2262,33087,Not in California
Outside California,2021-01-13,3499,43576,1724,29483,1775,14093,0,0,2370,27307,1128,8154,2374,35461,Not in California
Outside California,2021-01-14,3541,47117,1248,30731,2293,16386,0,0,2914,29610,614,8768,2917,38378,Not in California
Outside California,2021-01-15,3982,51099,975,31706,3007,19393,0,0,3537,32713,434,9202,3537,41915,Not in California
Outside California,2021-01-16,2549,53648,395,32101,2154,21547,0,0,2376,34918,171,9373,2376,44291,Not in California
Outside California,2021-01-17,532,54180,165,32266,367,21914,0,0,473,35332,59,9432,473,44764,Not in California
Outside California,2021-01-18,1184,55364,770,33036,414,22328,0,0,738,35626,445,9877,739,45503,Not in California
Outside California,2021-01-19,4041,59405,1334,34370,2707,25035,0,0,3179,37946,862,10739,3182,48685,Not in California
Outside California,2021-01-20,4369,63774,1402,35772,2967,28002,0,0,3459,40502,904,11643,3460,52145,Not in California
Outside California,2021-01-21,4089,67863,1157,36929,2932,30934,0,0,3528,43485,545,12188,3528,55673,Not in California
Outside California,2021-01-22,4471,72334,1108,38037,3363,34297,0,0,4069,47163,393,12581,4071,59744,Not in California
Outside California,2021-01-23,2172,74506,358,38395,1814,36111,0,0,2000,48994,169,12750,2000,61744,Not in California
Outside California,2021-01-24,559,75065,250,38645,309,36420,0,0,480,49395,79,12829,480,62224,Not in California
Outside California,2021-01-25,4359,79424,1836,40481,2523,38943,0,0,3491,52028,859,13688,3492,65716,Not in California
Outside California,2021-01-26,5640,85064,2595,43076,3045,41988,0,0,4773,55943,866,14554,4781,70497,Not in California
Outside California,2021-01-27,4709,89773,2333,45409,2376,44364,0,0,4049,59340,655,15209,4052,74549,Not in California
Outside California,2021-01-28,4699,94472,2394,47803,2305,46669,0,0,4153,62957,537,15746,4154,78703,Not in California
Outside California,2021-01-29,4519,98991,2692,50495,1827,48496,0,0,3707,65862,805,16551,3710,82413,Not in California
Outside California,2021-01-30,4012,103003,2010,52505,2002,50498,0,0,3760,69374,250,16801,3762,86175,Not in California
Outside California,2021-01-31,2717,105720,2313,54818,404,50902,0,0,2650,71962,65,16866,2653,88828,Not in California
Outside California,2021-02-01,5396,111116,2374,57192,3022,53924,0,0,4687,75949,700,17566,4687,93515,Not in California
Outside California,2021-02-02,6597,117713,1952,59144,4645,58569,0,0,5850,81067,732,18298,5850,99365,Not in California
Outside California,2021-02-03,7159,124872,1838,60982,5321,63890,0,0,6277,86468,878,19176,6279,105644,Not in California
Outside California,2021-02-04,6631,131503,1908,62890,4723,68613,0,0,5573,90997,1045,20221,5574,111218,Not in California
Outside California,2021-02-05,6716,138219,2127,65017,4589,73202,0,0,5581,95451,1127,21348,5581,116799,Not in California
Outside California,2021-02-06,4181,142400,1956,66973,2225,75427,0,0,3705,98694,466,21814,3709,120508,Not in California
Outside California,2021-02-07,1967,144367,1565,68538,402,75829,0,0,1872,100475,94,21908,1875,122383,Not in California
Outside California,2021-02-08,4687,149054,2720,71258,1967,77796,0,0,3606,103010,1072,22980,3607,125990,Not in California
Outside California,2021-02-09,4177,153231,1789,73047,2388,80184,0,0,2818,104495,1334,24314,2819,128809,Not in California
Outside California,2021-02-10,5271,158502,1654,74701,3617,83801,0,0,2840,104967,2381,26695,2853,131662,Not in California
Outside California,2021-02-11,4579,163081,1987,76688,2592,86393,0,0,3241,106906,1320,28015,3259,134921,Not in California
Outside California,2021-02-12,5226,168307,1875,78563,3351,89744,0,0,3327,108359,1877,29892,3330,138251,Not in California
Outside California,2021-02-13,2356,170663,679,79242,1677,91421,0,0,1733,109488,618,30510,1747,139998,Not in California
Outside California,2021-02-14,1307,171970,368,79610,939,92360,0,0,1021,110233,278,30788,1023,141021,Not in California
Outside California,2021-02-15,2525,174495,1455,81065,1070,93430,0,0,1241,110207,1269,32057,1243,142264,Not in California
Outside California,2021-02-16,6402,180897,2617,83682,3785,97215,0,0,2532,108890,3853,35910,2536,144800,Not in California
Outside California,2021-02-17,5619,186516,2648,86330,2971,100186,0,0,1776,106841,3830,39740,1781,146581,Not in California
Outside California,2021-02-18,6069,192585,3257,89587,2812,102998,0,0,1931,104669,4103,43843,1931,148512,Not in California
Outside California,2021-02-19,5371,197956,3598,93185,1773,104771,0,0,2321,103954,3038,46881,2323,150835,Not in California
Outside California,2021-02-20,3119,201075,2420,95605,699,105470,0,0,1265,103373,1846,48727,1265,152100,Not in California
Outside California,2021-02-21,2587,203662,2330,97935,257,105727,0,0,883,102568,1688,50415,883,152983,Not in California
Outside California,2021-02-22,3564,207226,2521,100456,1043,106770,0,0,1690,102399,1864,52279,1695,154678,Not in California
Outside California,2021-02-23,6516,213742,3424,103880,3092,109862,0,0,2522,101033,3902,56181,2536,157214,Not in California
Outside California,2021-02-24,6764,220506,3533,107413,3231,113093,0,0,2582,99485,4135,60316,2587,159801,Not in California
Outside California,2021-02-25,7349,227855,3533,110946,3816,116909,0,0,3293,98779,4006,64322,3300,163101,Not in California
Outside California,2021-02-26,7506,235361,3827,114773,3679,120588,0,0,3386,98149,4017,68339,3387,166488,Not in California
Outside California,2021-02-27,6090,241451,2904,117677,3185,123773,1,1,2096,96281,3968,72307,2100,168588,Not in California
Outside California,2021-02-28,2530,243981,1797,119474,732,124505,1,2,911,95589,1606,73913,914,169502,Not in California
Outside California,2021-03-01,5013,248994,2974,122448,2037,126542,2,4,1594,93783,3406,77319,1600,171102,Not in California
Outside California,2021-03-02,7700,256694,2704,125152,4996,131538,0,4,2440,90998,5229,82548,2444,173546,Not in California
Outside California,2021-03-03,8447,265141,3053,128205,5390,136928,4,8,3077,88743,5342,87890,3087,176633,Not in California
Outside California,2021-03-04,7290,272431,2836,131041,4446,141374,8,16,2676,86847,4584,92474,2688,179321,Not in California
Outside California,2021-03-05,5740,278171,2708,133749,3011,144385,21,37,3010,87174,2712,95186,3039,182360,Not in California
Outside California,2021-03-06,4762,282933,2115,135864,2486,146871,161,198,2440,87466,2313,97499,2605,184965,Not in California
Outside California,2021-03-07,1689,284622,968,136832,567,147438,154,352,985,87913,698,98197,1145,186110,Not in California
Outside California,2021-03-08,3190,287812,1885,138717,1060,148498,245,597,2236,89473,921,99118,2481,188591,Not in California
Outside California,2021-03-09,4723,292535,2436,141153,1993,150491,294,891,2792,90642,1916,101034,3085,191676,Not in California
Outside California,2021-03-10,4441,296976,2132,143285,1806,152297,503,1394,2710,92133,1717,102751,3208,194884,Not in California
Outside California,2021-03-11,6242,303218,3188,146473,2397,154694,657,2051,3306,93169,2922,105673,3958,198842,Not in California
Outside California,2021-03-12,6513,309731,3912,150385,1901,156595,700,2751,3576,94512,2922,108595,4265,203107,Not in California
Outside California,2021-03-13,3800,313531,2184,152569,1164,157759,452,3203,2581,96329,1210,109805,3027,206134,Not in California
Outside California,2021-03-14,1793,315324,937,153506,527,158286,329,3532,978,96822,806,110611,1299,207433,Not in California
Outside California,2021-03-15,4104,319428,2164,155670,1473,159759,467,3999,2186,97571,1901,112512,2650,210083,Not in California
Outside California,2021-03-16,7654,327082,4424,160094,2825,162584,405,4404,4215,98767,3416,115928,4612,214695,Not in California
Outside California,2021-03-17,8511,335593,5499,165593,2627,165211,385,4789,5060,100771,3436,119364,5440,220135,Not in California
Outside California,2021-03-18,8394,343987,5186,170779,2666,167877,542,5331,4801,102529,3580,122944,5338,225473,Not in California
Outside California,2021-03-19,7440,351427,4420,175199,2476,170353,544,5875,4371,104391,3054,125998,4916,230389,Not in California
Outside California,2021-03-20,4836,356263,3185,178384,1551,171904,100,5975,3621,106911,1202,127200,3722,234111,Not in California
Outside California,2021-03-21,2160,358423,1481,179865,589,172493,90,6065,1696,108235,459,127659,1783,235894,Not in California
Outside California,2021-03-22,3433,361856,2080,181945,1254,173747,99,6164,2311,109529,1110,128769,2404,238298,Not in California
Outside California,2021-03-23,6336,368192,3250,185195,2772,176519,314,6478,4172,111882,2130,130899,4483,242781,Not in California
Outside California,2021-03-24,7489,375681,3847,189042,3195,179714,447,6925,5083,115019,2388,133287,5525,248306,Not in California
Outside California,2021-03-25,8443,384124,3899,192941,4008,183722,536,7461,6066,119264,2355,135642,6600,254906,Not in California
Outside California,2021-03-26,6879,391003,3605,196546,3089,186811,185,7646,4471,121539,2377,138019,4652,259558,Not in California
Outside California,2021-03-27,5664,396667,3157,199703,2281,189092,226,7872,3538,123187,2112,140131,3760,263318,Not in California
Outside California,2021-03-28,3131,399798,1667,201370,1302,190394,162,8034,2016,124259,1105,141236,2177,265495,Not in California
Outside California,2021-03-29,5385,405183,2415,203785,2623,193017,347,8381,3070,125370,2307,143543,3418,268913,Not in California
Outside California,2021-03-30,7067,412250,3706,207491,2775,195792,586,8967,4148,127201,2905,146448,4736,273649,Not in California
Outside California,2021-03-31,6571,418821,3921,211412,1863,197655,787,9754,3517,128447,3043,149491,4289,277938,Not in California
Outside California,2021-04-01,7823,426644,4680,216092,2472,200127,671,10425,4518,130330,3288,152779,5171,283109,Not in California
Outside California,2021-04-02,8652,435296,4610,220702,2914,203041,1128,11553,4495,131800,4138,156917,5608,288717,Not in California
Outside California,2021-04-03,6432,441728,3849,224551,1429,204470,1154,12707,3451,133426,2969,159886,4595,293312,Not in California
Outside California,2021-04-04,1860,443588,920,225471,702,205172,238,12945,1005,133807,851,160737,1232,294544,Not in California
Outside California,2021-04-05,4367,447955,2132,227603,1540,206712,695,13640,2083,134302,2271,163008,2766,297310,Not in California
Outside California,2021-04-06,7407,455362,3998,231601,1748,208460,1661,15301,3019,134606,4364,167372,4668,301978,Not in California
Outside California,2021-04-07,8492,463854,4776,236377,1981,210441,1735,17036,3366,134577,5109,172481,5080,307058,Not in California
Outside California,2021-04-08,8491,472345,4479,240856,2038,212479,1974,19010,3430,134903,5045,177526,5371,312429,Not in California
Outside California,2021-04-09,7803,480148,4030,244886,1803,214282,1970,20980,3055,135178,4730,182256,5005,317434,Not in California
Outside California,2021-04-10,6285,486433,3124,248010,1300,215582,1861,22841,1819,134390,4452,186708,3664,321098,Not in California
Outside California,2021-04-11,2958,489391,1630,249640,666,216248,662,23503,1022,134134,1930,188638,1674,322772,Not in California
Outside California,2021-04-12,4371,493762,2461,252101,1321,217569,589,24092,1946,134251,2415,191053,2532,325304,Not in California
Outside California,2021-04-13,5981,499743,3792,255893,2164,219733,25,24117,3083,134469,2889,193942,3107,328411,Not in California
Outside California,2021-04-14,5701,505444,3652,259545,2045,221778,4,24121,3102,134989,2587,196529,3107,331518,Not in California
Outside California,2021-04-15,6340,511784,3983,263528,2351,224129,6,24127,3367,135450,2913,199442,3374,334892,Not in California
Outside California,2021-04-16,6120,517904,3511,267039,2600,226729,9,24136,3384,136127,2719,202161,3396,338288,Not in California
Outside California,2021-04-17,5708,523612,3588,270627,2119,228848,1,24137,3273,136983,2417,204578,3273,341561,Not in California
Outside California,2021-04-18,2272,525884,1324,271951,947,229795,1,24138,1110,136943,1154,205732,1114,342675,Not in California
Outside California,2021-04-19,4310,530194,2096,274047,2212,232007,2,24140,2180,137012,2116,207848,2185,344860,Not in California
Outside California,2021-04-20,5685,535879,2647,276694,3036,235043,2,24142,2306,135959,3362,211210,2309,347169,Not in California
Outside California,2021-04-21,6847,542726,3009,279703,3830,238873,8,24150,2451,134041,4376,215586,2458,349627,Not in California
Outside California,2021-04-22,7231,549957,3721,283424,3507,242380,3,24153,2645,132128,4565,220151,2652,352279,Not in California
Outside California,2021-04-23,6205,556162,3238,286662,2965,245345,2,24155,2512,130977,3668,223819,2517,354796,Not in California
Outside California,2021-04-24,4881,561043,3216,289878,1661,247006,4,24159,1940,129996,2927,226746,1946,356742,Not in California
Outside California,2021-04-25,2315,563358,1314,291192,1000,248006,1,24160,1220,130128,1092,227838,1224,357966,Not in California
Outside California,2021-04-26,4357,567715,1986,293178,2342,250348,29,24189,1939,129696,2402,230240,1970,359936,Not in California
Outside California,2021-04-27,5962,573677,2328,295506,3265,253613,369,24558,2073,128273,3874,234114,2451,362387,Not in California
Outside California,2021-04-28,5160,578837,2286,297792,2477,256090,397,24955,1963,127456,3172,237286,2355,364742,Not in California
Outside California,2021-04-29,5113,583950,2448,300240,2223,258313,442,25397,1902,126615,3185,240471,2344,367086,Not in California
Outside California,2021-04-30,5213,589163,2579,302819,2200,260513,434,25831,1917,125690,3278,243749,2353,369439,Not in California
Outside California,2021-05-01,3338,592501,1936,304755,969,261482,433,26264,1301,125409,2018,245767,1737,371176,Not in California
Outside California,2021-05-02,1921,594422,1149,305904,648,262130,124,26388,820,125266,1091,246858,948,372124,Not in California
Outside California,2021-05-03,3084,597506,1715,307619,1073,263203,296,26684,1182,124848,1895,248753,1477,373601,Not in California
Outside California,2021-05-04,4168,601674,2285,309904,1436,264639,447,27131,1347,123832,2808,251561,1792,375393,Not in California
Outside California,2021-05-05,4729,606403,2694,312598,1653,266292,382,27513,1660,122818,3057,254618,2043,377436,Not in California
Outside California,2021-05-06,4717,611120,2923,315521,1459,267751,335,27848,1606,121661,3098,257716,1941,379377,Not in California
Outside California,2021-05-07,4846,615966,2830,318351,1624,269375,392,28240,1633,120493,3192,260908,2024,381401,Not in California
Outside California,2021-05-08,3393,619359,2314,320665,824,270199,255,28495,1098,119566,2280,263188,1353,382754,Not in California
Outside California,2021-05-09,1427,620786,965,321630,339,270538,123,28618,566,119399,855,264043,688,383442,Not in California
Outside California,2021-05-10,2698,623484,1277,322907,1090,271628,331,28949,935,118913,1753,265796,1267,384709,Not in California
Outside California,2021-05-11,3299,626783,1673,324580,1321,272949,305,29254,1180,118289,2109,267905,1485,386194,Not in California
Outside California,2021-05-12,3372,630155,1648,326228,1390,274339,334,29588,1272,117800,2093,269998,1604,387798,Not in California
Outside California,2021-05-13,3352,633507,1965,328193,1174,275513,213,29801,1406,117482,1937,271935,1619,389417,Not in California
Outside California,2021-05-14,3702,637209,2101,330294,1357,276870,244,30045,1600,117238,2091,274026,1847,391264,Not in California
Outside California,2021-05-15,2763,639972,1644,331938,974,277844,145,30190,1159,116949,1596,275622,1307,392571,Not in California
Outside California,2021-05-16,1690,641662,1108,333046,518,278362,64,30254,758,116844,929,276551,824,393395,Not in California
Outside California,2021-05-17,3133,644795,1687,334733,1213,279575,233,30487,1311,116573,1813,278364,1542,394937,Not in California
Outside California,2021-05-18,3312,648107,1684,336417,1321,280896,307,30794,1438,116460,1859,280223,1746,396683,Not in California
Outside California,2021-05-19,3423,651530,1721,338138,1429,282325,273,31067,1445,116210,1967,282190,1717,398400,Not in California
Outside California,2021-05-20,3267,654797,1821,339959,1197,283522,249,31316,1439,116086,1816,284006,1692,400092,Not in California
Outside California,2021-05-21,3244,658041,1811,341770,1183,284705,250,31566,1343,115792,1887,285893,1593,401685,Not in California
Outside California,2021-05-22,2863,660904,1884,343654,779,285484,200,31766,1516,116171,1338,287231,1717,403402,Not in California
Outside California,2021-05-23,1598,662502,1038,344692,481,285965,79,31845,796,116248,798,288029,875,404277,Not in California
Outside California,2021-05-24,2499,665001,1211,345903,941,286906,347,32192,1074,116255,1414,289443,1421,405698,Not in California
Outside California,2021-05-25,2459,667460,1159,347062,964,287870,336,32528,1028,116197,1419,290862,1361,407059,Not in California
Outside California,2021-05-26,2425,669885,1134,348196,937,288807,354,32882,990,116119,1423,292285,1345,408404,Not in California
Outside California,2021-05-27,2234,672119,1106,349302,827,289634,301,33183,996,116183,1231,293516,1295,409699,Not in California
Outside California,2021-05-28,2510,674629,1273,350575,882,290516,355,33538,1118,116271,1384,294900,1472,411171,Not in California
Outside California,2021-05-29,1712,676341,856,351431,496,291012,360,33898,715,116354,992,295892,1075,412246,Not in California
Outside California,2021-05-30,936,677277,579,352010,230,291242,127,34025,465,116481,465,296357,592,412838,Not in California
Outside California,2021-05-31,444,677721,196,352206,210,291452,38,34063,188,116461,246,296603,226,413064,Not in California
Outside California,2021-06-01,2199,679920,1176,353382,715,292167,308,34371,1003,116585,1188,297791,1312,414376,Not in California
Outside California,2021-06-02,2032,681952,1021,354403,664,292831,347,34718,897,116709,1123,298914,1247,415623,Not in California
Outside California,2021-06-03,2194,684146,1198,355601,680,293511,316,35034,977,116796,1206,300120,1293,416916,Not in California
Outside California,2021-06-04,2567,686713,1433,357034,806,294317,328,35362,1084,116733,1472,301592,1409,418325,Not in California
Outside California,2021-06-05,1719,688432,1196,358230,360,294677,163,35525,750,116683,960,302552,910,419235,Not in California
Outside California,2021-06-06,912,689344,683,358913,147,294824,82,35607,426,116708,483,303035,508,419743,Not in California
Outside California,2021-06-07,1945,691289,1059,359972,552,295376,334,35941,798,116696,1142,304177,1130,420873,Not in California
Outside California,2021-06-08,2069,693358,1190,361162,539,295915,340,36281,797,116565,1266,305443,1135,422008,Not in California
Outside California,2021-06-09,1965,695323,1179,362341,499,296414,287,36568,783,116459,1173,306616,1067,423075,Not in California
Outside California,2021-06-10,1978,697301,1151,363492,516,296930,311,36879,822,116437,1153,307769,1131,424206,Not in California
Outside California,2021-06-11,2182,699483,1249,364741,598,297528,335,37214,898,116394,1276,309045,1233,425439,Not in California
Outside California,2021-06-12,1625,701108,1212,365953,277,297805,136,37350,618,116145,1003,310048,754,426193,Not in California
Outside California,2021-06-13,915,702023,622,366575,196,298001,97,37447,382,116094,529,310577,478,426671,Not in California
Outside California,2021-06-14,1765,703788,996,367571,466,298467,303,37750,728,116092,1031,311608,1029,427700,Not in California
Outside California,2021-06-15,1770,705558,978,368549,514,298981,278,38028,767,116143,994,312602,1045,428745,Not in California
Outside California,2021-06-16,1709,707267,1022,369571,461,299442,226,38254,800,116272,897,313499,1026,429771,Not in California
Outside California,2021-06-17,1826,709093,1007,370578,459,299901,360,38614,803,116417,1018,314517,1163,430934,Not in California
Outside California,2021-06-18,1969,711062,1084,371662,430,300331,455,39069,817,116544,1142,315659,1269,432203,Not in California
Outside California,2021-06-19,1053,712115,700,372362,256,300587,97,39166,540,116671,507,316166,634,432837,Not in California
Outside California,2021-06-20,780,712895,565,372927,168,300755,47,39213,450,116843,324,316490,496,433333,Not in California
Outside California,2021-06-21,1275,714170,639,373566,325,301080,311,39524,679,117244,589,317079,990,434323,Not in California
Outside California,2021-06-22,1633,715803,1031,374597,355,301435,247,39771,849,117564,776,317855,1096,435419,Not in California
Outside California,2021-06-23,1677,717480,926,375523,445,301880,306,40077,795,117790,874,318729,1100,436519,Not in California
Outside California,2021-06-24,1566,719046,913,376436,374,302254,279,40356,813,118131,751,319480,1092,437611,Not in California
Outside California,2021-06-25,1763,720809,1010,377446,397,302651,356,40712,830,118387,927,320407,1183,438794,Not in California
Outside California,2021-06-26,1150,721959,746,378192,220,302871,184,40896,578,118581,568,320975,762,439556,Not in California
Outside California,2021-06-27,747,722706,581,378773,108,302979,58,40954,435,118764,309,321284,492,440048,Not in California
Outside California,2021-06-28,1425,724131,850,379623,275,303254,300,41254,728,119101,692,321976,1029,441077,Not in California
Outside California,2021-06-29,1447,725578,882,380505,327,303581,238,41492,760,119417,680,322656,996,442073,Not in California
Outside California,2021-06-30,1405,726983,817,381322,376,303957,212,41704,750,119732,647,323303,962,443035,Not in California
Outside California,2021-07-01,1430,728413,826,382148,363,304320,241,41945,776,120106,641,323944,1015,444050,Not in California
Outside California,2021-07-02,1395,729808,804,382952,351,304671,240,42185,701,120361,686,324630,941,444991,Not in California
Outside California,2021-07-03,826,730634,588,383540,151,304822,87,42272,517,120657,307,324937,603,445594,Not in California
Outside California,2021-07-04,103,730737,61,383601,26,304848,16,42288,61,120694,40,324977,77,445671,Not in California
Outside California,2021-07-05,1023,731760,638,384239,312,305160,73,42361,600,120950,418,325395,674,446345,Not in California
Outside California,2021-07-06,1442,733202,845,385084,319,305479,278,42639,668,121128,768,326163,946,447291,Not in California
Outside California,2021-07-07,1513,734715,794,385878,364,305843,355,42994,736,121442,771,326934,1085,448376,Not in California
Outside California,2021-07-08,1300,736015,706,386584,301,306144,293,43287,609,121661,679,327613,898,449274,Not in California
Outside California,2021-07-09,1341,737356,755,387339,345,306489,241,43528,638,121846,693,328306,878,450152,Not in California
Outside California,2021-07-10,874,738230,630,387969,171,306660,73,43601,509,122071,357,328663,582,450734,Not in California
Outside California,2021-07-11,623,738853,465,388434,113,306773,45,43646,363,122222,257,328920,408,451142,Not in California
Outside California,2021-07-12,1294,740147,771,389205,292,307065,231,43877,645,122458,640,329560,876,452018,Not in California
Outside California,2021-07-13,1296,741443,795,390000,327,307392,174,44051,628,122599,661,330221,802,452820,Not in California
Outside California,2021-07-14,1391,742834,753,390753,411,307803,227,44278,735,122912,647,330868,960,453780,Not in California
Outside California,2021-07-15,1373,744207,799,391552,320,308123,254,44532,664,123126,705,331573,919,454699,Not in California
Outside California,2021-07-16,1425,745632,792,392344,341,308464,292,44824,712,123425,706,332279,1005,455704,Not in California
Outside California,2021-07-17,912,746544,607,392951,203,308667,102,44926,529,123676,380,332659,631,456335,Not in California
Outside California,2021-07-18,622,747166,434,393385,137,308804,51,44977,372,123853,248,332907,425,456760,Not in California
Outside California,2021-07-19,1274,748440,806,394191,254,309058,214,45191,708,124218,555,333462,920,457680,Not in California
Outside California,2021-07-20,1476,749916,798,394989,347,309405,331,45522,758,124595,712,334174,1089,458769,Not in California
Outside California,2021-07-21,1516,751432,801,395790,433,309838,282,45804,808,124986,700,334874,1091,459860,Not in California
Outside California,2021-07-22,1575,753007,906,396696,441,310279,228,46032,902,125449,666,335540,1129,460989,Not in California
Outside California,2021-07-23,1543,754550,890,397586,428,310707,225,46257,916,125973,615,336155,1139,462128,Not in California
Outside California,2021-07-24,899,755449,605,398191,211,310918,83,46340,565,126294,327,336482,648,462776,Not in California
Outside California,2021-07-25,572,756021,408,398599,132,311050,32,46372,428,126619,135,336617,460,463236,Not in California
Outside California,2021-07-26,1507,757528,845,399444,387,311437,275,46647,854,127100,646,337263,1127,464363,Not in California
Outside California,2021-07-27,1465,758993,805,400249,431,311868,229,46876,883,127637,571,337834,1108,465471,Not in California
Outside California,2021-07-28,1554,760547,831,401080,501,312369,222,47098,959,128230,587,338421,1180,466651,Not in California
Outside California,2021-07-29,1502,762049,839,401919,411,312780,252,47350,887,128764,605,339026,1139,467790,Not in California
Outside California,2021-07-30,1587,763636,899,402818,483,313263,205,47555,996,129390,575,339601,1201,468991,Not in California
Outside California,2021-07-31,1065,764701,697,403515,257,313520,111,47666,675,129794,382,339983,786,469777,Not in California
Outside California,2021-08-01,655,765356,504,404019,117,313637,34,47700,471,130120,179,340162,505,470282,Not in California
Outside California,2021-08-02,1334,766690,849,404868,353,313990,132,47832,869,130670,452,340614,1002,471284,Not in California
Outside California,2021-08-03,1573,768263,902,405770,432,314422,239,48071,939,131226,621,341235,1177,472461,Not in California
Outside California,2021-08-04,1406,769669,782,406552,480,314902,144,48215,946,131873,442,341677,1089,473550,Not in California
Outside California,2021-08-05,1481,771150,870,407422,395,315297,216,48431,940,132499,530,342207,1156,474706,Not in California
Outside California,2021-08-06,1621,772771,967,408389,468,315765,186,48617,1041,133159,565,342772,1225,475931,Not in California
Outside California,2021-08-07,1055,773826,692,409081,258,316023,105,48722,707,133632,339,343111,812,476743,Not in California
Outside California,2021-08-08,765,774591,538,409619,183,316206,44,48766,555,134027,203,343314,598,477341,Not in California
Outside California,2021-08-09,1576,776167,1015,410634,340,316546,221,48987,947,134578,615,343929,1166,478507,Not in California
Outside California,2021-08-10,1523,777690,959,411593,404,316950,160,49147,947,135120,566,344495,1108,479615,Not in California
Outside California,2021-08-11,1599,779289,915,412508,471,317421,213,49360,979,135707,604,345099,1191,480806,Not in California
Outside California,2021-08-12,1614,780903,953,413461,494,317915,167,49527,1016,136307,583,345682,1183,481989,Not in California
Outside California,2021-08-13,1673,782576,973,414434,503,318418,197,49724,991,136843,651,346333,1187,483176,Not in California
Outside California,2021-08-14,1145,783721,689,415123,342,318760,114,49838,715,137295,378,346711,830,484006,Not in California
Outside California,2021-08-15,741,784462,529,415652,175,318935,37,49875,442,137522,252,346963,479,484485,Not in California
Outside California,2021-08-16,1557,786019,956,416608,439,319374,162,50037,942,138081,545,347508,1104,485589,Not in California
Outside California,2021-08-17,1689,787708,950,417558,506,319880,233,50270,926,138572,663,348171,1154,486743,Not in California
Outside California,2021-08-18,1870,789578,1000,418558,670,320550,200,50470,1034,139075,731,348902,1234,487977,Not in California
Outside California,2021-08-19,1822,791400,934,419492,671,321221,217,50687,1063,139692,660,349562,1277,489254,Not in California
Outside California,2021-08-20,1795,793195,1032,420524,565,321786,198,50885,997,140209,676,350238,1193,490447,Not in California
Outside California,2021-08-21,1107,794302,722,421246,291,322077,94,50979,616,140498,421,350659,710,491157,Not in California
Outside California,2021-08-22,824,795126,574,421820,202,322279,48,51027,488,140734,302,350961,538,491695,Not in California
Outside California,2021-08-23,1730,796856,1060,422880,502,322781,168,51195,982,141268,616,351577,1150,492845,Not in California
Outside California,2021-08-24,1672,798528,1013,423893,523,323304,136,51331,944,141736,613,352190,1081,493926,Not in California
Outside California,2021-08-25,2065,800593,1193,425086,714,324018,158,51489,1084,142253,722,352912,1239,495165,Not in California
Outside California,2021-08-26,1910,802503,1029,426115,690,324708,191,51680,895,142691,649,353561,1087,496252,Not in California
Outside California,2021-08-27,1991,804494,1075,427190,781,325489,135,51815,995,143135,687,354248,1131,497383,Not in California
Outside California,2021-08-28,1236,805730,761,427951,393,325882,82,51897,638,143416,439,354687,720,498103,Not in California
Outside California,2021-08-29,836,806566,597,428548,212,326094,27,51924,504,143681,268,354955,533,498636,Not in California
Outside California,2021-08-30,1556,808122,744,429292,547,326641,265,52189,597,143897,645,355600,861,499497,Not in California
Unknown,2020-12-17,2,2,2,2,0,0,0,0,0,0,0,0,0,0,Not in California
Unknown,2020-12-18,1,3,1,3,0,0,0,0,0,0,0,0,0,0,Not in California
Unknown,2020-12-21,4,7,4,7,0,0,0,0,0,0,0,0,0,0,Not in California
Unknown,2020-12-29,3,10,2,9,1,1,0,0,4,4,0,0,4,4,Not in California
Unknown,2020-12-30,54,64,54,63,0,1,0,0,54,58,0,0,54,58,Not in California
Unknown,2020-12-31,1,65,0,63,1,2,0,0,1,59,0,0,1,59,Not in California
Unknown,2021-01-02,1,66,0,63,1,3,0,0,1,60,0,0,1,60,Not in California
Unknown,2021-01-04,1,67,1,64,0,3,0,0,1,61,0,0,1,61,Not in California
Unknown,2021-01-06,4,71,2,66,2,5,0,0,4,65,0,0,4,65,Not in California
Unknown,2021-01-07,68,139,68,134,0,5,0,0,67,132,0,0,67,132,Not in California
Unknown,2021-01-09,1,140,1,135,0,5,0,0,1,134,0,0,1,134,Not in California
Unknown,2021-01-11,20,160,20,155,0,5,0,0,21,155,0,0,21,155,Not in California
Unknown,2021-01-12,8,168,7,162,1,6,0,0,6,161,1,1,7,162,Not in California
Unknown,2021-01-13,3,171,3,165,0,6,0,0,3,164,0,1,3,165,Not in California
Unknown,2021-01-14,5,176,5,170,0,6,0,0,4,168,0,1,4,169,Not in California
Unknown,2021-01-15,5,181,4,174,1,7,0,0,4,172,0,1,4,173,Not in California
Unknown,2021-01-16,4,185,4,178,0,7,0,0,4,176,0,1,4,177,Not in California
Unknown,2021-01-18,10,195,10,188,0,7,0,0,10,186,0,1,10,187,Not in California
Unknown,2021-01-19,6,201,6,194,0,7,0,0,4,189,1,2,4,191,Not in California
Unknown,2021-01-20,56,257,56,250,0,7,0,0,4,140,53,55,4,195,Not in California
Unknown,2021-01-21,16,273,14,264,2,9,0,0,17,156,1,56,17,212,Not in California
Unknown,2021-01-22,11,284,7,271,4,13,0,0,12,168,0,56,12,224,Not in California
Unknown,2021-01-23,8,292,4,275,4,17,0,0,8,176,0,56,8,232,Not in California
Unknown,2021-01-24,2,294,2,277,0,17,0,0,2,178,0,56,2,234,Not in California
Unknown,2021-01-25,6,300,3,280,3,20,0,0,5,182,1,57,5,239,Not in California
Unknown,2021-01-26,10,310,9,289,1,21,0,0,12,193,1,58,12,251,Not in California
Unknown,2021-01-27,10,320,10,299,0,21,0,0,7,199,1,59,7,258,Not in California
Unknown,2021-01-28,80,400,77,376,3,24,0,0,23,162,60,119,23,281,Not in California
Unknown,2021-01-29,98,498,98,474,0,24,0,0,102,263,1,120,102,383,Not in California
Unknown,2021-01-30,6,504,4,478,2,26,0,0,9,271,1,121,9,392,Not in California
Unknown,2021-01-31,3,507,3,481,0,26,0,0,3,273,1,122,3,395,Not in California
Unknown,2021-02-01,33,540,32,513,1,27,0,0,14,266,21,143,14,409,Not in California
Unknown,2021-02-02,13,553,12,525,1,28,0,0,9,271,4,147,9,418,Not in California
Unknown,2021-02-03,4,557,4,529,0,28,0,0,1,270,2,149,1,419,Not in California
Unknown,2021-02-04,17,574,13,542,4,32,0,0,8,271,7,156,8,427,Not in California
Unknown,2021-02-05,14,588,11,553,3,35,0,0,10,277,4,160,10,437,Not in California
Unknown,2021-02-06,4,592,4,557,0,35,0,0,1,275,3,163,1,438,Not in California
Unknown,2021-02-07,1,593,1,558,0,35,0,0,1,276,0,163,1,439,Not in California
Unknown,2021-02-08,6,599,5,563,1,36,0,0,2,274,4,167,2,441,Not in California
Unknown,2021-02-09,2,601,2,565,0,36,0,0,1,274,1,168,1,442,Not in California
Unknown,2021-02-10,5,606,1,566,4,40,0,0,4,277,1,169,4,446,Not in California
Unknown,2021-02-11,13,619,12,578,1,41,0,0,2,268,11,180,2,448,Not in California
Unknown,2021-02-12,9,628,6,584,3,44,0,0,3,265,6,186,3,451,Not in California
Unknown,2021-02-13,7,635,3,587,4,48,0,0,5,268,2,188,5,456,Not in California
Unknown,2021-02-14,2,637,1,588,1,49,0,0,1,268,1,189,1,457,Not in California
Unknown,2021-02-15,31,668,27,615,4,53,0,0,26,291,3,192,26,483,Not in California
Unknown,2021-02-16,14,682,9,624,5,58,0,0,5,287,9,201,5,488,Not in California
Unknown,2021-02-17,10,692,8,632,2,60,0,0,6,288,5,206,6,494,Not in California
Unknown,2021-02-18,17,709,12,644,5,65,0,0,5,280,13,219,5,499,Not in California
Unknown,2021-02-19,123,832,118,762,5,70,0,0,29,215,94,313,29,528,Not in California
Unknown,2021-02-20,3,835,2,764,1,71,0,0,2,216,1,314,2,530,Not in California
Unknown,2021-02-21,2,837,2,766,0,71,0,0,0,214,2,316,0,530,Not in California
Unknown,2021-02-22,8,845,8,774,0,71,0,0,0,206,8,324,0,530,Not in California
Unknown,2021-02-23,15,860,5,779,10,81,0,0,7,206,7,331,7,537,Not in California
Unknown,2021-02-24,12,872,4,783,8,89,0,0,10,214,2,333,10,547,Not in California
Unknown,2021-02-25,26,898,13,796,13,102,0,0,16,218,12,345,16,563,Not in California
Unknown,2021-02-26,30,928,14,810,16,118,0,0,16,220,14,359,16,579,Not in California
Unknown,2021-02-27,16,944,11,821,5,123,0,0,12,231,1,360,12,591,Not in California
Unknown,2021-02-28,8,952,5,826,3,126,0,0,6,237,0,360,6,597,Not in California
Unknown,2021-03-01,14,966,6,832,8,134,0,0,8,240,5,365,8,605,Not in California
Unknown,2021-03-02,18,984,6,838,12,146,0,0,11,246,5,370,11,616,Not in California
Unknown,2021-03-03,6,990,4,842,2,148,0,0,5,251,0,370,5,621,Not in California
Unknown,2021-03-04,12,1002,9,851,3,151,0,0,11,262,0,370,11,632,Not in California
Unknown,2021-03-05,11,1013,4,855,7,158,0,0,10,270,2,372,10,642,Not in California
Unknown,2021-03-06,14,1027,7,862,4,162,3,3,12,282,2,374,14,656,Not in California
Unknown,2021-03-07,1,1028,0,862,0,162,1,4,0,282,1,375,1,657,Not in California
Unknown,2021-03-08,26,1054,20,882,5,167,1,5,7,270,20,395,8,665,Not in California
Unknown,2021-03-09,8,1062,4,886,2,169,2,7,5,274,3,398,7,672,Not in California
Unknown,2021-03-10,9,1071,6,892,1,170,2,9,4,273,7,405,6,678,Not in California
Unknown,2021-03-11,21,1092,5,897,2,172,14,23,3,274,16,421,17,695,Not in California
Unknown,2021-03-12,40,1132,29,926,4,176,7,30,8,256,33,454,15,710,Not in California
Unknown,2021-03-13,10,1142,1,927,5,181,4,34,0,251,9,463,4,714,Not in California
Unknown,2021-03-14,2,1144,0,927,1,182,1,35,0,250,2,465,1,715,Not in California
Unknown,2021-03-15,20,1164,7,934,11,193,2,37,14,260,6,471,16,731,Not in California
Unknown,2021-03-16,25,1189,7,941,14,207,4,41,17,272,9,480,21,752,Not in California
Unknown,2021-03-17,25,1214,7,948,17,224,1,42,25,296,2,482,26,778,Not in California
Unknown,2021-03-18,20,1234,9,957,11,235,0,42,12,302,6,488,12,790,Not in California
Unknown,2021-03-19,12,1246,7,964,5,240,0,42,8,306,4,492,8,798,Not in California
Unknown,2021-03-20,15,1261,7,971,8,248,0,42,4,304,6,498,4,802,Not in California
Unknown,2021-03-21,7,1268,2,973,5,253,0,42,6,309,1,499,6,808,Not in California
Unknown,2021-03-22,18,1286,7,980,10,263,1,43,8,310,8,507,9,817,Not in California
Unknown,2021-03-23,14,1300,2,982,6,269,6,49,3,309,10,517,9,826,Not in California
Unknown,2021-03-24,13,1313,3,985,10,279,0,49,8,311,6,523,8,834,Not in California
Unknown,2021-03-25,23,1336,12,997,11,290,0,49,14,316,9,532,14,848,Not in California
Unknown,2021-03-26,17,1353,5,1002,7,297,5,54,8,321,8,540,13,861,Not in California
Unknown,2021-03-27,24,1377,10,1012,11,308,3,57,13,323,14,554,16,877,Not in California
Unknown,2021-03-28,8,1385,2,1014,6,314,0,57,6,328,1,555,6,883,Not in California
Unknown,2021-03-29,19,1404,9,1023,10,324,0,57,12,334,6,561,12,895,Not in California
Unknown,2021-03-30,17,1421,5,1028,12,336,0,57,10,338,6,567,10,905,Not in California
Unknown,2021-03-31,20,1441,10,1038,8,344,2,59,15,349,6,573,17,922,Not in California
Unknown,2021-04-01,18,1459,11,1049,4,348,3,62,12,358,6,579,15,937,Not in California
Unknown,2021-04-02,32,1491,13,1062,10,358,9,71,12,359,20,599,21,958,Not in California
Unknown,2021-04-03,13,1504,5,1067,8,366,0,71,9,361,7,606,9,967,Not in California
Unknown,2021-04-04,7,1511,3,1070,4,370,0,71,7,368,0,606,7,974,Not in California
Unknown,2021-04-05,16,1527,6,1076,9,379,1,72,6,366,9,615,7,981,Not in California
Unknown,2021-04-06,13,1540,7,1083,5,384,1,73,6,368,5,620,7,988,Not in California
Unknown,2021-04-07,24,1564,16,1099,7,391,1,74,16,377,7,627,16,1004,Not in California
Unknown,2021-04-08,20,1584,12,1111,4,395,4,78,12,385,8,635,16,1020,Not in California
Unknown,2021-04-09,14,1598,10,1121,4,399,0,78,10,392,3,638,10,1030,Not in California
Unknown,2021-04-10,5,1603,4,1125,0,399,1,79,1,390,4,642,2,1032,Not in California
Unknown,2021-04-11,7,1610,6,1131,1,400,0,79,3,391,2,644,3,1035,Not in California
Unknown,2021-04-12,17,1627,5,1136,11,411,1,80,6,387,11,655,7,1042,Not in California
Unknown,2021-04-13,24,1651,9,1145,15,426,0,80,8,381,14,669,8,1050,Not in California
Unknown,2021-04-14,19,1670,1,1146,18,444,0,80,2,367,16,685,2,1052,Not in California
Unknown,2021-04-15,18,1688,7,1153,10,454,1,81,10,368,9,694,10,1062,Not in California
Unknown,2021-04-16,15,1703,9,1162,6,460,0,81,7,368,7,701,7,1069,Not in California
Unknown,2021-04-17,12,1715,9,1171,3,463,0,81,5,368,6,707,6,1075,Not in California
Unknown,2021-04-18,10,1725,3,1174,7,470,0,81,6,369,5,712,6,1081,Not in California
Unknown,2021-04-19,13,1738,2,1176,11,481,0,81,3,363,9,721,3,1084,Not in California
Unknown,2021-04-20,12,1750,7,1183,5,486,0,81,5,361,7,728,5,1089,Not in California
Unknown,2021-04-21,26,1776,12,1195,14,500,0,81,10,356,15,743,10,1099,Not in California
Unknown,2021-04-22,21,1797,10,1205,11,511,0,81,4,345,15,758,4,1103,Not in California
Unknown,2021-04-23,18,1815,7,1212,11,522,0,81,9,347,7,765,9,1112,Not in California
Unknown,2021-04-24,25,1840,17,1229,8,530,0,81,13,348,12,777,13,1125,Not in California
Unknown,2021-04-25,11,1851,5,1234,6,536,0,81,5,348,5,782,5,1130,Not in California
Unknown,2021-04-26,28,1879,14,1248,14,550,0,81,20,359,9,791,20,1150,Not in California
Unknown,2021-04-27,24,1903,12,1260,11,561,1,82,11,359,12,803,12,1162,Not in California
Unknown,2021-04-28,24,1927,18,1278,5,566,1,83,9,354,15,818,10,1172,Not in California
Unknown,2021-04-29,24,1951,16,1294,8,574,0,83,13,353,14,832,13,1185,Not in California
Unknown,2021-04-30,20,1971,9,1303,7,581,4,87,11,358,10,842,15,1200,Not in California
Unknown,2021-05-01,19,1990,15,1318,4,585,0,87,10,360,8,850,10,1210,Not in California
Unknown,2021-05-02,13,2003,6,1324,7,592,0,87,2,353,9,859,2,1212,Not in California
Unknown,2021-05-03,15,2018,9,1333,4,596,2,89,6,353,8,867,8,1220,Not in California
Unknown,2021-05-04,14,2032,4,1337,4,600,6,95,2,349,12,879,8,1228,Not in California
Unknown,2021-05-05,17,2049,6,1343,9,609,2,97,10,353,8,887,12,1240,Not in California
Unknown,2021-05-06,30,2079,15,1358,7,616,8,105,9,348,22,909,17,1257,Not in California
Unknown,2021-05-07,21,2100,12,1370,6,622,3,108,10,349,12,921,13,1270,Not in California
Unknown,2021-05-08,11,2111,7,1377,2,624,2,110,4,349,6,927,6,1276,Not in California
Unknown,2021-05-09,14,2125,4,1381,7,631,3,113,8,354,6,933,11,1287,Not in California
Unknown,2021-05-10,9,2134,2,1383,4,635,3,116,3,355,5,938,6,1293,Not in California
Unknown,2021-05-11,16,2150,7,1390,5,640,4,120,6,355,10,948,10,1303,Not in California
Unknown,2021-05-12,8,2158,3,1393,4,644,1,121,4,356,4,952,5,1308,Not in California
Unknown,2021-05-13,12,2170,6,1399,1,645,5,126,6,360,8,960,12,1320,Not in California
Unknown,2021-05-14,15,2185,12,1411,2,647,1,127,15,374,1,961,15,1335,Not in California
Unknown,2021-05-15,11,2196,9,1420,2,649,0,127,8,379,3,964,8,1343,Not in California
Unknown,2021-05-16,26,2222,20,1440,5,654,1,128,20,393,7,971,21,1364,Not in California
Unknown,2021-05-17,27,2249,22,1462,3,657,2,130,14,397,12,983,16,1380,Not in California
Unknown,2021-05-18,25,2274,18,1480,5,662,2,132,14,402,11,994,16,1396,Not in California
Unknown,2021-05-19,28,2302,22,1502,5,667,1,133,11,398,16,1010,12,1408,Not in California
Unknown,2021-05-20,16,2318,11,1513,4,671,1,134,8,399,8,1018,9,1417,Not in California
Unknown,2021-05-21,18,2336,8,1521,6,677,4,138,7,399,11,1029,11,1428,Not in California
Unknown,2021-05-22,23,2359,19,1540,3,680,1,139,10,401,9,1038,11,1439,Not in California
Unknown,2021-05-23,8,2367,6,1546,2,682,0,139,8,408,1,1039,8,1447,Not in California
Unknown,2021-05-24,16,2383,8,1554,7,689,1,140,6,404,11,1050,7,1454,Not in California
Unknown,2021-05-25,16,2399,6,1560,4,693,6,146,7,409,8,1058,13,1467,Not in California
Unknown,2021-05-26,10,2409,7,1567,2,695,1,147,5,410,5,1063,6,1473,Not in California
Unknown,2021-05-27,19,2428,13,1580,4,699,2,149,8,410,10,1073,10,1483,Not in California
Unknown,2021-05-28,24,2452,12,1592,6,705,6,155,14,419,11,1084,20,1503,Not in California
Unknown,2021-05-29,18,2470,17,1609,1,706,0,155,14,429,4,1088,14,1517,Not in California
Unknown,2021-05-30,16,2486,15,1624,0,706,1,156,12,438,4,1092,13,1530,Not in California
Unknown,2021-05-31,1,2487,1,1625,0,706,0,156,0,437,1,1093,0,1530,Not in California
Unknown,2021-06-01,25,2512,12,1637,7,713,6,162,12,442,13,1106,18,1548,Not in California
Unknown,2021-06-02,8,2520,4,1641,4,717,0,162,2,439,5,1111,2,1550,Not in California
Unknown,2021-06-03,13,2533,12,1653,1,718,0,162,7,440,6,1117,7,1557,Not in California
Unknown,2021-06-04,23,2556,13,1666,10,728,0,162,12,442,10,1127,12,1569,Not in California
Unknown,2021-06-05,24,2580,19,1685,4,732,1,163,15,450,8,1135,16,1585,Not in California
Unknown,2021-06-06,29,2609,20,1705,6,738,3,166,11,446,18,1153,14,1599,Not in California
Unknown,2021-06-07,24,2633,15,1720,8,746,1,167,9,441,15,1168,10,1609,Not in California
Unknown,2021-06-08,16,2649,9,1729,4,750,3,170,5,438,11,1179,8,1617,Not in California
Unknown,2021-06-09,20,2669,13,1742,7,757,0,170,8,436,10,1189,8,1625,Not in California
Unknown,2021-06-10,11,2680,7,1749,4,761,0,170,6,437,5,1194,6,1631,Not in California
Unknown,2021-06-11,9,2689,6,1755,2,763,1,171,5,439,4,1198,6,1637,Not in California
Unknown,2021-06-12,14,2703,10,1765,4,767,0,171,8,441,6,1204,8,1645,Not in California
Unknown,2021-06-13,9,2712,5,1770,4,771,0,171,2,436,7,1211,2,1647,Not in California
Unknown,2021-06-14,11,2723,9,1779,2,773,0,171,2,432,6,1217,2,1649,Not in California
Unknown,2021-06-15,17,2740,9,1788,7,780,1,172,7,429,11,1228,8,1657,Not in California
Unknown,2021-06-16,7,2747,4,1792,3,783,0,172,5,432,2,1230,5,1662,Not in California
Unknown,2021-06-17,12,2759,7,1799,3,786,2,174,9,440,3,1233,11,1673,Not in California
Unknown,2021-06-18,13,2772,10,1809,3,789,0,174,5,437,8,1241,5,1678,Not in California
Unknown,2021-06-19,12,2784,10,1819,2,791,0,174,2,430,9,1250,2,1680,Not in California
Unknown,2021-06-20,5,2789,4,1823,1,792,0,174,2,430,2,1252,2,1682,Not in California
Unknown,2021-06-21,12,2801,8,1831,4,796,0,174,8,434,4,1256,8,1690,Not in California
Unknown,2021-06-22,15,2816,9,1840,6,802,0,174,10,440,4,1260,10,1700,Not in California
Unknown,2021-06-23,8,2824,3,1843,4,806,1,175,6,444,3,1263,7,1707,Not in California
Unknown,2021-06-24,11,2835,5,1848,5,811,1,176,6,446,5,1268,7,1714,Not in California
Unknown,2021-06-25,13,2848,12,1860,1,812,0,176,7,449,4,1272,7,1721,Not in California
Unknown,2021-06-26,11,2859,11,1871,0,812,0,176,8,454,3,1275,8,1729,Not in California
Unknown,2021-06-27,20,2879,15,1886,3,815,2,178,8,452,12,1287,10,1739,Not in California
Unknown,2021-06-28,14,2893,12,1898,2,817,0,178,9,456,5,1292,9,1748,Not in California
Unknown,2021-06-29,8,2901,5,1903,3,820,0,178,6,461,1,1293,6,1754,Not in California
Unknown,2021-06-30,10,2911,9,1912,1,821,0,178,7,464,4,1297,7,1761,Not in California
Unknown,2021-07-01,11,2922,10,1922,1,822,0,178,7,467,4,1301,7,1768,Not in California
Unknown,2021-07-02,6,2928,2,1924,4,826,0,178,2,465,4,1305,2,1770,Not in California
Unknown,2021-07-03,7,2935,6,1930,1,827,0,178,4,465,4,1309,4,1774,Not in California
Unknown,2021-07-05,18,2953,13,1943,4,831,1,179,13,474,5,1314,14,1788,Not in California
Unknown,2021-07-06,9,2962,6,1949,3,834,0,179,5,476,3,1317,5,1793,Not in California
Unknown,2021-07-07,25,2987,16,1965,7,841,2,181,14,484,8,1325,16,1809,Not in California
Unknown,2021-07-08,23,3010,20,1985,3,844,0,181,15,491,8,1333,15,1824,Not in California
Unknown,2021-07-09,12,3022,8,1993,2,846,2,183,6,493,6,1339,8,1832,Not in California
Unknown,2021-07-10,11,3033,7,2000,4,850,0,183,7,496,4,1343,7,1839,Not in California
Unknown,2021-07-11,5,3038,5,2005,0,850,0,183,3,497,2,1345,3,1842,Not in California
Unknown,2021-07-12,4,3042,3,2008,1,851,0,183,1,495,3,1348,1,1843,Not in California
Unknown,2021-07-13,12,3054,11,2019,1,852,0,183,9,501,3,1351,9,1852,Not in California
Unknown,2021-07-14,6,3060,2,2021,4,856,0,183,2,499,4,1355,2,1854,Not in California
Unknown,2021-07-15,15,3075,7,2028,7,863,1,184,10,502,8,1363,11,1865,Not in California
Unknown,2021-07-16,10,3085,8,2036,2,865,0,184,5,502,5,1368,5,1870,Not in California
Unknown,2021-07-17,13,3098,13,2049,0,865,0,184,8,508,2,1370,8,1878,Not in California
Unknown,2021-07-18,7,3105,7,2056,0,865,0,184,3,507,4,1374,3,1881,Not in California
Unknown,2021-07-19,11,3116,9,2065,2,867,0,184,6,508,5,1379,6,1887,Not in California
Unknown,2021-07-20,15,3131,8,2073,5,872,2,186,3,501,12,1391,5,1892,Not in California
Unknown,2021-07-21,6,3137,5,2078,1,873,0,186,4,503,2,1393,4,1896,Not in California
Unknown,2021-07-22,11,3148,8,2086,3,876,0,186,6,504,5,1398,6,1902,Not in California
Unknown,2021-07-23,16,3164,13,2099,3,879,0,186,14,516,2,1400,14,1916,Not in California
Unknown,2021-07-24,7,3171,6,2105,1,880,0,186,5,519,2,1402,5,1921,Not in California
Unknown,2021-07-25,6,3177,4,2109,1,881,1,187,4,522,2,1404,5,1926,Not in California
Unknown,2021-07-26,12,3189,10,2119,2,883,0,187,7,524,5,1409,7,1933,Not in California
Unknown,2021-07-27,15,3204,12,2131,3,886,0,187,11,531,4,1413,11,1944,Not in California
Unknown,2021-07-28,16,3220,9,2140,7,893,0,187,13,541,3,1416,13,1957,Not in California
Unknown,2021-07-29,16,3236,14,2154,2,895,0,187,4,532,13,1429,4,1961,Not in California
Unknown,2021-07-30,7,3243,5,2159,2,897,0,187,4,533,3,1432,4,1965,Not in California
Unknown,2021-07-31,11,3254,8,2167,3,900,0,187,7,536,4,1436,7,1972,Not in California
Unknown,2021-08-01,12,3266,11,2178,1,901,0,187,8,540,4,1440,8,1980,Not in California
Unknown,2021-08-02,4,3270,2,2180,2,903,0,187,5,545,0,1440,5,1985,Not in California
Unknown,2021-08-03,16,3286,10,2190,5,908,1,188,12,554,4,1444,13,1998,Not in California
Unknown,2021-08-04,9,3295,5,2195,4,912,0,188,6,557,3,1447,6,2004,Not in California
Unknown,2021-08-05,7,3302,3,2198,4,916,0,188,2,555,4,1451,2,2006,Not in California
Unknown,2021-08-06,12,3314,10,2208,2,918,0,188,9,561,3,1454,9,2015,Not in California
Unknown,2021-08-07,10,3324,4,2212,6,924,0,188,8,567,2,1456,8,2023,Not in California
Unknown,2021-08-08,6,3330,5,2217,1,925,0,188,2,565,4,1460,2,2025,Not in California
Unknown,2021-08-09,16,3346,11,2228,2,927,3,191,10,572,6,1466,13,2038,Not in California
Unknown,2021-08-10,3,3349,3,2231,0,927,0,191,3,575,0,1466,3,2041,Not in California
Unknown,2021-08-11,3,3352,2,2233,1,928,0,191,2,576,1,1467,2,2043,Not in California
Unknown,2021-08-12,19,3371,17,2250,2,930,0,191,16,589,3,1470,16,2059,Not in California
Unknown,2021-08-13,23,3394,20,2270,3,933,0,191,14,594,9,1479,14,2073,Not in California
Unknown,2021-08-14,11,3405,9,2279,2,935,0,191,4,592,6,1485,4,2077,Not in California
Unknown,2021-08-15,4,3409,2,2281,2,937,0,191,3,595,0,1485,3,2080,Not in California
Unknown,2021-08-16,10,3419,7,2288,2,939,1,192,4,594,6,1491,5,2085,Not in California
Unknown,2021-08-17,9,3428,6,2294,3,942,0,192,4,594,4,1495,4,2089,Not in California
Unknown,2021-08-18,21,3449,19,2313,1,943,1,193,6,588,12,1507,6,2095,Not in California
Unknown,2021-08-19,13,3462,6,2319,6,949,1,194,7,590,6,1513,8,2103,Not in California
Unknown,2021-08-20,9,3471,6,2325,3,952,0,194,4,590,4,1517,4,2107,Not in California
Unknown,2021-08-21,8,3479,6,2331,2,954,0,194,4,591,3,1520,4,2111,Not in California
Unknown,2021-08-22,13,3492,10,2341,3,957,0,194,7,593,5,1525,7,2118,Not in California
Unknown,2021-08-23,4,3496,3,2344,1,958,0,194,3,596,0,1525,3,2121,Not in California
Unknown,2021-08-24,12,3508,10,2354,2,960,0,194,8,602,2,1527,8,2129,Not in California
Unknown,2021-08-25,12,3520,8,2362,4,964,0,194,5,601,6,1533,5,2134,Not in California
Unknown,2021-08-26,11,3531,8,2370,3,967,0,194,6,603,4,1537,6,2140,Not in California
Unknown,2021-08-27,6,3537,6,2376,0,967,0,194,3,603,3,1540,3,2143,Not in California
Unknown,2021-08-28,22,3559,16,2392,6,973,0,194,17,615,5,1545,17,2160,Not in California
Unknown,2021-08-29,3,3562,1,2393,2,975,0,194,2,617,0,1545,2,2162,Not in California
Unknown,2021-08-30,7,3569,4,2397,3,978,0,194,4,618,3,1548,4,2166,Not in California
Alameda,2020-12-15,41,41,41,41,0,0,0,0,41,41,0,0,41,41,California
Alameda,2020-12-16,219,260,219,260,0,0,0,0,219,260,0,0,219,260,California
Alameda,2020-12-17,516,776,516,776,0,0,0,0,516,776,0,0,516,776,California
Alameda,2020-12-18,1951,2727,1950,2726,1,1,0,0,1950,2726,0,0,1950,2726,California
Alameda,2020-12-19,1424,4151,1424,4150,0,1,0,0,1424,4150,0,0,1424,4150,California
Alameda,2020-12-20,1180,5331,1179,5329,1,2,0,0,1179,5328,1,1,1179,5329,California
Alameda,2020-12-21,1835,7166,1833,7162,2,4,0,0,1834,7162,0,1,1834,7163,California
Alameda,2020-12-22,2094,9260,2040,9202,54,58,0,0,2092,9254,0,1,2092,9255,California
Alameda,2020-12-23,1950,11210,1689,10891,261,319,0,0,1949,11202,1,2,1949,11204,California
Alameda,2020-12-24,1212,12422,751,11642,461,780,0,0,1212,12414,0,2,1212,12416,California
Alameda,2020-12-25,157,12579,123,11765,34,814,0,0,157,12571,0,2,157,12573,California
Alameda,2020-12-26,844,13423,319,12084,525,1339,0,0,844,13415,0,2,844,13417,California
Alameda,2020-12-27,489,13912,252,12336,237,1576,0,0,489,13904,0,2,489,13906,California
Alameda,2020-12-28,1882,15794,972,13308,910,2486,0,0,1882,15786,0,2,1882,15788,California
Alameda,2020-12-29,2509,18303,1110,14418,1399,3885,0,0,2508,18294,0,2,2508,18296,California
Alameda,2020-12-30,3104,21407,1356,15774,1748,5633,0,0,3104,21398,0,2,3104,21400,California
Alameda,2020-12-31,1806,23213,455,16229,1351,6984,0,0,1803,23199,2,4,1803,23203,California
Alameda,2021-01-01,185,23398,78,16307,107,7091,0,0,183,23380,2,6,183,23386,California
Alameda,2021-01-02,725,24123,524,16831,201,7292,0,0,724,24104,0,6,724,24110,California
Alameda,2021-01-03,330,24453,217,17048,113,7405,0,0,327,24428,3,9,327,24437,California
Alameda,2021-01-04,1608,26061,912,17960,696,8101,0,0,1595,26011,12,21,1595,26032,California
Alameda,2021-01-05,2217,28278,1284,19244,933,9034,0,0,1961,27719,253,274,1961,27993,California
Alameda,2021-01-06,3280,31558,1829,21073,1451,10485,0,0,2374,29193,904,1178,2378,30371,California
Alameda,2021-01-07,3824,35382,2151,23224,1673,12158,0,0,2631,30644,1184,2362,2635,33006,California
Alameda,2021-01-08,4788,40170,2726,25950,2062,14220,0,0,3044,31954,1739,4101,3049,36055,California
Alameda,2021-01-09,2023,42193,1379,27329,644,14864,0,0,1146,32224,876,4977,1146,37201,California
Alameda,2021-01-10,1060,43253,837,28166,223,15087,0,0,426,32016,634,5611,426,37627,California
Alameda,2021-01-11,4712,47965,3570,31736,1142,16229,0,0,2881,33076,1827,7438,2887,40514,California
Alameda,2021-01-12,4869,52834,3275,35011,1594,17823,0,0,3468,35147,1400,8838,3471,43985,California
Alameda,2021-01-13,5090,57924,2713,37724,2377,20200,0,0,3877,37818,1208,10046,3879,47864,California
Alameda,2021-01-14,5714,63638,2832,40556,2882,23082,0,0,4801,41720,903,10949,4805,52669,California
Alameda,2021-01-15,5831,69469,2319,42875,3512,26594,0,0,5054,46012,766,11715,5058,57727,California
Alameda,2021-01-16,2968,72437,1378,44253,1590,28184,0,0,2708,48460,261,11976,2709,60436,California
Alameda,2021-01-17,1877,74314,1097,45350,780,28964,0,0,1657,49897,220,12196,1657,62093,California
Alameda,2021-01-18,3164,77478,2022,47372,1142,30106,0,0,2571,51882,588,12784,2573,64666,California
Alameda,2021-01-19,5535,83013,3318,50690,2217,32323,0,0,4314,54976,1221,14005,4315,68981,California
Alameda,2021-01-20,6911,89924,4219,54909,2692,35015,0,0,5600,59283,1297,15302,5604,74585,California
Alameda,2021-01-21,8179,98103,3775,58684,4404,39419,0,0,7304,65727,866,16168,7310,81895,California
Alameda,2021-01-22,6882,104985,2057,60741,4825,44244,0,0,5719,70294,1153,17321,5720,87615,California
Alameda,2021-01-23,3283,108268,946,61687,2337,46581,0,0,2735,72483,547,17868,2736,90351,California
Alameda,2021-01-24,2019,110287,656,62343,1363,47944,0,0,1747,73962,268,18136,1747,92098,California
Alameda,2021-01-25,5219,115506,1996,64339,3223,51167,0,0,3647,76047,1564,19700,3649,95747,California
Alameda,2021-01-26,7338,122844,2326,66665,5012,56179,0,0,5439,79597,1890,21590,5440,101187,California
Alameda,2021-01-27,6722,129566,2071,68736,4651,60830,0,0,4851,82587,1862,23452,4852,106039,California
Alameda,2021-01-28,7860,137426,2556,71292,5304,66134,0,0,5629,86005,2215,25667,5633,111672,California
Alameda,2021-01-29,8018,145444,3206,74498,4812,70946,0,0,6162,90325,1843,27510,6163,117835,California
Alameda,2021-01-30,3425,148869,1685,76183,1740,72686,0,0,2714,92335,705,28215,2715,120550,California
Alameda,2021-01-31,1932,150801,960,77143,972,73658,0,0,1688,93785,238,28453,1688,122238,California
Alameda,2021-02-01,6486,157287,3874,81017,2612,76270,0,0,4337,95983,2140,30593,4338,126576,California
Alameda,2021-02-02,7067,164354,3812,84829,3255,79525,0,0,4705,98337,2351,32944,4705,131281,California
Alameda,2021-02-03,7087,171441,3750,88579,3337,82862,0,0,4335,99932,2745,35689,4340,135621,California
Alameda,2021-02-04,9466,180907,4111,92690,5355,88217,0,0,6307,103097,3147,38836,6312,141933,California
Alameda,2021-02-05,10298,191205,5363,98053,4935,93152,0,0,6370,105554,3920,42756,6377,148310,California
Alameda,2021-02-06,6956,198161,4412,102465,2544,95696,0,0,5803,110208,1150,43906,5804,154114,California
Alameda,2021-02-07,3593,201754,2898,105363,695,96391,0,0,2640,111901,948,44854,2641,156755,California
Alameda,2021-02-08,8119,209873,5783,111146,2336,98727,0,0,5525,114849,2579,47433,5527,162282,California
Alameda,2021-02-09,9717,219590,5820,116966,3897,102624,0,0,6044,117238,3657,51090,6046,168328,California
Alameda,2021-02-10,11571,231161,6830,123796,4741,107365,0,0,6462,118616,5091,56181,6469,174797,California
Alameda,2021-02-11,14038,245199,8084,131880,5954,113319,0,0,8106,120816,5909,62090,8109,182906,California
Alameda,2021-02-12,12570,257769,5712,137592,6858,120177,0,0,7761,123791,4789,66879,7764,190670,California
Alameda,2021-02-13,7847,265616,4085,141677,3762,123939,0,0,5861,127680,1974,68853,5863,196533,California
Alameda,2021-02-14,4048,269664,2551,144228,1497,125436,0,0,2863,129367,1179,70032,2866,199399,California
Alameda,2021-02-15,5699,275363,3222,147450,2477,127913,0,0,3678,131032,2017,72049,3682,203081,California
Alameda,2021-02-16,12608,287971,7044,154494,5564,133477,0,0,9301,137052,3290,75339,9310,212391,California
Alameda,2021-02-17,14217,302188,8454,162948,5763,139240,0,0,10482,143822,3714,79053,10484,222875,California
Alameda,2021-02-18,15987,318175,10156,173104,5831,145071,0,0,11580,151021,4388,83441,11587,234462,California
Alameda,2021-02-19,18020,336195,11698,184802,6322,151393,0,0,11824,156680,6171,89612,11830,246292,California
Alameda,2021-02-20,12173,348368,9851,194653,2322,153715,0,0,9317,163154,2848,92460,9322,255614,California
Alameda,2021-02-21,7988,356356,7011,201664,977,154692,0,0,5372,165924,2603,95063,5373,260987,California
Alameda,2021-02-22,11445,367801,8443,210107,3002,157694,0,0,7160,168828,4266,99329,7170,268157,California
Alameda,2021-02-23,13598,381399,8234,218341,5364,163058,0,0,8407,172069,5172,104501,8413,276570,California
Alameda,2021-02-24,15465,396864,8644,226985,6821,169879,0,0,9972,176625,5421,109922,9977,286547,California
Alameda,2021-02-25,16498,413362,9550,236535,6948,176827,0,0,10414,181011,6039,115961,10425,296972,California
Alameda,2021-02-26,19290,432652,11201,247736,8089,184916,0,0,12187,186158,7046,123007,12193,309165,California
Alameda,2021-02-27,15727,448379,11585,259321,4140,189056,2,2,9699,189881,5982,128989,9705,318870,California
Alameda,2021-02-28,10467,458846,8732,268053,1733,190789,2,4,6704,192853,3735,132724,6707,325577,California
Alameda,2021-03-01,14562,473408,10054,278107,4491,195280,17,21,8859,196091,5645,138369,8883,334460,California
Alameda,2021-03-02,15466,488874,11089,289196,4374,199654,3,24,10095,200857,5340,143709,10106,344566,California
Alameda,2021-03-03,16173,505047,10562,299758,5607,205261,4,28,11015,206755,5126,148835,11024,355590,California
Alameda,2021-03-04,17788,522835,11393,311151,6392,211653,3,31,11153,211320,6592,155427,11157,366747,California
Alameda,2021-03-05,16543,539378,10811,321962,5718,217371,14,45,11096,217038,5401,160828,11119,377866,California
Alameda,2021-03-06,14815,554193,10440,332402,4112,221483,263,308,9752,222036,5010,165838,10008,387874,California
Alameda,2021-03-07,9970,564163,8540,340942,1211,222694,219,527,7026,226372,2910,168748,7246,395120,California
Alameda,2021-03-08,12078,576241,7519,348461,4155,226849,404,931,8975,232679,3056,171804,9363,404483,California
Alameda,2021-03-09,14823,591064,10390,358851,3990,230839,443,1374,8024,234386,6756,178560,8463,412946,California
Alameda,2021-03-10,17589,608653,12122,370973,4904,235743,563,1937,7887,233153,9663,188223,8430,421376,California
Alameda,2021-03-11,19812,628465,11608,382581,6490,242233,1714,3651,6758,228508,13019,201242,8374,429750,California
Alameda,2021-03-12,21461,649926,12572,395153,7171,249404,1718,5369,7372,223467,14049,215291,9008,438758,California
Alameda,2021-03-13,16174,666100,10363,405516,4793,254197,1018,6387,5134,218567,11002,226293,6102,444860,California
Alameda,2021-03-14,10880,676980,8033,413549,2062,256259,785,7172,3281,215022,7576,233869,4031,448891,California
Alameda,2021-03-15,14546,691526,9492,423041,4528,260787,526,7698,6159,213342,8344,242213,6664,455555,California
Alameda,2021-03-16,17317,708843,11248,434289,5526,266313,543,8241,7235,211087,10021,252234,7766,463321,California
Alameda,2021-03-17,17724,726567,10053,444342,6942,273255,729,8970,8168,210455,9510,261744,8878,472199,California
Alameda,2021-03-18,19436,746003,10640,454982,7898,281153,898,9868,8698,209322,10703,272447,9570,481769,California
Alameda,2021-03-19,19628,765631,10803,465785,7042,288195,1783,11651,7655,206793,11910,284357,9381,491150,California
Alameda,2021-03-20,15861,781492,10402,476187,4603,292798,856,12507,6235,204273,9582,293939,7062,498212,California
Alameda,2021-03-21,9271,790763,7285,483472,1425,294223,561,13068,3328,202231,5926,299865,3884,502096,California
Alameda,2021-03-22,15279,806042,10261,493733,4010,298233,1008,14076,6897,201776,8341,308206,7886,509982,California
Alameda,2021-03-23,19556,825598,11858,505591,6878,305111,820,14896,9811,202705,9687,317893,10616,520598,California
Alameda,2021-03-24,19580,845178,11774,517365,6777,311888,1029,15925,8446,201087,11061,328954,9443,530041,California
Alameda,2021-03-25,20802,865980,11503,528868,7875,319763,1424,17349,9382,200520,11338,340292,10771,540812,California
Alameda,2021-03-26,21179,887159,12738,541606,6873,326636,1568,18917,8449,197830,12671,352963,9981,550793,California
Alameda,2021-03-27,18484,905643,12602,554208,4928,331564,954,19871,7444,195229,10976,363939,8375,559168,California
Alameda,2021-03-28,10727,916370,8744,562952,1775,333339,208,20079,3440,191610,7265,371204,3646,562814,California
Alameda,2021-03-29,14998,931368,9504,572456,4501,337840,993,21072,5996,189632,8955,380159,6977,569791,California
Alameda,2021-03-30,18892,950260,9893,582349,7260,345100,1739,22811,9421,191333,9426,389585,11127,580918,California
Alameda,2021-03-31,19550,969810,10217,592566,7202,352302,2131,24942,9044,192011,10463,400048,11141,592059,California
Alameda,2021-04-01,23497,993307,10009,602575,7763,360065,5725,30667,11144,196407,12283,412331,16679,608738,California
Alameda,2021-04-02,24304,1017611,9893,612468,8485,368550,5926,36593,11834,201545,12422,424753,17560,626298,California
Alameda,2021-04-03,20392,1038003,9822,622290,5684,374234,4886,41479,10300,206542,10060,434813,15057,641355,California
Alameda,2021-04-04,9956,1047959,3997,626287,2258,376492,3701,45180,3495,207218,6438,441251,7114,648469,California
Alameda,2021-04-05,18006,1065965,7557,633844,5624,382116,4825,50005,7423,208836,10547,451798,12165,660634,California
Alameda,2021-04-06,22404,1088369,10730,644574,5782,387898,5892,55897,10264,212788,12095,463893,16047,676681,California
Alameda,2021-04-07,22788,1111157,11679,656253,5611,393509,5498,61395,11542,218524,11197,475090,16933,693614,California
Alameda,2021-04-08,25718,1136875,11578,667831,6097,399606,8043,69438,11092,222991,14538,489628,19005,712619,California
Alameda,2021-04-09,23568,1160443,10741,678572,7551,407157,5276,74714,12163,229010,11359,500987,17378,729997,California
Alameda,2021-04-10,19473,1179916,7541,686113,5689,412846,6243,80957,8342,232417,11094,512081,14501,744498,California
Alameda,2021-04-11,11103,1191019,4887,691000,2234,415080,3982,84939,4571,234384,6509,518590,8476,752974,California
Alameda,2021-04-12,18361,1209380,11901,702901,4447,419527,2013,86952,10353,238771,7964,526554,12351,765325,California
Alameda,2021-04-13,23354,1232734,14848,717749,8444,427971,62,87014,17168,249876,6131,532685,17236,782561,California
Alameda,2021-04-14,23521,1256255,15478,733227,8039,436010,4,87018,15771,257960,7699,540384,15783,798344,California
Alameda,2021-04-15,24390,1280645,15511,748738,8874,444884,5,87023,16056,265779,8257,548641,16076,814420,California
Alameda,2021-04-16,24828,1305473,14611,763349,10209,455093,8,87031,15885,272819,8870,557511,15910,830330,California
Alameda,2021-04-17,21208,1326681,14635,777984,6571,461664,2,87033,14631,280935,6533,564044,14649,844979,California
Alameda,2021-04-18,10518,1337199,8165,786149,2353,464017,0,87033,7254,284974,3223,567267,7262,852241,California
Alameda,2021-04-19,15934,1353133,9894,796043,6037,470054,3,87036,9142,287387,6745,574012,9158,861399,California
Alameda,2021-04-20,18873,1372006,11691,807734,7180,477234,2,87038,10229,289061,8578,582590,10252,871651,California
Alameda,2021-04-21,20400,1392406,12218,819952,8166,485400,16,87054,11752,292282,8568,591158,11789,883440,California
Alameda,2021-04-22,22239,1414645,14389,834341,7843,493243,7,87061,11788,293730,10377,601535,11825,895265,California
Alameda,2021-04-23,22575,1437220,14720,849061,7851,501094,4,87065,12599,296459,9904,611439,12633,907898,California
Alameda,2021-04-24,19185,1456405,14568,863629,4606,505700,11,87076,10142,297644,8986,620425,10171,918069,California
Alameda,2021-04-25,9085,1465490,7084,870713,2000,507700,1,87077,5957,300515,3101,623526,5972,924041,California
Alameda,2021-04-26,14956,1480446,10388,881101,4540,512240,28,87105,9096,303836,5815,629341,9136,933177,California
Alameda,2021-04-27,16761,1497207,9980,891081,6411,518651,370,87475,7825,303180,8876,638217,8220,941397,California
Alameda,2021-04-28,17185,1514392,10984,902065,5734,524385,467,87942,6894,300317,10241,648458,7378,948775,California
Alameda,2021-04-29,17899,1532291,10812,912877,6749,531134,338,88280,6650,296150,11181,659639,7014,955789,California
Alameda,2021-04-30,20717,1553008,12945,925822,7422,538556,350,88630,8534,293013,12077,671716,8940,964729,California
Alameda,2021-05-01,14307,1567315,9554,935376,4538,543094,215,88845,5381,289760,8876,680592,5623,970352,California
Alameda,2021-05-02,7147,1574462,5001,940377,1973,545067,173,89018,2894,288600,4232,684824,3072,973424,California
Alameda,2021-05-03,14863,1589325,11190,951567,3349,548416,324,89342,2844,279857,11946,696770,3203,976627,California
Alameda,2021-05-04,19092,1608417,13800,965367,4926,553342,366,89708,3775,268804,15232,712002,4179,980806,California
Alameda,2021-05-05,19022,1627439,13896,979263,4607,557949,519,90227,3817,258032,15131,727133,4359,985165,California
Alameda,2021-05-06,19578,1647017,14889,994152,3988,561937,701,90928,3789,246849,15695,742828,4512,989677,California
Alameda,2021-05-07,19607,1666624,13219,1007371,5968,567905,420,91348,4471,236704,15056,757884,4911,994588,California
Alameda,2021-05-08,17271,1683895,11971,1019342,5088,572993,212,91560,3289,226287,13935,771819,3518,998106,California
Alameda,2021-05-09,8634,1692529,7075,1026417,1414,574407,145,91705,1319,220466,7291,779110,1470,999576,California
Alameda,2021-05-10,10512,1703041,7267,1033684,2913,577320,332,92037,2498,215337,7968,787078,2839,1002415,California
Alameda,2021-05-11,15922,1718963,8765,1042449,6837,584157,320,92357,2829,205491,13032,800110,3186,1005601,California
Alameda,2021-05-12,13630,1732593,9097,1051546,4081,588238,452,92809,2742,197889,10832,810942,3230,1008831,California
Alameda,2021-05-13,18223,1750816,13095,1064641,4579,592817,549,93358,5725,191767,12434,823376,6312,1015143,California
Alameda,2021-05-14,21035,1771851,14283,1078924,6286,599103,466,93824,7110,185518,13839,837215,7590,1022733,California
Alameda,2021-05-15,17583,1789434,12819,1091743,4530,603633,234,94058,5984,180199,11542,848757,6223,1028956,California
Alameda,2021-05-16,9016,1798450,7753,1099496,1158,604791,105,94163,3152,177639,5824,854581,3264,1032220,California
Alameda,2021-05-17,13618,1812068,10160,1109656,2919,607710,539,94702,4188,172996,9384,863965,4741,1036961,California
Alameda,2021-05-18,14344,1826412,10439,1120095,3477,611187,428,95130,5003,169132,9296,873261,5432,1042393,California
Alameda,2021-05-19,14602,1841014,10007,1130102,4253,615440,342,95472,5910,166753,8634,881895,6255,1048648,California
Alameda,2021-05-20,13578,1854592,8955,1139057,4081,619521,542,96014,5810,165400,7708,889603,6355,1055003,California
Alameda,2021-05-21,15473,1870065,10175,1149232,5027,624548,271,96285,5133,160546,10264,899867,5410,1060413,California
Alameda,2021-05-22,10501,1880566,7620,1156852,2712,627260,169,96454,4221,158704,6237,906104,4395,1064808,California
Alameda,2021-05-23,5173,1885739,3983,1160835,1099,628359,91,96545,1687,157019,3465,909569,1780,1066588,California
Alameda,2021-05-24,7326,1893065,4267,1165102,2799,631158,260,96805,2824,155651,4455,914024,3087,1069675,California
Alameda,2021-05-25,8134,1901199,5265,1170367,2604,633762,265,97070,3580,154981,4513,918537,3843,1073518,California
Alameda,2021-05-26,8369,1909568,5243,1175610,2821,636583,305,97375,3613,154174,4719,923256,3912,1077430,California
Alameda,2021-05-27,8247,1917815,4914,1180524,2931,639514,402,97777,3358,153090,4838,928094,3754,1081184,California
Alameda,2021-05-28,8777,1926592,5152,1185676,3391,642905,234,98011,3665,151921,5071,933165,3902,1085086,California
Alameda,2021-05-29,4984,1931576,3016,1188692,1782,644687,186,98197,2450,152049,2509,935674,2637,1087723,California
Alameda,2021-05-30,2484,1934060,1631,1190323,764,645451,89,98286,982,151629,1490,937164,1070,1088793,California
Alameda,2021-05-31,1171,1935231,869,1191192,247,645698,55,98341,347,151225,806,937970,402,1089195,California
Alameda,2021-06-01,7250,1942481,5038,1196230,1902,647600,310,98651,2980,150274,4238,942208,3287,1092482,California
Alameda,2021-06-02,5891,1948372,3672,1199902,1994,649594,225,98876,2223,149086,3628,945836,2440,1094922,California
Alameda,2021-06-03,8578,1956950,6457,1206359,1818,651412,303,99179,2800,146447,5738,951574,3099,1098021,California
Alameda,2021-06-04,10620,1967570,7828,1214187,2546,653958,246,99425,2880,141875,7695,959269,3123,1101144,California
Alameda,2021-06-05,8193,1975763,5954,1220141,2074,656032,165,99590,1800,137481,6356,965625,1962,1103106,California
Alameda,2021-06-06,3701,1979464,3342,1223483,279,656311,80,99670,849,135572,2840,968465,931,1104037,California
Alameda,2021-06-07,5928,1985392,4311,1227794,1428,657739,189,99859,1773,133408,4127,972592,1963,1106000,California
Alameda,2021-06-08,7290,1992682,5825,1233619,1218,658957,247,100106,2108,130602,5158,977750,2352,1108352,California
Alameda,2021-06-09,7355,2000037,5997,1239616,1151,660108,207,100313,1685,126845,5644,983394,1887,1110239,California
Alameda,2021-06-10,8038,2008075,6725,1246341,1012,661120,301,100614,2121,123378,5888,989282,2421,1112660,California
Alameda,2021-06-11,8182,2016257,6262,1252603,1691,662811,229,100843,2517,120493,5634,994916,2749,1115409,California
Alameda,2021-06-12,5603,2021860,4302,1256905,1115,663926,186,101029,1390,117888,4188,999104,1583,1116992,California
Alameda,2021-06-13,2343,2024203,1792,1258697,428,664354,123,101152,674,117027,1656,1000760,795,1117787,California
Alameda,2021-06-14,4659,2028862,3510,1262207,936,665290,213,101365,1588,115779,3045,1003805,1797,1119584,California
Alameda,2021-06-15,6090,2034952,4422,1266629,1383,666673,285,101650,1823,113663,4222,1008027,2106,1121690,California
Alameda,2021-06-16,5297,2040249,4226,1270855,866,667539,205,101855,1588,111763,3690,1011717,1790,1123480,California
Alameda,2021-06-17,5708,2045957,4602,1275457,867,668406,239,102094,1904,110138,3770,1015487,2145,1125625,California
Alameda,2021-06-18,5985,2051942,4514,1279971,1215,669621,256,102350,1985,108407,3967,1019454,2236,1127861,California
Alameda,2021-06-19,3468,2055410,2624,1282595,685,670306,159,102509,1065,107242,2388,1021842,1223,1129084,California
Alameda,2021-06-20,1409,2056819,1179,1283774,185,670491,45,102554,528,106939,874,1022716,571,1129655,California
Alameda,2021-06-21,2737,2059556,1855,1285629,715,671206,167,102721,1392,107173,1324,1024040,1558,1131213,California
Alameda,2021-06-22,4619,2064175,3573,1289202,842,672048,204,102925,1417,105610,3180,1027220,1617,1132830,California
Alameda,2021-06-23,3522,2067697,2708,1291910,629,672677,185,103110,1185,104652,2323,1029543,1365,1134195,California
Alameda,2021-06-24,4451,2072148,3554,1295464,661,673338,236,103346,1535,103530,2891,1032434,1769,1135964,California
Alameda,2021-06-25,4682,2076830,3505,1298969,967,674305,210,103556,1718,102514,2943,1035377,1927,1137891,California
Alameda,2021-06-26,3106,2079936,2284,1301253,654,674959,168,103724,1078,101754,2003,1037380,1243,1139134,California
Alameda,2021-06-27,1316,2081252,1083,1302336,187,675146,46,103770,517,101525,792,1038172,563,1139697,California
Alameda,2021-06-28,2947,2084199,2394,1304730,358,675504,195,103965,1156,101108,1767,1039939,1350,1141047,California
Alameda,2021-06-29,3735,2087934,2990,1307720,606,676110,139,104104,1321,100169,2397,1042336,1458,1142505,California
Alameda,2021-06-30,2935,2090869,2276,1309996,527,676637,132,104236,1098,99575,1822,1044158,1228,1143733,California
Alameda,2021-07-01,3529,2094398,2768,1312764,609,677246,152,104388,1270,98759,2234,1046392,1418,1145151,California
Alameda,2021-07-02,4056,2098454,3046,1315810,838,678084,172,104560,1500,97896,2527,1048919,1664,1146815,California
Alameda,2021-07-03,2065,2100519,1508,1317318,466,678550,91,104651,810,97553,1242,1050161,899,1147714,California
Alameda,2021-07-04,100,2100619,66,1317384,29,678579,5,104656,42,97543,57,1050218,47,1147761,California
Alameda,2021-07-05,1640,2102259,1364,1318748,218,678797,58,104714,722,97419,901,1051119,777,1148538,California
Alameda,2021-07-06,3676,2105935,2941,1321689,628,679425,107,104821,1256,96389,2392,1053511,1362,1149900,California
Alameda,2021-07-07,2796,2108731,2038,1323727,581,680006,177,104998,980,95761,1783,1055294,1155,1151055,California
Alameda,2021-07-08,2836,2111567,2247,1325974,440,680446,149,105147,1035,95167,1772,1057066,1178,1152233,California
Alameda,2021-07-09,3581,2115148,2790,1328764,639,681085,152,105299,1408,94585,2141,1059207,1559,1153792,California
Alameda,2021-07-10,2215,2117363,1624,1330388,471,681556,120,105419,867,94250,1323,1060530,988,1154780,California
Alameda,2021-07-11,1028,2118391,813,1331201,151,681707,64,105483,398,94087,624,1061154,461,1155241,California
Alameda,2021-07-12,2609,2121000,2009,1333210,466,682173,134,105617,1025,93678,1565,1062719,1156,1156397,California
Alameda,2021-07-13,2743,2123743,2141,1335351,457,682630,145,105762,1152,93405,1569,1064288,1296,1157693,California
Alameda,2021-07-14,2212,2125955,1653,1337004,428,683058,131,105893,978,93292,1214,1065502,1101,1158794,California
Alameda,2021-07-15,2509,2128464,2012,1339016,408,683466,89,105982,1107,93107,1380,1066882,1195,1159989,California
Alameda,2021-07-16,3276,2131740,2607,1341623,556,684022,113,106095,1437,92840,1814,1068696,1547,1161536,California
Alameda,2021-07-17,2094,2133834,1634,1343257,391,684413,69,106164,934,92702,1141,1069837,1003,1162539,California
Alameda,2021-07-18,1039,2134873,818,1344075,123,684536,98,106262,466,92703,563,1070400,564,1163103,California
Alameda,2021-07-19,2532,2137405,2012,1346087,418,684954,102,106364,1245,92788,1261,1071661,1346,1164449,California
Alameda,2021-07-20,2604,2140009,2070,1348157,418,685372,116,106480,1296,92921,1274,1072935,1407,1165856,California
Alameda,2021-07-21,2426,2142435,1905,1350062,412,685784,109,106589,1201,93034,1193,1074128,1306,1167162,California
Alameda,2021-07-22,2520,2144955,1969,1352031,422,686206,129,106718,1285,93236,1211,1075339,1413,1168575,California
Alameda,2021-07-23,3372,2148327,2653,1354684,572,686778,147,106865,1619,93282,1714,1077053,1760,1170335,California
Alameda,2021-07-24,2222,2150549,1695,1356379,439,687217,88,106953,1160,93497,1033,1078086,1248,1171583,California
Alameda,2021-07-25,716,2151265,603,1356982,106,687323,7,106960,513,93824,193,1078279,520,1172103,California
Alameda,2021-07-26,2473,2153738,1866,1358848,473,687796,134,107094,1454,94416,995,1079274,1587,1173690,California
Alameda,2021-07-27,2872,2156610,2285,1361133,450,688246,137,107231,1600,94918,1233,1080507,1735,1175425,California
Alameda,2021-07-28,2299,2158909,1736,1362869,445,688691,118,107349,1294,95359,968,1081475,1409,1176834,California
Alameda,2021-07-29,2773,2161682,2227,1365096,406,689097,140,107489,1554,95866,1186,1082661,1693,1178527,California
Alameda,2021-07-30,3472,2165154,2768,1367864,535,689632,169,107658,1874,96363,1540,1084201,2037,1180564,California
Alameda,2021-07-31,2174,2167328,1767,1369631,324,689956,83,107741,1237,96780,902,1085103,1319,1181883,California
Alameda,2021-08-01,912,2168240,750,1370381,143,690099,19,107760,530,96968,361,1085464,549,1182432,California
Alameda,2021-08-02,2882,2171122,2339,1372720,408,690507,135,107895,1712,97680,1133,1086597,1845,1184277,California
Alameda,2021-08-03,3089,2174211,2464,1375184,452,690959,173,108068,1861,98519,1193,1087790,2032,1186309,California
Alameda,2021-08-04,2603,2176814,2079,1377263,412,691371,112,108180,1581,99225,988,1088778,1694,1188003,California
Alameda,2021-08-05,3128,2179942,2525,1379788,457,691828,146,108326,1840,99955,1254,1090032,1984,1189987,California
Alameda,2021-08-06,3938,2183880,3162,1382950,633,692461,143,108469,2296,100789,1605,1091637,2439,1192426,California
Alameda,2021-08-07,2398,2186278,1964,1384914,331,692792,103,108572,1298,101123,1064,1092701,1398,1193824,California
Alameda,2021-08-08,1198,2187476,984,1385898,165,692957,49,108621,698,101385,484,1093185,746,1194570,California
Alameda,2021-08-09,3044,2190520,2469,1388367,443,693400,132,108753,1603,101711,1407,1094592,1733,1196303,California
Alameda,2021-08-10,2809,2193329,2261,1390628,441,693841,107,108860,1514,102064,1266,1095858,1619,1197922,California
Alameda,2021-08-11,2384,2195713,1810,1392438,463,694304,111,108971,1306,102447,1034,1096892,1417,1199339,California
Alameda,2021-08-12,2818,2198531,2241,1394679,454,694758,123,109094,1504,102812,1260,1098152,1625,1200964,California
Alameda,2021-08-13,4035,2202566,3266,1397945,625,695383,144,109238,2153,103305,1804,1099956,2297,1203261,California
Alameda,2021-08-14,2468,2205034,1918,1399863,463,695846,87,109325,1203,103481,1113,1101069,1289,1204550,California
Alameda,2021-08-15,1185,2206219,897,1400760,222,696068,66,109391,610,103685,473,1101542,677,1205227,California
Alameda,2021-08-16,3236,2209455,2485,1403245,603,696671,148,109539,1539,103961,1410,1102952,1686,1206913,California
Alameda,2021-08-17,3317,2212772,2619,1405864,573,697244,125,109664,1536,104142,1480,1104432,1661,1208574,California
Alameda,2021-08-18,2969,2215741,2272,1408136,580,697824,117,109781,1311,104381,1187,1105619,1426,1210000,California
Alameda,2021-08-19,3422,2219163,2548,1410684,749,698573,125,109906,1410,104528,1388,1107007,1535,1211535,California
Alameda,2021-08-20,4530,2223693,3422,1414106,974,699547,134,110040,1838,104586,1910,1108917,1968,1213503,California
Alameda,2021-08-21,2862,2226555,2269,1416375,495,700042,98,110138,1104,104497,1287,1110204,1198,1214701,California
Alameda,2021-08-22,1362,2227917,1052,1417427,269,700311,41,110179,645,104657,525,1110729,685,1215386,California
Alameda,2021-08-23,3711,2231628,2791,1420218,812,701123,108,110287,1420,104501,1684,1112413,1528,1216914,California
Alameda,2021-08-24,3648,2235276,2918,1423136,630,701753,100,110387,1395,104352,1645,1114058,1496,1218410,California
Alameda,2021-08-25,3059,2238335,2368,1425504,618,702371,73,110460,1149,104196,1377,1115435,1221,1219631,California
Alameda,2021-08-26,3665,2242000,2932,1428436,629,703000,104,110564,1360,103959,1700,1117135,1463,1221094,California
Alameda,2021-08-27,4367,2246367,3495,1431931,757,703757,115,110679,1544,103359,2258,1119393,1658,1222752,California
Alameda,2021-08-28,2635,2249002,2093,1434024,495,704252,47,110726,940,103057,1287,1120680,985,1223737,California
Alameda,2021-08-29,1202,2250204,941,1434965,254,704506,7,110733,414,102874,604,1121284,421,1224158,California
Alameda,2021-08-30,2409,2252613,1785,1436750,545,705051,79,110812,760,102546,1169,1122453,841,1224999,California
Alpine,2020-12-18,2,2,2,2,0,0,0,0,2,2,0,0,2,2,California
Alpine,2020-12-19,2,4,2,4,0,0,0,0,2,4,0,0,2,4,California
Alpine,2020-12-21,1,5,1,5,0,0,0,0,1,5,0,0,1,5,California
Alpine,2020-12-29,1,6,0,5,1,1,0,0,1,6,0,0,1,6,California
Alpine,2020-12-30,14,20,0,5,14,15,0,0,14,20,0,0,14,20,California
Alpine,2020-12-31,1,21,0,5,1,16,0,0,1,21,0,0,1,21,California
Alpine,2021-01-01,1,22,0,5,1,17,0,0,1,22,0,0,1,22,California
Alpine,2021-01-02,1,23,1,6,0,17,0,0,1,23,0,0,1,23,California
Alpine,2021-01-04,10,33,0,6,10,27,0,0,10,33,0,0,10,33,California
Alpine,2021-01-05,8,41,0,6,8,35,0,0,8,41,0,0,8,41,California
Alpine,2021-01-06,31,72,0,6,31,66,0,0,31,72,0,0,31,72,California
Alpine,2021-01-07,8,80,0,6,8,74,0,0,8,80,0,0,8,80,California
Alpine,2021-01-08,4,84,2,8,2,76,0,0,2,80,2,2,2,82,California
Alpine,2021-01-09,2,86,2,10,0,76,0,0,0,78,2,4,0,82,California
Alpine,2021-01-11,32,118,1,11,31,107,0,0,31,108,1,5,31,113,California
Alpine,2021-01-13,35,153,0,11,35,142,0,0,35,143,0,5,35,148,California
Alpine,2021-01-14,1,154,0,11,1,143,0,0,1,144,0,5,1,149,California
Alpine,2021-01-15,1,155,0,11,1,144,0,0,1,145,0,5,1,150,California
Alpine,2021-01-18,1,156,1,12,0,144,0,0,1,146,0,5,1,151,California
Alpine,2021-01-20,21,177,0,12,21,165,0,0,21,167,0,5,21,172,California
Alpine,2021-01-21,1,178,0,12,1,166,0,0,1,168,0,5,1,173,California
Alpine,2021-01-22,33,211,0,12,33,199,0,0,33,201,0,5,33,206,California
Alpine,2021-01-23,1,212,1,13,0,199,0,0,0,200,1,6,0,206,California
Alpine,2021-01-25,16,228,0,13,16,215,0,0,16,216,0,6,16,222,California
Alpine,2021-01-26,1,229,0,13,1,216,0,0,0,215,1,7,0,222,California
Alpine,2021-01-28,1,230,0,13,1,217,0,0,0,214,1,8,0,222,California
Alpine,2021-01-29,1,231,0,13,1,218,0,0,1,215,0,8,1,223,California
Alpine,2021-02-01,25,256,0,13,25,243,0,0,7,204,18,26,7,230,California
Alpine,2021-02-03,34,290,0,13,34,277,0,0,10,190,24,50,10,240,California
Alpine,2021-02-04,8,298,0,13,8,285,0,0,3,188,5,55,3,243,California
Alpine,2021-02-05,31,329,1,14,30,315,0,0,11,179,20,75,11,254,California
Alpine,2021-02-08,32,361,0,14,32,347,0,0,4,155,28,103,4,258,California
Alpine,2021-02-10,34,395,0,14,34,381,0,0,0,121,34,137,0,258,California
Alpine,2021-02-11,6,401,0,14,6,387,0,0,3,121,3,140,3,261,California
Alpine,2021-02-12,1,402,0,14,1,388,0,0,0,120,1,141,0,261,California
Alpine,2021-02-17,23,425,0,14,23,411,0,0,3,103,20,161,3,264,California
Alpine,2021-02-18,2,427,0,14,2,413,0,0,1,103,1,162,1,265,California
Alpine,2021-02-19,34,461,1,15,33,446,0,0,2,73,32,194,2,267,California
Alpine,2021-02-22,27,488,0,15,27,473,0,0,8,62,19,213,8,275,California
Alpine,2021-02-25,5,493,0,15,5,478,0,0,5,67,0,213,5,280,California
Alpine,2021-02-26,30,523,1,16,29,507,0,0,29,95,1,214,29,309,California
Alpine,2021-02-27,1,524,0,16,1,508,0,0,1,96,0,214,1,310,California
Alpine,2021-03-01,36,560,0,16,36,544,0,0,26,112,10,224,26,336,California
Alpine,2021-03-03,28,588,0,16,28,572,0,0,17,118,11,235,17,353,California
Alpine,2021-03-04,10,598,0,16,10,582,0,0,10,128,0,235,10,363,California
Alpine,2021-03-05,29,627,0,16,29,611,0,0,22,143,7,242,22,385,California
Alpine,2021-03-08,31,658,0,16,31,642,0,0,29,170,2,244,29,414,California
Alpine,2021-03-10,72,730,0,16,72,714,0,0,72,242,0,244,72,486,California
Alpine,2021-03-11,35,765,0,16,35,749,0,0,31,269,4,248,31,517,California
Alpine,2021-03-12,20,785,0,16,20,769,0,0,18,285,2,250,18,535,California
Alpine,2021-03-15,20,805,0,16,20,789,0,0,19,303,1,251,19,554,California
Alpine,2021-03-17,23,828,0,16,22,811,1,1,19,319,4,255,20,574,California
Alpine,2021-03-18,35,863,0,16,35,846,0,1,34,352,1,256,34,608,California
Alpine,2021-03-19,2,865,1,17,1,847,0,1,1,352,1,257,1,609,California
Alpine,2021-03-22,24,889,0,17,24,871,0,1,15,358,9,266,15,624,California
Alpine,2021-03-24,19,908,0,17,19,890,0,1,8,355,11,277,8,632,California
Alpine,2021-03-25,34,942,0,17,33,923,1,2,27,377,6,283,28,660,California
Alpine,2021-03-27,1,943,0,17,1,924,0,2,0,376,1,284,0,660,California
Alpine,2021-03-28,1,944,1,18,0,924,0,2,1,377,0,284,1,661,California
Alpine,2021-03-29,19,963,0,18,18,942,1,3,2,363,17,301,3,664,California
Alpine,2021-04-01,18,981,0,18,18,960,0,3,8,361,10,311,8,672,California
Alpine,2021-04-02,99,1080,0,18,99,1059,0,3,45,353,53,364,45,717,California
Alpine,2021-04-05,3,1083,0,18,3,1062,0,3,0,350,3,367,0,717,California
Alpine,2021-04-06,2,1085,1,19,1,1063,0,3,1,350,1,368,1,718,California
Alpine,2021-04-07,117,1202,0,19,116,1179,1,4,30,295,86,454,31,749,California
Alpine,2021-04-08,35,1237,0,19,35,1214,0,4,10,280,25,479,10,759,California
Alpine,2021-04-09,2,1239,0,19,2,1216,0,4,2,282,0,479,2,761,California
Alpine,2021-04-14,47,1286,0,19,47,1263,0,4,10,255,37,516,10,771,California
Alpine,2021-04-15,35,1321,0,19,35,1298,0,4,3,226,32,548,3,774,California
Alpine,2021-04-19,1,1322,0,19,1,1299,0,4,1,227,0,548,1,775,California
Alpine,2021-04-21,31,1353,0,19,31,1330,0,4,15,226,16,564,15,790,California
Alpine,2021-04-22,24,1377,0,19,24,1354,0,4,1,204,23,587,1,791,California
Alpine,2021-04-25,1,1378,1,20,0,1354,0,4,0,203,1,588,0,791,California
Alpine,2021-04-27,1,1379,0,20,1,1355,0,4,1,204,0,588,1,792,California
Alpine,2021-04-28,36,1415,0,20,36,1391,0,4,6,180,30,618,6,798,California
Alpine,2021-04-29,6,1421,0,20,6,1397,0,4,0,174,6,624,0,798,California
Alpine,2021-04-30,2,1423,1,21,0,1397,1,5,1,175,1,625,2,800,California
Alpine,2021-05-02,1,1424,0,21,0,1397,1,6,0,175,1,626,1,801,California
Alpine,2021-05-05,17,1441,0,21,17,1414,0,6,4,166,13,639,4,805,California
Alpine,2021-05-06,8,1449,0,21,8,1422,0,6,0,158,8,647,0,805,California
Alpine,2021-05-07,1,1450,0,21,1,1423,0,6,0,157,1,648,0,805,California
Alpine,2021-05-10,1,1451,0,21,1,1424,0,6,1,158,0,648,1,806,California
Alpine,2021-05-12,1,1452,0,21,0,1424,1,7,0,158,1,649,1,807,California
Alpine,2021-05-13,3,1455,0,21,3,1427,0,7,0,155,3,652,0,807,California
Alpine,2021-05-17,2,1457,0,21,2,1429,0,7,1,155,1,653,1,808,California
Alpine,2021-05-18,1,1458,0,21,1,1430,0,7,1,156,0,653,1,809,California
Alpine,2021-05-19,15,1473,0,21,15,1445,0,7,0,141,15,668,0,809,California
Alpine,2021-05-21,1,1474,1,22,0,1445,0,7,0,140,1,669,0,809,California
Alpine,2021-05-25,1,1475,0,22,1,1446,0,7,0,139,1,670,0,809,California
Alpine,2021-05-27,2,1477,1,23,1,1447,0,7,2,141,0,670,2,811,California
Alpine,2021-05-28,3,1480,2,25,1,1448,0,7,3,144,0,670,3,814,California
Alpine,2021-05-29,1,1481,0,25,1,1449,0,7,1,145,0,670,1,815,California
Alpine,2021-06-02,8,1489,0,25,8,1457,0,7,1,139,7,677,1,816,California
Alpine,2021-06-04,1,1490,0,25,1,1458,0,7,1,140,0,677,1,817,California
Alpine,2021-06-07,1,1491,0,25,1,1459,0,7,0,139,1,678,0,817,California
Alpine,2021-06-10,1,1492,1,26,0,1459,0,7,1,140,0,678,1,818,California
Alpine,2021-06-15,1,1493,0,26,1,1460,0,7,0,139,1,679,0,818,California
Alpine,2021-06-18,2,1495,2,28,0,1460,0,7,0,137,2,681,0,818,California
Alpine,2021-06-19,1,1496,1,29,0,1460,0,7,0,136,1,682,0,818,California
Alpine,2021-06-25,1,1497,0,29,1,1461,0,7,0,135,1,683,0,818,California
Alpine,2021-06-29,1,1498,0,29,1,1462,0,7,1,136,0,683,1,819,California
Alpine,2021-06-30,1,1499,0,29,1,1463,0,7,0,135,1,684,0,819,California
Alpine,2021-07-01,1,1500,1,30,0,1463,0,7,0,134,1,685,0,819,California
Alpine,2021-07-06,1,1501,0,30,1,1464,0,7,1,135,0,685,1,820,California
Alpine,2021-07-07,2,1503,0,30,2,1466,0,7,2,137,0,685,2,822,California
Alpine,2021-07-16,1,1504,0,30,1,1467,0,7,1,138,0,685,1,823,California
Alpine,2021-07-20,1,1505,0,30,1,1468,0,7,1,139,0,685,1,824,California
Alpine,2021-07-24,1,1506,0,30,1,1469,0,7,1,140,0,685,1,825,California
Alpine,2021-07-30,1,1507,0,30,1,1470,0,7,0,139,1,686,0,825,California
Alpine,2021-08-03,1,1508,0,30,1,1471,0,7,1,140,0,686,1,826,California
Alpine,2021-08-04,2,1510,0,30,2,1473,0,7,0,138,2,688,0,826,California
Alpine,2021-08-11,1,1511,0,30,1,1474,0,7,1,139,0,688,1,827,California
Alpine,2021-08-13,1,1512,0,30,1,1475,0,7,1,140,0,688,1,828,California
Alpine,2021-08-17,1,1513,0,30,1,1476,0,7,0,139,1,689,0,828,California
Alpine,2021-08-23,1,1514,1,31,0,1476,0,7,1,140,0,689,1,829,California
Alpine,2021-08-24,1,1515,1,32,0,1476,0,7,1,141,0,689,1,830,California
Alpine,2021-08-25,5,1520,0,32,5,1481,0,7,3,144,0,689,3,833,California
Alpine,2021-08-29,1,1521,0,32,1,1482,0,7,0,144,0,689,0,833,California
Amador,2020-12-16,3,3,3,3,0,0,0,0,3,3,0,0,3,3,California
Amador,2020-12-17,5,8,5,8,0,0,0,0,5,8,0,0,5,8,California
Amador,2020-12-18,47,55,47,55,0,0,0,0,47,55,0,0,47,55,California
Amador,2020-12-19,16,71,16,71,0,0,0,0,16,71,0,0,16,71,California
Amador,2020-12-20,4,75,4,75,0,0,0,0,4,75,0,0,4,75,California
Amador,2020-12-21,30,105,30,105,0,0,0,0,30,105,0,0,30,105,California
Amador,2020-12-22,37,142,36,141,1,1,0,0,37,142,0,0,37,142,California
Amador,2020-12-23,41,183,39,180,2,3,0,0,41,183,0,0,41,183,California
Amador,2020-12-24,5,188,3,183,2,5,0,0,5,188,0,0,5,188,California
Amador,2020-12-26,5,193,4,187,1,6,0,0,5,193,0,0,5,193,California
Amador,2020-12-27,1,194,0,187,1,7,0,0,1,194,0,0,1,194,California
Amador,2020-12-28,32,226,28,215,4,11,0,0,32,226,0,0,32,226,California
Amador,2020-12-29,25,251,18,233,7,18,0,0,25,251,0,0,25,251,California
Amador,2020-12-30,127,378,81,314,46,64,0,0,127,378,0,0,127,378,California
Amador,2020-12-31,196,574,170,484,26,90,0,0,196,574,0,0,196,574,California
Amador,2021-01-01,2,576,0,484,2,92,0,0,2,576,0,0,2,576,California
Amador,2021-01-02,59,635,59,543,0,92,0,0,59,635,0,0,59,635,California
Amador,2021-01-03,69,704,19,562,50,142,0,0,69,704,0,0,69,704,California
Amador,2021-01-04,127,831,2,564,125,267,0,0,127,831,0,0,127,831,California
Amador,2021-01-05,33,864,3,567,30,297,0,0,32,862,1,1,32,863,California
Amador,2021-01-06,40,904,11,578,29,326,0,0,36,894,4,5,36,899,California
Amador,2021-01-07,234,1138,72,650,162,488,0,0,223,1106,11,16,223,1122,California
Amador,2021-01-08,87,1225,72,722,15,503,0,0,42,1104,45,61,43,1165,California
Amador,2021-01-09,12,1237,12,734,0,503,0,0,2,1097,10,71,3,1168,California
Amador,2021-01-10,6,1243,4,738,2,505,0,0,2,1095,4,75,2,1170,California
Amador,2021-01-11,128,1371,45,783,83,588,0,0,90,1148,38,113,91,1261,California
Amador,2021-01-12,73,1444,56,839,17,605,0,0,42,1159,31,144,42,1303,California
Amador,2021-01-13,42,1486,24,863,18,623,0,0,29,1176,12,156,29,1332,California
Amador,2021-01-14,152,1638,22,885,130,753,0,0,142,1309,10,166,143,1475,California
Amador,2021-01-15,64,1702,27,912,37,790,0,0,54,1353,10,176,54,1529,California
Amador,2021-01-16,21,1723,12,924,9,799,0,0,15,1363,6,182,16,1545,California
Amador,2021-01-17,27,1750,5,929,22,821,0,0,27,1390,0,182,27,1572,California
Amador,2021-01-18,31,1781,26,955,5,826,0,0,10,1379,21,203,10,1582,California
Amador,2021-01-19,131,1912,103,1058,28,854,0,0,81,1411,49,252,81,1663,California
Amador,2021-01-20,181,2093,29,1087,152,1006,0,0,167,1565,13,265,167,1830,California
Amador,2021-01-21,265,2358,233,1320,32,1038,0,0,152,1605,113,378,153,1983,California
Amador,2021-01-22,141,2499,74,1394,67,1105,0,0,133,1730,8,386,133,2116,California
Amador,2021-01-23,63,2562,34,1428,29,1134,0,0,60,1787,3,389,60,2176,California
Amador,2021-01-24,29,2591,12,1440,17,1151,0,0,25,1808,4,393,25,2201,California
Amador,2021-01-25,61,2652,31,1471,30,1181,0,0,42,1831,19,412,42,2243,California
Amador,2021-01-26,247,2899,18,1489,229,1410,0,0,237,2058,10,422,237,2480,California
Amador,2021-01-27,312,3211,37,1526,275,1685,0,0,263,2276,46,468,264,2744,California
Amador,2021-01-28,378,3589,100,1626,278,1963,0,0,294,2487,84,552,295,3039,California
Amador,2021-01-29,106,3695,32,1658,74,2037,0,0,91,2563,15,567,91,3130,California
Amador,2021-01-30,199,3894,38,1696,161,2198,0,0,194,2752,5,572,194,3324,California
Amador,2021-01-31,34,3928,29,1725,5,2203,0,0,33,2784,1,573,33,3357,California
Amador,2021-02-01,65,3993,22,1747,43,2246,0,0,37,2793,28,601,37,3394,California
Amador,2021-02-02,219,4212,70,1817,149,2395,0,0,131,2839,86,687,132,3526,California
Amador,2021-02-03,144,4356,41,1858,103,2498,0,0,89,2874,54,741,89,3615,California
Amador,2021-02-04,254,4610,77,1935,177,2675,0,0,165,2954,88,829,168,3783,California
Amador,2021-02-05,341,4951,64,1999,277,2952,0,0,322,3258,18,847,322,4105,California
Amador,2021-02-06,128,5079,84,2083,44,2996,0,0,124,3378,4,851,124,4229,California
Amador,2021-02-07,38,5117,34,2117,4,3000,0,0,34,3409,4,855,35,4264,California
Amador,2021-02-08,92,5209,64,2181,28,3028,0,0,75,3467,17,872,75,4339,California
Amador,2021-02-09,175,5384,81,2262,94,3122,0,0,107,3506,68,940,107,4446,California
Amador,2021-02-10,986,6370,80,2342,906,4028,0,0,951,4423,34,974,951,5397,California
Amador,2021-02-11,320,6690,124,2466,196,4224,0,0,201,4510,117,1091,204,5601,California
Amador,2021-02-12,339,7029,123,2589,216,4440,0,0,263,4697,76,1167,263,5864,California
Amador,2021-02-13,179,7208,83,2672,96,4536,0,0,150,4818,29,1196,150,6014,California
Amador,2021-02-14,125,7333,55,2727,70,4606,0,0,107,4907,18,1214,107,6121,California
Amador,2021-02-15,188,7521,61,2788,127,4733,0,0,170,5060,17,1231,170,6291,California
Amador,2021-02-16,473,7994,56,2844,417,5150,0,0,430,5448,43,1274,431,6722,California
Amador,2021-02-17,273,8267,89,2933,184,5334,0,0,171,5517,102,1376,171,6893,California
Amador,2021-02-18,398,8665,99,3032,299,5633,0,0,333,5785,65,1441,333,7226,California
Amador,2021-02-19,198,8863,75,3107,123,5756,0,0,112,5811,86,1527,112,7338,California
Amador,2021-02-20,105,8968,35,3142,70,5826,0,0,67,5840,38,1565,67,7405,California
Amador,2021-02-21,54,9022,36,3178,18,5844,0,0,18,5824,34,1599,18,7423,California
Amador,2021-02-22,69,9091,26,3204,43,5887,0,0,33,5822,35,1634,33,7456,California
Amador,2021-02-23,328,9419,58,3262,270,6157,0,0,138,5771,190,1824,139,7595,California
Amador,2021-02-24,403,9822,63,3325,340,6497,0,0,264,5900,135,1959,264,7859,California
Amador,2021-02-25,543,10365,130,3455,413,6910,0,0,284,5927,257,2216,284,8143,California
Amador,2021-02-26,647,11012,83,3538,564,7474,0,0,519,6319,127,2343,519,8662,California
Amador,2021-02-27,316,11328,106,3644,210,7684,0,0,103,6212,212,2555,105,8767,California
Amador,2021-02-28,129,11457,58,3702,71,7755,0,0,64,6213,65,2620,66,8833,California
Amador,2021-03-01,207,11664,76,3778,131,7886,0,0,130,6267,77,2697,131,8964,California
Amador,2021-03-02,397,12061,75,3853,322,8208,0,0,337,6545,60,2757,338,9302,California
Amador,2021-03-03,257,12318,92,3945,165,8373,0,0,172,6634,84,2841,173,9475,California
Amador,2021-03-04,501,12819,117,4062,384,8757,0,0,395,6925,105,2946,396,9871,California
Amador,2021-03-05,528,13347,88,4150,440,9197,0,0,292,6986,234,3180,295,10166,California
Amador,2021-03-06,104,13451,51,4201,52,9249,1,1,57,6997,47,3227,58,10224,California
Amador,2021-03-07,96,13547,46,4247,50,9299,0,1,26,6953,70,3297,26,10250,California
Amador,2021-03-08,160,13707,75,4322,84,9383,1,2,94,6982,66,3363,95,10345,California
Amador,2021-03-09,384,14091,56,4378,328,9711,0,2,291,7185,89,3452,292,10637,California
Amador,2021-03-10,526,14617,80,4458,444,10155,2,4,113,6889,413,3865,117,10754,California
Amador,2021-03-11,485,15102,126,4584,348,10503,11,15,303,7026,180,4045,317,11071,California
Amador,2021-03-12,592,15694,70,4654,515,11018,7,22,347,7141,244,4289,359,11430,California
Amador,2021-03-13,123,15817,18,4672,98,11116,7,29,76,7185,45,4334,89,11519,California
Amador,2021-03-14,98,15915,17,4689,79,11195,2,31,20,7129,78,4412,22,11541,California
Amador,2021-03-15,180,16095,26,4715,147,11342,7,38,52,7061,128,4540,60,11601,California
Amador,2021-03-16,458,16553,56,4771,393,11735,9,47,141,6897,315,4855,151,11752,California
Amador,2021-03-17,387,16940,48,4819,336,12071,3,50,264,7043,121,4976,267,12019,California
Amador,2021-03-18,519,17459,104,4923,411,12482,4,54,255,7044,262,5238,263,12282,California
Amador,2021-03-19,552,18011,58,4981,477,12959,17,71,391,7297,159,5397,412,12694,California
Amador,2021-03-20,115,18126,47,5028,67,13026,1,72,49,7285,65,5462,53,12747,California
Amador,2021-03-21,51,18177,33,5061,17,13043,1,73,27,7291,24,5486,30,12777,California
Amador,2021-03-22,118,18295,36,5097,53,13096,29,102,49,7300,69,5555,78,12855,California
Amador,2021-03-23,441,18736,47,5144,387,13483,7,109,277,7422,163,5718,285,13140,California
Amador,2021-03-24,351,19087,42,5186,55,13538,254,363,38,7402,312,6030,292,13432,California
Amador,2021-03-25,616,19703,89,5275,520,14058,7,370,400,7594,215,6245,407,13839,California
Amador,2021-03-26,756,20459,46,5321,704,14762,6,376,283,7416,470,6715,292,14131,California
Amador,2021-03-27,91,20550,16,5337,73,14835,2,378,29,7387,62,6777,33,14164,California
Amador,2021-03-28,70,20620,16,5353,52,14887,2,380,10,7341,59,6836,13,14177,California
Amador,2021-03-29,185,20805,32,5385,152,15039,1,381,81,7328,101,6937,88,14265,California
Amador,2021-03-30,538,21343,28,5413,509,15548,1,382,287,7366,250,7187,288,14553,California
Amador,2021-03-31,203,21546,58,5471,140,15688,5,387,44,7257,158,7345,49,14602,California
Amador,2021-04-01,621,22167,91,5562,530,16218,0,387,264,7170,353,7698,266,14868,California
Amador,2021-04-02,618,22785,40,5602,565,16783,13,400,385,7338,232,7930,400,15268,California
Amador,2021-04-03,90,22875,28,5630,43,16826,19,419,23,7316,67,7997,45,15313,California
Amador,2021-04-04,41,22916,3,5633,31,16857,7,426,15,7312,26,8023,22,15335,California
Amador,2021-04-05,146,23062,50,5683,79,16936,17,443,47,7280,98,8121,66,15401,California
Amador,2021-04-06,505,23567,38,5721,449,17385,18,461,221,7237,282,8403,239,15640,California
Amador,2021-04-07,103,23670,35,5756,48,17433,20,481,44,7245,56,8459,64,15704,California
Amador,2021-04-08,499,24169,85,5841,392,17825,22,503,220,7211,277,8736,243,15947,California
Amador,2021-04-09,491,24660,24,5865,447,18272,20,523,213,7164,277,9013,230,16177,California
Amador,2021-04-10,51,24711,15,5880,27,18299,9,532,21,7164,30,9043,30,16207,California
Amador,2021-04-11,50,24761,24,5904,22,18321,4,536,22,7163,27,9070,26,16233,California
Amador,2021-04-12,100,24861,28,5932,62,18383,10,546,41,7155,59,9129,51,16284,California
Amador,2021-04-13,348,25209,49,5981,299,18682,0,546,65,6942,279,9408,66,16350,California
Amador,2021-04-14,284,25493,30,6011,254,18936,0,546,56,6774,225,9633,57,16407,California
Amador,2021-04-15,337,25830,77,6088,260,19196,0,546,69,6586,257,9890,69,16476,California
Amador,2021-04-16,495,26325,31,6119,464,19660,0,546,384,6861,110,10000,385,16861,California
Amador,2021-04-17,66,26391,35,6154,31,19691,0,546,30,6855,36,10036,30,16891,California
Amador,2021-04-18,41,26432,16,6170,25,19716,0,546,12,6838,29,10065,12,16903,California
Amador,2021-04-19,73,26505,30,6200,43,19759,0,546,30,6829,41,10106,32,16935,California
Amador,2021-04-20,442,26947,57,6257,385,20144,0,546,109,6614,326,10432,111,17046,California
Amador,2021-04-21,87,27034,33,6290,53,20197,1,547,43,6615,43,10475,44,17090,California
Amador,2021-04-22,517,27551,78,6368,438,20635,1,548,100,6317,399,10874,101,17191,California
Amador,2021-04-23,368,27919,47,6415,321,20956,0,548,289,6534,74,10948,291,17482,California
Amador,2021-04-24,51,27970,25,6440,26,20982,0,548,29,6542,21,10969,29,17511,California
Amador,2021-04-25,45,28015,19,6459,26,21008,0,548,29,6555,16,10985,29,17540,California
Amador,2021-04-26,99,28114,31,6490,67,21075,1,549,47,6554,51,11036,50,17590,California
Amador,2021-04-27,497,28611,41,6531,455,21530,1,550,88,6240,404,11440,90,17680,California
Amador,2021-04-28,71,28682,30,6561,38,21568,3,553,41,6254,30,11470,44,17724,California
Amador,2021-04-29,232,28914,75,6636,48,21616,109,662,69,6268,163,11633,177,17901,California
Amador,2021-04-30,343,29257,27,6663,312,21928,4,666,86,6102,257,11890,91,17992,California
Amador,2021-05-01,49,29306,16,6679,28,21956,5,671,27,6114,20,11910,32,18024,California
Amador,2021-05-02,28,29334,14,6693,11,21967,3,674,11,6112,17,11927,15,18039,California
Amador,2021-05-03,70,29404,36,6729,24,21991,10,684,29,6110,41,11968,39,18078,California
Amador,2021-05-04,469,29873,29,6758,433,22424,7,691,67,5783,402,12370,75,18153,California
Amador,2021-05-05,211,30084,157,6915,46,22470,8,699,163,5908,45,12415,170,18323,California
Amador,2021-05-06,107,30191,54,6969,48,22518,5,704,61,5930,44,12459,66,18389,California
Amador,2021-05-07,132,30323,30,6999,95,22613,7,711,69,5943,63,12522,76,18465,California
Amador,2021-05-08,42,30365,10,7009,29,22642,3,714,20,5944,22,12544,23,18488,California
Amador,2021-05-09,17,30382,1,7010,10,22652,6,720,4,5941,13,12557,10,18498,California
Amador,2021-05-10,58,30440,12,7022,43,22695,3,723,25,5936,33,12590,28,18526,California
Amador,2021-05-11,100,30540,32,7054,42,22737,26,749,45,5952,55,12645,71,18597,California
Amador,2021-05-12,71,30611,25,7079,43,22780,3,752,35,5954,36,12681,38,18635,California
Amador,2021-05-13,79,30690,41,7120,32,22812,6,758,38,5958,40,12721,44,18679,California
Amador,2021-05-14,404,31094,36,7156,363,23175,5,763,90,5742,313,13034,97,18776,California
Amador,2021-05-15,48,31142,19,7175,19,23194,10,773,22,5749,26,13060,33,18809,California
Amador,2021-05-16,40,31182,14,7189,26,23220,0,773,17,5743,23,13083,17,18826,California
Amador,2021-05-17,77,31259,24,7213,51,23271,2,775,36,5742,40,13123,39,18865,California
Amador,2021-05-18,251,31510,169,7382,47,23318,35,810,168,5864,81,13204,203,19068,California
Amador,2021-05-19,76,31586,26,7408,47,23365,3,813,34,5862,41,13245,39,19107,California
Amador,2021-05-20,90,31676,47,7455,39,23404,4,817,30,5838,59,13304,35,19142,California
Amador,2021-05-21,274,31950,32,7487,241,23645,1,818,38,5641,236,13540,39,19181,California
Amador,2021-05-22,44,31994,14,7501,26,23671,4,822,12,5626,32,13572,17,19198,California
Amador,2021-05-23,30,32024,6,7507,21,23692,3,825,5,5609,25,13597,8,19206,California
Amador,2021-05-24,93,32117,35,7542,46,23738,12,837,43,5614,50,13647,55,19261,California
Amador,2021-05-25,145,32262,91,7633,28,23766,26,863,84,5665,59,13706,110,19371,California
Amador,2021-05-26,204,32466,161,7794,36,23802,7,870,37,5542,166,13872,43,19414,California
Amador,2021-05-27,82,32548,38,7832,35,23837,9,879,30,5530,51,13923,39,19453,California
Amador,2021-05-28,70,32618,28,7860,38,23875,4,883,30,5525,39,13962,34,19487,California
Amador,2021-05-29,28,32646,2,7862,23,23898,3,886,9,5519,19,13981,13,19500,California
Amador,2021-05-30,19,32665,5,7867,8,23906,6,892,5,5516,14,13995,11,19511,California
Amador,2021-05-31,10,32675,0,7867,9,23915,1,893,2,5511,8,14003,3,19514,California
Amador,2021-06-01,95,32770,67,7934,23,23938,5,898,44,5510,50,14053,49,19563,California
Amador,2021-06-02,46,32816,16,7950,22,23960,8,906,16,5505,30,14083,25,19588,California
Amador,2021-06-03,58,32874,25,7975,28,23988,5,911,19,5491,38,14121,24,19612,California
Amador,2021-06-04,101,32975,20,7995,60,24048,21,932,20,5451,80,14201,40,19652,California
Amador,2021-06-05,41,33016,17,8012,19,24067,5,937,5,5425,36,14237,10,19662,California
Amador,2021-06-06,20,33036,9,8021,10,24077,1,938,9,5425,11,14248,11,19673,California
Amador,2021-06-07,46,33082,18,8039,23,24100,5,943,18,5420,28,14276,23,19696,California
Amador,2021-06-08,175,33257,139,8178,26,24126,10,953,53,5363,121,14397,64,19760,California
Amador,2021-06-09,48,33305,19,8197,20,24146,9,962,13,5350,35,14432,22,19782,California
Amador,2021-06-10,56,33361,23,8220,22,24168,11,973,20,5345,36,14468,31,19813,California
Amador,2021-06-11,59,33420,18,8238,36,24204,5,978,12,5315,47,14515,17,19830,California
Amador,2021-06-12,24,33444,11,8249,11,24215,2,980,9,5312,14,14529,11,19841,California
Amador,2021-06-13,9,33453,2,8251,6,24221,1,981,2,5308,7,14536,3,19844,California
Amador,2021-06-14,46,33499,23,8274,21,24242,2,983,14,5292,32,14568,16,19860,California
Amador,2021-06-15,45,33544,14,8288,19,24261,12,995,19,5298,25,14593,31,19891,California
Amador,2021-06-16,71,33615,31,8319,31,24292,9,1004,33,5302,38,14631,42,19933,California
Amador,2021-06-17,49,33664,25,8344,20,24312,4,1008,29,5316,19,14650,33,19966,California
Amador,2021-06-18,156,33820,119,8463,30,24342,7,1015,60,5288,96,14746,68,20034,California
Amador,2021-06-19,30,33850,8,8471,14,24356,8,1023,11,5289,19,14765,20,20054,California
Amador,2021-06-20,8,33858,6,8477,1,24357,1,1024,3,5288,5,14770,4,20058,California
Amador,2021-06-21,48,33906,15,8492,23,24380,10,1034,17,5283,31,14801,26,20084,California
Amador,2021-06-22,48,33954,27,8519,19,24399,2,1036,29,5295,19,14820,31,20115,California
Amador,2021-06-23,42,33996,22,8541,12,24411,8,1044,23,5307,19,14839,31,20146,California
Amador,2021-06-24,51,34047,27,8568,18,24429,6,1050,26,5316,23,14862,32,20178,California
Amador,2021-06-25,53,34100,32,8600,10,24439,11,1061,28,5332,24,14886,40,20218,California
Amador,2021-06-26,10,34110,4,8604,4,24443,2,1063,6,5336,4,14890,8,20226,California
Amador,2021-06-27,22,34132,14,8618,4,24447,4,1067,11,5340,11,14901,15,20241,California
Amador,2021-06-28,52,34184,28,8646,13,24460,11,1078,24,5347,28,14929,35,20276,California
Amador,2021-06-29,51,34235,24,8670,18,24478,9,1087,26,5357,25,14954,35,20311,California
Amador,2021-06-30,47,34282,17,8687,14,24492,16,1103,22,5369,25,14979,37,20348,California
Amador,2021-07-01,32,34314,16,8703,13,24505,3,1106,15,5370,17,14996,18,20366,California
Amador,2021-07-02,35,34349,16,8719,9,24514,10,1116,19,5383,16,15012,29,20395,California
Amador,2021-07-03,16,34365,1,8720,11,24525,4,1120,9,5389,7,15019,13,20408,California
Amador,2021-07-04,5,34370,0,8720,5,24530,0,1120,5,5394,0,15019,5,20413,California
Amador,2021-07-05,29,34399,6,8726,19,24549,4,1124,15,5399,14,15033,19,20432,California
Amador,2021-07-06,30,34429,13,8739,13,24562,4,1128,13,5399,17,15050,17,20449,California
Amador,2021-07-07,35,34464,13,8752,17,24579,5,1133,17,5403,18,15068,22,20471,California
Amador,2021-07-08,28,34492,11,8763,16,24595,1,1134,11,5399,17,15085,13,20484,California
Amador,2021-07-09,64,34556,45,8808,18,24613,1,1135,23,5384,41,15126,26,20510,California
Amador,2021-07-10,15,34571,6,8814,7,24620,2,1137,8,5387,7,15133,10,20520,California
Amador,2021-07-11,4,34575,2,8816,2,24622,0,1137,0,5384,4,15137,1,20521,California
Amador,2021-07-12,35,34610,17,8833,13,24635,5,1142,24,5402,11,15148,29,20550,California
Amador,2021-07-13,36,34646,16,8849,14,24649,6,1148,16,5404,20,15168,22,20572,California
Amador,2021-07-14,36,34682,18,8867,17,24666,1,1149,15,5399,21,15189,16,20588,California
Amador,2021-07-15,41,34723,25,8892,14,24680,2,1151,26,5412,15,15204,28,20616,California
Amador,2021-07-16,57,34780,30,8922,22,24702,5,1156,25,5410,32,15236,30,20646,California
Amador,2021-07-17,20,34800,7,8929,8,24710,5,1161,10,5416,10,15246,16,20662,California
Amador,2021-07-18,12,34812,9,8938,2,24712,1,1162,4,5414,8,15254,6,20668,California
Amador,2021-07-19,49,34861,27,8965,17,24729,5,1167,29,5430,20,15274,36,20704,California
Amador,2021-07-20,69,34930,36,9001,19,24748,14,1181,31,5438,38,15312,46,20750,California
Amador,2021-07-21,45,34975,18,9019,21,24769,6,1187,27,5454,17,15329,33,20783,California
Amador,2021-07-22,48,35023,20,9039,20,24789,8,1195,27,5469,21,15350,36,20819,California
Amador,2021-07-23,47,35070,25,9064,17,24806,5,1200,26,5479,21,15371,31,20850,California
Amador,2021-07-24,11,35081,0,9064,9,24815,2,1202,5,5480,6,15377,7,20857,California
Amador,2021-07-25,15,35096,3,9067,7,24822,5,1207,6,5482,9,15386,11,20868,California
Amador,2021-07-26,42,35138,17,9084,24,24846,1,1208,35,5512,7,15393,37,20905,California
Amador,2021-07-27,38,35176,17,9101,15,24861,6,1214,20,5520,18,15411,26,20931,California
Amador,2021-07-28,44,35220,21,9122,19,24880,4,1218,28,5536,16,15427,32,20963,California
Amador,2021-07-29,42,35262,22,9144,15,24895,5,1223,29,5557,13,15440,34,20997,California
Amador,2021-07-30,70,35332,36,9180,29,24924,5,1228,50,5593,20,15460,56,21053,California
Amador,2021-07-31,39,35371,16,9196,21,24945,2,1230,25,5606,14,15474,27,21080,California
Amador,2021-08-01,21,35392,10,9206,9,24954,2,1232,12,5611,9,15483,14,21094,California
Amador,2021-08-02,63,35455,28,9234,30,24984,5,1237,45,5643,18,15501,50,21144,California
Amador,2021-08-03,72,35527,40,9274,27,25011,5,1242,56,5689,15,15516,61,21205,California
Amador,2021-08-04,67,35594,46,9320,17,25028,4,1246,58,5742,9,15525,62,21267,California
Amador,2021-08-05,54,35648,29,9349,18,25046,7,1253,35,5765,19,15544,42,21309,California
Amador,2021-08-06,61,35709,28,9377,33,25079,0,1253,49,5802,12,15556,49,21358,California
Amador,2021-08-07,19,35728,8,9385,10,25089,1,1254,17,5818,2,15558,18,21376,California
Amador,2021-08-08,24,35752,8,9393,13,25102,3,1257,18,5833,6,15564,21,21397,California
Amador,2021-08-09,65,35817,37,9430,27,25129,1,1258,44,5859,20,15584,46,21443,California
Amador,2021-08-10,108,35925,67,9497,22,25151,19,1277,67,5905,39,15623,85,21528,California
Amador,2021-08-11,46,35971,21,9518,20,25171,5,1282,27,5918,19,15642,32,21560,California
Amador,2021-08-12,95,36066,49,9567,34,25205,12,1294,59,5954,35,15677,71,21631,California
Amador,2021-08-13,99,36165,46,9613,49,25254,4,1298,77,6014,21,15698,81,21712,California
Amador,2021-08-14,31,36196,12,9625,17,25271,2,1300,21,6027,10,15708,23,21735,California
Amador,2021-08-15,19,36215,2,9627,16,25287,1,1301,14,6037,5,15713,15,21750,California
Amador,2021-08-16,69,36284,29,9656,37,25324,3,1304,43,6058,25,15738,46,21796,California
Amador,2021-08-17,77,36361,46,9702,28,25352,3,1307,58,6101,18,15756,61,21857,California
Amador,2021-08-18,57,36418,24,9726,30,25382,3,1310,32,6112,24,15780,35,21892,California
Amador,2021-08-19,73,36491,36,9762,33,25415,4,1314,42,6130,28,15808,46,21938,California
Amador,2021-08-20,117,36608,72,9834,34,25449,11,1325,62,6157,46,15854,73,22011,California
Amador,2021-08-21,37,36645,14,9848,23,25472,0,1325,22,6166,13,15867,22,22033,California
Amador,2021-08-22,35,36680,19,9867,12,25484,4,1329,17,6176,16,15883,26,22059,California
Amador,2021-08-23,81,36761,43,9910,37,25521,1,1330,44,6196,33,15916,53,22112,California
Amador,2021-08-24,76,36837,52,9962,16,25537,8,1338,39,6215,32,15948,51,22163,California
Amador,2021-08-25,72,36909,41,10003,23,25560,8,1346,35,6233,32,15980,50,22213,California
Amador,2021-08-26,90,36999,45,10048,32,25592,13,1359,48,6259,37,16017,63,22276,California
Amador,2021-08-27,108,37107,71,10119,32,25624,5,1364,67,6301,36,16053,78,22354,California
Amador,2021-08-28,35,37142,15,10134,18,25642,2,1366,17,6306,16,16069,21,22375,California
Amador,2021-08-29,20,37162,11,10145,9,25651,0,1366,10,6308,8,16077,10,22385,California
Amador,2021-08-30,22,37184,11,10156,11,25662,0,1366,8,6302,14,16091,8,22393,California
Butte,2020-12-16,4,4,4,4,0,0,0,0,4,4,0,0,4,4,California
Butte,2020-12-17,20,24,20,24,0,0,0,0,20,24,0,0,20,24,California
Butte,2020-12-18,52,76,52,76,0,0,0,0,52,76,0,0,52,76,California
Butte,2020-12-19,7,83,7,83,0,0,0,0,7,83,0,0,7,83,California
Butte,2020-12-20,9,92,9,92,0,0,0,0,9,92,0,0,9,92,California
Butte,2020-12-21,627,719,627,719,0,0,0,0,627,719,0,0,627,719,California
Butte,2020-12-22,616,1335,614,1333,2,2,0,0,616,1335,0,0,616,1335,California
Butte,2020-12-23,872,2207,856,2189,16,18,0,0,872,2207,0,0,872,2207,California
Butte,2020-12-24,157,2364,153,2342,4,22,0,0,157,2364,0,0,157,2364,California
Butte,2020-12-26,89,2453,87,2429,2,24,0,0,89,2453,0,0,89,2453,California
Butte,2020-12-27,35,2488,34,2463,1,25,0,0,35,2488,0,0,35,2488,California
Butte,2020-12-28,278,2766,272,2735,6,31,0,0,278,2766,0,0,278,2766,California
Butte,2020-12-29,206,2972,180,2915,26,57,0,0,206,2972,0,0,206,2972,California
Butte,2020-12-30,512,3484,292,3207,220,277,0,0,512,3484,0,0,512,3484,California
Butte,2020-12-31,215,3699,18,3225,197,474,0,0,215,3699,0,0,215,3699,California
Butte,2021-01-01,21,3720,9,3234,12,486,0,0,21,3720,0,0,21,3720,California
Butte,2021-01-02,40,3760,37,3271,3,489,0,0,40,3760,0,0,40,3760,California
Butte,2021-01-03,3,3763,1,3272,2,491,0,0,3,3763,0,0,3,3763,California
Butte,2021-01-04,210,3973,176,3448,34,525,0,0,210,3973,0,0,210,3973,California
Butte,2021-01-05,194,4167,150,3598,44,569,0,0,193,4165,1,1,193,4166,California
Butte,2021-01-06,632,4799,398,3996,234,803,0,0,626,4786,6,7,627,4793,California
Butte,2021-01-07,764,5563,368,4364,396,1199,0,0,745,5512,19,26,745,5538,California
Butte,2021-01-08,671,6234,529,4893,142,1341,0,0,622,6085,49,75,622,6160,California
Butte,2021-01-09,13,6247,8,4901,5,1346,0,0,7,6086,6,81,7,6167,California
Butte,2021-01-10,18,6265,4,4905,14,1360,0,0,14,6096,4,85,14,6181,California
Butte,2021-01-11,984,7249,948,5853,36,1396,0,0,357,5829,627,712,360,6541,California
Butte,2021-01-12,698,7947,652,6505,46,1442,0,0,276,5684,422,1134,277,6818,California
Butte,2021-01-13,1559,9506,1065,7570,494,1936,0,0,725,5578,833,1967,727,7545,California
Butte,2021-01-14,1640,11146,894,8464,746,2682,0,0,1442,6824,196,2163,1442,8987,California
Butte,2021-01-15,1062,12208,817,9281,245,2927,0,0,952,7666,110,2273,952,9939,California
Butte,2021-01-16,593,12801,304,9585,289,3216,0,0,548,8169,45,2318,548,10487,California
Butte,2021-01-17,238,13039,63,9648,175,3391,0,0,201,8333,37,2355,201,10688,California
Butte,2021-01-18,349,13388,307,9955,42,3433,0,0,282,8549,66,2421,282,10970,California
Butte,2021-01-19,498,13886,432,10387,66,3499,0,0,227,8505,271,2692,227,11197,California
Butte,2021-01-20,1402,15288,712,11099,690,4189,0,0,1096,9295,306,2998,1096,12293,California
Butte,2021-01-21,1500,16788,888,11987,612,4801,0,0,1391,10578,108,3106,1391,13684,California
Butte,2021-01-22,1148,17936,486,12473,662,5463,0,0,1092,11614,56,3162,1092,14776,California
Butte,2021-01-23,125,18061,85,12558,40,5503,0,0,100,11689,25,3187,100,14876,California
Butte,2021-01-24,7,18068,6,12564,1,5504,0,0,7,11696,0,3187,7,14883,California
Butte,2021-01-25,660,18728,338,12902,322,5826,0,0,496,12028,164,3351,496,15379,California
Butte,2021-01-26,1494,20222,377,13279,1117,6943,0,0,1357,13248,137,3488,1357,16736,California
Butte,2021-01-27,2123,22345,708,13987,1415,8358,0,0,1385,13896,737,4225,1385,18121,California
Butte,2021-01-28,2285,24630,258,14245,2027,10385,0,0,1959,15530,325,4550,1959,20080,California
Butte,2021-01-29,1699,26329,493,14738,1206,11591,0,0,1316,16465,381,4931,1316,21396,California
Butte,2021-01-30,29,26358,8,14746,21,11612,0,0,27,16490,2,4933,27,21423,California
Butte,2021-01-31,18,26376,15,14761,3,11615,0,0,17,16506,1,4934,17,21440,California
Butte,2021-02-01,1782,28158,409,15170,1373,12988,0,0,1381,17489,398,5332,1381,22821,California
Butte,2021-02-02,1961,30119,367,15537,1594,14582,0,0,1654,18835,308,5640,1654,24475,California
Butte,2021-02-03,2763,32882,780,16317,1983,16565,0,0,1858,19790,903,6543,1858,26333,California
Butte,2021-02-04,2985,35867,322,16639,2663,19228,0,0,2420,21646,564,7107,2420,28753,California
Butte,2021-02-05,1285,37152,671,17310,614,19842,0,0,554,21470,731,7838,555,29308,California
Butte,2021-02-06,147,37299,104,17414,43,19885,0,0,61,21445,86,7924,61,29369,California
Butte,2021-02-07,40,37339,35,17449,5,19890,0,0,16,21438,23,7947,16,29385,California
Butte,2021-02-08,702,38041,549,17998,153,20043,0,0,238,21214,462,8409,238,29623,California
Butte,2021-02-09,971,39012,464,18462,507,20550,0,0,735,21714,235,8644,735,30358,California
Butte,2021-02-10,1710,40722,1191,19653,519,21069,0,0,653,21314,1054,9698,654,31012,California
Butte,2021-02-11,2231,42953,1364,21017,867,21936,0,0,1008,21100,1223,10921,1009,32021,California
Butte,2021-02-12,1008,43961,438,21455,570,22506,0,0,325,20744,681,11602,325,32346,California
Butte,2021-02-13,257,44218,45,21500,212,22718,0,0,153,20794,103,11705,153,32499,California
Butte,2021-02-14,164,44382,9,21509,155,22873,0,0,158,20947,6,11711,159,32658,California
Butte,2021-02-15,260,44642,48,21557,212,23085,0,0,193,21073,67,11778,193,32851,California
Butte,2021-02-16,765,45407,438,21995,327,23412,0,0,301,20910,464,12242,301,33152,California
Butte,2021-02-17,1540,46947,857,22852,683,24095,0,0,851,21075,686,12928,851,34003,California
Butte,2021-02-18,1591,48538,776,23628,815,24910,0,0,772,21028,819,13747,772,34775,California
Butte,2021-02-19,1182,49720,394,24022,788,25698,0,0,400,20654,774,14521,400,35175,California
Butte,2021-02-20,488,50208,36,24058,452,26150,0,0,129,20425,358,14879,129,35304,California
Butte,2021-02-21,22,50230,19,24077,3,26153,0,0,16,20435,6,14885,16,35320,California
Butte,2021-02-22,1573,51803,316,24393,1257,27410,0,0,393,19654,1175,16060,394,35714,California
Butte,2021-02-23,1698,53501,311,24704,1387,28797,0,0,468,18900,1222,17282,468,36182,California
Butte,2021-02-24,2231,55732,641,25345,1590,30387,0,0,770,18218,1453,18735,771,36953,California
Butte,2021-02-25,2190,57922,654,25999,1536,31923,0,0,719,17478,1460,20195,720,37673,California
Butte,2021-02-26,979,58901,334,26333,645,32568,0,0,426,17357,547,20742,426,38099,California
Butte,2021-02-27,248,59149,49,26382,199,32767,0,0,196,17503,50,20792,196,38295,California
Butte,2021-02-28,156,59305,16,26398,140,32907,0,0,145,17640,8,20800,145,38440,California
Butte,2021-03-01,1715,61020,206,26604,1503,34410,6,6,361,16663,1344,22144,367,38807,California
Butte,2021-03-02,1819,62839,210,26814,1609,36019,0,6,317,15484,1497,23641,318,39125,California
Butte,2021-03-03,2904,65743,902,27716,2002,38021,0,6,513,13613,2384,26025,513,39638,California
Butte,2021-03-04,3265,69008,726,28442,2539,40560,0,6,643,11639,2617,28642,643,40281,California
Butte,2021-03-05,1388,70396,634,29076,753,41313,1,7,751,11757,634,29276,752,41033,California
Butte,2021-03-06,255,70651,25,29101,206,41519,24,31,191,11912,60,29336,215,41248,California
Butte,2021-03-07,73,70724,4,29105,46,41565,23,54,43,11948,30,29366,66,41314,California
Butte,2021-03-08,1280,72004,134,29239,1066,42631,80,134,1110,12970,167,29533,1189,42503,California
Butte,2021-03-09,1948,73952,287,29526,1557,44188,104,238,1421,13976,519,30052,1525,44028,California
Butte,2021-03-10,2350,76302,987,30513,1261,45449,102,340,1595,14923,749,30801,1696,45724,California
Butte,2021-03-11,2819,79121,1321,31834,1371,46820,127,467,1971,16186,836,31637,2099,47823,California
Butte,2021-03-12,1161,80282,329,32163,469,47289,363,830,354,16102,800,32437,716,48539,California
Butte,2021-03-13,272,80554,68,32231,141,47430,63,893,58,16009,213,32650,120,48659,California
Butte,2021-03-14,168,80722,17,32248,108,47538,43,936,20,15926,146,32796,63,48722,California
Butte,2021-03-15,1749,82471,360,32608,1092,48630,297,1233,1145,16771,596,33392,1441,50163,California
Butte,2021-03-16,1682,84153,427,33035,1177,49807,78,1311,1093,17357,584,33976,1170,51333,California
Butte,2021-03-17,1966,86119,1360,34395,525,50332,81,1392,1108,17695,850,34826,1188,52521,California
Butte,2021-03-18,1827,87946,1479,35874,220,50552,128,1520,1009,18020,811,35637,1136,53657,California
Butte,2021-03-19,698,88644,312,36186,302,50854,84,1604,336,18087,351,35988,418,54075,California
Butte,2021-03-20,213,88857,32,36218,165,51019,16,1620,102,18094,111,36099,118,54193,California
Butte,2021-03-21,74,88931,41,36259,4,51023,29,1649,23,18098,48,36147,52,54245,California
Butte,2021-03-22,1522,90453,383,36642,1044,52067,95,1744,1246,19162,275,36422,1339,55584,California
Butte,2021-03-23,1866,92319,523,37165,1230,53297,113,1857,1504,20421,357,36779,1616,57200,California
Butte,2021-03-24,2285,94604,1280,38445,880,54177,125,1982,1700,21665,580,37359,1824,59024,California
Butte,2021-03-25,1505,96109,1214,39659,199,54376,92,2074,1017,22290,482,37841,1107,60131,California
Butte,2021-03-26,1216,97325,438,40097,528,54904,250,2324,555,22441,653,38494,804,60935,California
Butte,2021-03-27,316,97641,86,40183,204,55108,26,2350,137,22427,175,38669,161,61096,California
Butte,2021-03-28,236,97877,47,40230,182,55290,7,2357,100,22401,132,38801,106,61202,California
Butte,2021-03-29,1784,99661,385,40615,1328,56618,71,2428,1341,23380,433,39234,1412,62614,California
Butte,2021-03-30,1045,100706,477,41092,477,57095,91,2519,486,23405,551,39785,576,63190,California
Butte,2021-03-31,1796,102502,1308,42400,419,57514,69,2588,1072,23834,712,40497,1141,64331,California
Butte,2021-04-01,3375,105877,2730,45130,515,58029,130,2718,2271,25150,1084,41581,2400,66731,California
Butte,2021-04-02,1015,106892,422,45552,472,58501,121,2839,566,25398,438,42019,686,67417,California
Butte,2021-04-03,343,107235,46,45598,224,58725,73,2912,166,25459,177,42196,238,67655,California
Butte,2021-04-04,207,107442,33,45631,149,58874,25,2937,119,25517,85,42281,143,67798,California
Butte,2021-04-05,1973,109415,422,46053,1383,60257,168,3105,591,24901,1373,43654,757,68555,California
Butte,2021-04-06,2208,111623,617,46670,1173,61430,418,3523,796,24709,1403,45057,1211,69766,California
Butte,2021-04-07,3054,114677,1324,47994,1333,62763,397,3920,722,23495,2326,47383,1112,70878,California
Butte,2021-04-08,2774,117451,1204,49198,1298,64061,272,4192,454,21906,2314,49697,725,71603,California
Butte,2021-04-09,1380,118831,355,49553,543,64604,482,4674,329,21667,1046,50743,807,72410,California
Butte,2021-04-10,237,119068,50,49603,76,64680,111,4785,101,21743,135,50878,211,72621,California
Butte,2021-04-11,107,119175,44,49647,53,64733,10,4795,83,21813,23,50901,93,72714,California
Butte,2021-04-12,1422,120597,316,49963,973,65706,133,4928,238,21000,1183,52084,370,73084,California
Butte,2021-04-13,1659,122256,573,50536,1080,66786,6,4934,346,20048,1304,53388,352,73436,California
Butte,2021-04-14,2866,125122,2363,52899,503,67289,0,4934,1312,19813,1548,54936,1313,74749,California
Butte,2021-04-15,635,125757,387,53286,248,67537,0,4934,471,20126,158,55094,471,75220,California
Butte,2021-04-16,822,126579,423,53709,399,67936,0,4934,484,20277,333,55427,484,75704,California
Butte,2021-04-17,349,126928,63,53772,286,68222,0,4934,241,20412,106,55533,241,75945,California
Butte,2021-04-18,57,126985,22,53794,35,68257,0,4934,42,20439,15,55548,42,75987,California
Butte,2021-04-19,1584,128569,391,54185,1193,69450,0,4934,423,19708,1155,56703,424,76411,California
Butte,2021-04-20,2045,130614,773,54958,1272,70722,0,4934,757,19188,1277,57980,757,77168,California
Butte,2021-04-21,2125,132739,1239,56197,886,71608,0,4934,487,18047,1628,59608,487,77655,California
Butte,2021-04-22,2289,135028,2001,58198,288,71896,0,4934,635,17035,1647,61255,635,78290,California
Butte,2021-04-23,974,136002,474,58672,500,72396,0,4934,489,17040,484,61739,489,78779,California
Butte,2021-04-24,352,136354,141,58813,211,72607,0,4934,190,17068,162,61901,190,78969,California
Butte,2021-04-25,180,136534,73,58886,107,72714,0,4934,60,17009,119,62020,60,79029,California
Butte,2021-04-26,1590,138124,475,59361,1109,73823,6,4940,402,16235,1182,63202,408,79437,California
Butte,2021-04-27,1036,139160,693,60054,316,74139,27,4967,587,16404,445,63647,614,80051,California
Butte,2021-04-28,1453,140613,989,61043,439,74578,25,4992,517,16017,929,64576,542,80593,California
Butte,2021-04-29,938,141551,585,61628,327,74905,26,5018,316,15747,612,65188,342,80935,California
Butte,2021-04-30,944,142495,429,62057,495,75400,20,5038,473,15777,461,65649,491,81426,California
Butte,2021-05-01,264,142759,69,62126,171,75571,24,5062,78,15702,173,65822,98,81524,California
Butte,2021-05-02,162,142921,68,62194,80,75651,14,5076,48,15650,113,65935,61,81585,California
Butte,2021-05-03,641,143562,263,62457,347,75998,31,5107,179,15409,451,66386,210,81795,California
Butte,2021-05-04,861,144423,351,62808,478,76476,32,5139,226,15041,624,67010,256,82051,California
Butte,2021-05-05,1392,145815,1134,63942,219,76695,39,5178,292,14280,1092,68102,331,82382,California
Butte,2021-05-06,995,146810,728,64670,227,76922,40,5218,372,14072,618,68720,410,82792,California
Butte,2021-05-07,597,147407,317,64987,244,77166,36,5254,308,14129,285,69005,342,83134,California
Butte,2021-05-08,189,147596,52,65039,126,77292,11,5265,93,14138,95,69100,104,83238,California
Butte,2021-05-09,103,147699,27,65066,73,77365,3,5268,54,14146,49,69149,57,83295,California
Butte,2021-05-10,544,148243,320,65386,178,77543,46,5314,219,14090,321,69470,265,83560,California
Butte,2021-05-11,932,149175,676,66062,195,77738,61,5375,297,13817,630,70100,357,83917,California
Butte,2021-05-12,793,149968,489,66551,255,77993,49,5424,336,13749,453,70553,385,84302,California
Butte,2021-05-13,962,150930,638,67189,258,78251,66,5490,350,13561,602,71155,414,84716,California
Butte,2021-05-14,868,151798,542,67731,293,78544,33,5523,377,13482,488,71643,409,85125,California
Butte,2021-05-15,515,152313,248,67979,233,78777,34,5557,241,13485,272,71915,275,85400,California
Butte,2021-05-16,170,152483,83,68062,69,78846,18,5575,99,13533,69,71984,117,85517,California
Butte,2021-05-17,772,153255,500,68562,224,79070,48,5623,332,13477,435,72419,379,85896,California
Butte,2021-05-18,1071,154326,736,69298,287,79357,48,5671,475,13410,590,73009,523,86419,California
Butte,2021-05-19,845,155171,549,69847,247,79604,49,5720,331,13281,508,73517,379,86798,California
Butte,2021-05-20,996,156167,672,70519,215,79819,109,5829,389,13176,602,74119,497,87295,California
Butte,2021-05-21,898,157065,546,71065,324,80143,28,5857,298,12904,596,74715,324,87619,California
Butte,2021-05-22,299,157364,139,71204,145,80288,15,5872,144,12911,152,74867,159,87778,California
Butte,2021-05-23,132,157496,83,71287,48,80336,1,5873,79,12938,53,74920,80,87858,California
Butte,2021-05-24,353,157849,164,71451,139,80475,50,5923,177,12990,175,75095,227,88085,California
Butte,2021-05-25,710,158559,455,71906,217,80692,38,5961,347,13021,352,75447,383,88468,California
Butte,2021-05-26,566,159125,183,72089,360,81052,23,5984,244,12973,314,75761,266,88734,California
Butte,2021-05-27,874,159999,629,72718,227,81279,18,6002,425,12974,443,76204,444,89178,California
Butte,2021-05-28,530,160529,149,72867,300,81579,81,6083,216,12960,311,76515,297,89475,California
Butte,2021-05-29,227,160756,117,72984,97,81676,13,6096,145,13036,82,76597,158,89633,California
Butte,2021-05-30,107,160863,57,73041,50,81726,0,6096,59,13047,48,76645,59,89692,California
Butte,2021-05-31,46,160909,24,73065,20,81746,2,6098,26,13056,19,76664,28,89720,California
Butte,2021-06-01,700,161609,441,73506,220,81966,39,6137,258,12919,431,77095,294,90014,California
Butte,2021-06-02,832,162441,576,74082,211,82177,45,6182,358,12852,469,77564,402,90416,California
Butte,2021-06-03,630,163071,425,74507,188,82365,17,6199,206,12654,421,77985,223,90639,California
Butte,2021-06-04,495,163566,284,74791,182,82547,29,6228,144,12485,342,78327,173,90812,California
Butte,2021-06-05,322,163888,208,74999,95,82642,19,6247,96,12376,224,78551,115,90927,California
Butte,2021-06-06,137,164025,101,75100,34,82676,2,6249,34,12310,102,78653,36,90963,California
Butte,2021-06-07,408,164433,259,75359,117,82793,32,6281,171,12276,235,78888,201,91164,California
Butte,2021-06-08,651,165084,468,75827,163,82956,20,6301,178,12014,460,79348,198,91362,California
Butte,2021-06-09,439,165523,301,76128,120,83076,18,6319,149,11898,283,79631,167,91529,California
Butte,2021-06-10,634,166157,452,76580,150,83226,32,6351,234,11765,398,80029,265,91794,California
Butte,2021-06-11,450,166607,268,76848,161,83387,21,6372,152,11641,297,80326,173,91967,California
Butte,2021-06-12,253,166860,152,77000,91,83478,10,6382,78,11555,174,80500,88,92055,California
Butte,2021-06-13,99,166959,65,77065,31,83509,3,6385,20,11499,79,80579,23,92078,California
Butte,2021-06-14,402,167361,242,77307,140,83649,20,6405,144,11407,257,80836,165,92243,California
Butte,2021-06-15,554,167915,389,77696,139,83788,26,6431,164,11213,384,81220,190,92433,California
Butte,2021-06-16,425,168340,261,77957,119,83907,45,6476,175,11185,248,81468,220,92653,California
Butte,2021-06-17,581,168921,432,78389,122,84029,27,6503,177,10987,403,81871,205,92858,California
Butte,2021-06-18,411,169332,204,78593,153,84182,54,6557,160,10949,249,82120,211,93069,California
Butte,2021-06-19,209,169541,155,78748,49,84231,5,6562,93,10931,116,82236,98,93167,California
Butte,2021-06-20,95,169636,70,78818,25,84256,0,6562,24,10886,70,82306,25,93192,California
Butte,2021-06-21,278,169914,166,78984,91,84347,21,6583,131,10894,144,82450,152,93344,California
Butte,2021-06-22,417,170331,276,79260,117,84464,24,6607,148,10802,264,82714,172,93516,California
Butte,2021-06-23,452,170783,335,79595,93,84557,24,6631,166,10706,285,82999,189,93705,California
Butte,2021-06-24,428,171211,285,79880,109,84666,34,6665,152,10617,275,83274,186,93891,California
Butte,2021-06-25,424,171635,206,80086,195,84861,23,6688,161,10539,262,83536,184,94075,California
Butte,2021-06-26,137,171772,100,80186,34,84895,3,6691,59,10523,78,83614,62,94137,California
Butte,2021-06-27,67,171839,41,80227,25,84920,1,6692,20,10498,47,83661,22,94159,California
Butte,2021-06-28,300,172139,225,80452,54,84974,21,6713,122,10464,176,83837,142,94301,California
Butte,2021-06-29,328,172467,220,80672,95,85069,13,6726,144,10440,180,84017,156,94457,California
Butte,2021-06-30,328,172795,215,80887,97,85166,16,6742,160,10450,166,84183,176,94633,California
Butte,2021-07-01,360,173155,230,81117,109,85275,21,6763,144,10400,214,84397,164,94797,California
Butte,2021-07-02,300,173455,205,81322,69,85344,26,6789,139,10407,158,84555,165,94962,California
Butte,2021-07-03,124,173579,84,81406,38,85382,2,6791,53,10392,70,84625,55,95017,California
Butte,2021-07-04,3,173582,2,81408,1,85383,0,6791,0,10390,2,84627,0,95017,California
Butte,2021-07-05,150,173732,99,81507,41,85424,10,6801,64,10382,82,84709,74,95091,California
Butte,2021-07-06,340,174072,251,81758,75,85499,14,6815,119,10297,219,84928,134,95225,California
Butte,2021-07-07,324,174396,239,81997,77,85576,8,6823,124,10232,197,85125,132,95357,California
Butte,2021-07-08,302,174698,195,82192,97,85673,10,6833,114,10170,186,85311,124,95481,California
Butte,2021-07-09,267,174965,162,82354,83,85756,22,6855,101,10128,165,85476,123,95604,California
Butte,2021-07-10,147,175112,102,82456,43,85799,2,6857,51,10084,96,85572,52,95656,California
Butte,2021-07-11,52,175164,37,82493,9,85808,6,6863,28,10095,23,85595,34,95690,California
Butte,2021-07-12,201,175365,126,82619,63,85871,12,6875,93,10093,107,85702,105,95795,California
Butte,2021-07-13,319,175684,238,82857,72,85943,9,6884,148,10082,168,85870,157,95952,California
Butte,2021-07-14,353,176037,265,83122,73,86016,15,6899,147,10042,202,86072,162,96114,California
Butte,2021-07-15,403,176440,284,83406,63,86079,56,6955,208,10112,194,86266,264,96378,California
Butte,2021-07-16,317,176757,198,83604,90,86169,29,6984,131,10086,186,86452,160,96538,California
Butte,2021-07-17,135,176892,92,83696,42,86211,1,6985,75,10103,59,86511,76,96614,California
Butte,2021-07-18,59,176951,36,83732,18,86229,5,6990,31,10111,28,86539,36,96650,California
Butte,2021-07-19,276,177227,202,83934,61,86290,13,7003,111,10070,165,86704,124,96774,California
Butte,2021-07-20,444,177671,329,84263,93,86383,22,7025,195,10038,249,86953,217,96991,California
Butte,2021-07-21,399,178070,299,84562,82,86465,18,7043,230,10120,165,87118,247,97238,California
Butte,2021-07-22,297,178367,190,84752,89,86554,18,7061,170,10185,123,87241,188,97426,California
Butte,2021-07-23,357,178724,215,84967,115,86669,27,7088,199,10257,154,87395,226,97652,California
Butte,2021-07-24,142,178866,109,85076,30,86699,3,7091,81,10281,60,87455,84,97736,California
Butte,2021-07-25,76,178942,45,85121,24,86723,7,7098,53,10322,19,87474,60,97796,California
Butte,2021-07-26,250,179192,154,85275,88,86811,8,7106,162,10407,86,87560,171,97967,California
Butte,2021-07-27,363,179555,277,85552,77,86888,9,7115,220,10494,142,87702,229,98196,California
Butte,2021-07-28,434,179989,318,85870,97,86985,19,7134,257,10596,174,87876,276,98472,California
Butte,2021-07-29,355,180344,208,86078,108,87093,39,7173,213,10711,138,88014,253,98725,California
Butte,2021-07-30,352,180696,206,86284,117,87210,29,7202,220,10833,128,88142,250,98975,California
Butte,2021-07-31,199,180895,128,86412,64,87274,7,7209,129,10900,68,88210,135,99110,California
Butte,2021-08-01,103,180998,74,86486,29,87303,0,7209,82,10961,21,88231,82,99192,California
Butte,2021-08-02,286,181284,183,86669,89,87392,14,7223,196,11084,87,88318,210,99402,California
Butte,2021-08-03,365,181649,255,86924,89,87481,21,7244,211,11166,150,88468,232,99634,California
Butte,2021-08-04,506,182155,406,87330,81,87562,19,7263,327,11339,173,88641,346,99980,California
Butte,2021-08-05,501,182656,377,87707,92,87654,32,7295,306,11484,193,88834,338,100318,California
Butte,2021-08-06,395,183051,261,87968,105,87759,29,7324,239,11596,155,88989,267,100585,California
Butte,2021-08-07,171,183222,112,88080,53,87812,6,7330,118,11668,52,89041,124,100709,California
Butte,2021-08-08,105,183327,74,88154,30,87842,1,7331,74,11712,31,89072,75,100784,California
Butte,2021-08-09,308,183635,199,88353,97,87939,12,7343,191,11801,114,89186,203,100987,California
Butte,2021-08-10,328,183963,222,88575,77,88016,29,7372,186,11876,140,89326,215,101202,California
Butte,2021-08-11,610,184573,476,89051,90,88106,44,7416,340,11995,265,89591,384,101586,California
Butte,2021-08-12,375,184948,227,89278,110,88216,38,7454,206,12075,164,89755,244,101830,California
Butte,2021-08-13,456,185404,262,89540,162,88378,32,7486,255,12165,196,89951,286,102116,California
Butte,2021-08-14,205,185609,145,89685,58,88436,2,7488,109,12185,91,90042,111,102227,California
Butte,2021-08-15,155,185764,105,89790,47,88483,3,7491,93,12235,46,90088,96,102323,California
Butte,2021-08-16,335,186099,199,89989,121,88604,15,7506,166,12271,145,90233,181,102504,California
Butte,2021-08-17,408,186507,240,90229,134,88738,34,7540,180,12296,189,90422,214,102718,California
Butte,2021-08-18,583,187090,411,90640,137,88875,35,7575,291,12355,267,90689,326,103044,California
Butte,2021-08-19,419,187509,249,90889,136,89011,34,7609,206,12416,179,90868,240,103284,California
Butte,2021-08-20,570,188079,350,91239,187,89198,33,7642,287,12501,235,91103,320,103604,California
Butte,2021-08-21,237,188316,173,91412,62,89260,2,7644,131,12540,94,91197,133,103737,California
Butte,2021-08-22,166,188482,113,91525,51,89311,2,7646,98,12578,62,91259,100,103837,California
Butte,2021-08-23,518,189000,350,91875,143,89454,25,7671,269,12668,205,91464,295,104132,California
Butte,2021-08-24,414,189414,268,92143,134,89588,12,7683,212,12740,152,91616,224,104356,California
Butte,2021-08-25,676,190090,508,92651,141,89729,27,7710,300,12763,304,91920,327,104683,California
Butte,2021-08-26,568,190658,441,93092,106,89835,21,7731,246,12749,281,92201,267,104950,California
Butte,2021-08-27,700,191358,480,93572,179,90014,41,7772,310,12810,290,92491,351,105301,California
Butte,2021-08-28,282,191640,209,93781,69,90083,4,7776,131,12821,124,92615,135,105436,California
Butte,2021-08-29,199,191839,144,93925,54,90137,1,7777,100,12837,85,92700,101,105537,California
Butte,2021-08-30,276,192115,145,94070,104,90241,27,7804,99,12837,126,92826,126,105663,California
Calaveras,2020-12-16,10,10,10,10,0,0,0,0,10,10,0,0,10,10,California
Calaveras,2020-12-17,6,16,6,16,0,0,0,0,6,16,0,0,6,16,California
Calaveras,2020-12-18,40,56,40,56,0,0,0,0,40,56,0,0,40,56,California
Calaveras,2020-12-19,4,60,4,60,0,0,0,0,4,60,0,0,4,60,California
Calaveras,2020-12-20,4,64,4,64,0,0,0,0,4,64,0,0,4,64,California
Calaveras,2020-12-21,54,118,48,112,6,6,0,0,54,118,0,0,54,118,California
Calaveras,2020-12-22,87,205,83,195,4,10,0,0,88,206,0,0,88,206,California
Calaveras,2020-12-23,74,279,72,267,2,12,0,0,74,280,0,0,74,280,California
Calaveras,2020-12-24,2,281,2,269,0,12,0,0,2,282,0,0,2,282,California
Calaveras,2020-12-26,4,285,3,272,1,13,0,0,4,286,0,0,4,286,California
Calaveras,2020-12-27,1,286,1,273,0,13,0,0,1,287,0,0,1,287,California
Calaveras,2020-12-28,24,310,18,291,6,19,0,0,23,309,1,1,23,310,California
Calaveras,2020-12-29,160,470,138,429,22,41,0,0,160,469,0,1,160,470,California
Calaveras,2020-12-30,99,569,86,515,13,54,0,0,99,568,0,1,99,569,California
Calaveras,2020-12-31,38,607,27,542,11,65,0,0,38,606,0,1,38,607,California
Calaveras,2021-01-02,12,619,12,554,0,65,0,0,12,618,0,1,12,619,California
Calaveras,2021-01-03,10,629,4,558,6,71,0,0,10,628,0,1,10,629,California
Calaveras,2021-01-04,33,662,6,564,27,98,0,0,33,661,0,1,33,662,California
Calaveras,2021-01-05,44,706,12,576,32,130,0,0,34,689,10,11,38,700,California
Calaveras,2021-01-06,108,814,31,607,77,207,0,0,98,777,10,21,98,798,California
Calaveras,2021-01-07,113,927,31,638,82,289,0,0,96,859,15,36,97,895,California
Calaveras,2021-01-08,76,1003,46,684,30,319,0,0,46,877,30,66,48,943,California
Calaveras,2021-01-09,5,1008,5,689,0,319,0,0,2,876,3,69,2,945,California
Calaveras,2021-01-10,2,1010,0,689,2,321,0,0,2,878,0,69,2,947,California
Calaveras,2021-01-11,70,1080,63,752,7,328,0,0,30,871,39,108,32,979,California
Calaveras,2021-01-12,88,1168,56,808,32,360,0,0,52,888,36,144,53,1032,California
Calaveras,2021-01-13,109,1277,45,853,64,424,0,0,75,931,33,177,76,1108,California
Calaveras,2021-01-14,145,1422,45,898,100,524,0,0,112,1012,32,209,113,1221,California
Calaveras,2021-01-15,94,1516,28,926,66,590,0,0,74,1066,20,229,74,1295,California
Calaveras,2021-01-16,16,1532,2,928,14,604,0,0,15,1080,1,230,15,1310,California
Calaveras,2021-01-17,10,1542,2,930,8,612,0,0,9,1088,1,231,9,1319,California
Calaveras,2021-01-18,140,1682,20,950,120,732,0,0,124,1201,16,247,129,1448,California
Calaveras,2021-01-19,212,1894,180,1130,32,764,0,0,73,1138,138,385,75,1523,California
Calaveras,2021-01-20,388,2282,87,1217,301,1065,0,0,289,1348,98,483,308,1831,California
Calaveras,2021-01-21,473,2755,45,1262,428,1493,0,0,422,1743,51,534,446,2277,California
Calaveras,2021-01-22,412,3167,25,1287,387,1880,0,0,392,2130,20,554,407,2684,California
Calaveras,2021-01-23,21,3188,11,1298,10,1890,0,0,19,2147,2,556,19,2703,California
Calaveras,2021-01-24,14,3202,8,1306,6,1896,0,0,12,2157,2,558,12,2715,California
Calaveras,2021-01-25,92,3294,9,1315,83,1979,0,0,84,2233,8,566,84,2799,California
Calaveras,2021-01-26,51,3345,16,1331,35,2014,0,0,41,2264,10,576,41,2840,California
Calaveras,2021-01-27,143,3488,50,1381,93,2107,0,0,111,2344,31,607,111,2951,California
Calaveras,2021-01-28,166,3654,26,1407,140,2247,0,0,134,2455,32,639,143,3094,California
Calaveras,2021-01-29,406,4060,16,1423,390,2637,0,0,361,2795,45,684,385,3479,California
Calaveras,2021-01-30,27,4087,10,1433,17,2654,0,0,25,2820,0,684,25,3504,California
Calaveras,2021-01-31,7,4094,4,1437,3,2657,0,0,6,2825,1,685,6,3510,California
Calaveras,2021-02-01,35,4129,13,1450,22,2679,0,0,25,2840,10,695,25,3535,California
Calaveras,2021-02-02,113,4242,25,1475,88,2767,0,0,74,2880,35,730,75,3610,California
Calaveras,2021-02-03,446,4688,45,1520,401,3168,0,0,361,3160,83,813,363,3973,California
Calaveras,2021-02-04,395,5083,28,1548,367,3535,0,0,306,3380,89,902,309,4282,California
Calaveras,2021-02-05,83,5166,23,1571,60,3595,0,0,45,3388,38,940,46,4328,California
Calaveras,2021-02-06,22,5188,13,1584,9,3604,0,0,22,3410,0,940,22,4350,California
Calaveras,2021-02-07,6,5194,1,1585,5,3609,0,0,2,3410,2,942,2,4352,California
Calaveras,2021-02-08,44,5238,17,1602,27,3636,0,0,35,3438,7,949,35,4387,California
Calaveras,2021-02-09,200,5438,79,1681,121,3757,0,0,137,3515,61,1010,138,4525,California
Calaveras,2021-02-10,525,5963,35,1716,490,4247,0,0,444,3891,81,1091,457,4982,California
Calaveras,2021-02-11,609,6572,95,1811,514,4761,0,0,482,4268,124,1215,501,5483,California
Calaveras,2021-02-12,577,7149,326,2137,251,5012,0,0,484,4677,91,1306,500,5983,California
Calaveras,2021-02-13,211,7360,47,2184,164,5176,0,0,192,4851,18,1324,192,6175,California
Calaveras,2021-02-14,223,7583,71,2255,152,5328,0,0,206,5043,14,1338,206,6381,California
Calaveras,2021-02-15,394,7977,25,2280,369,5697,0,0,267,5189,121,1459,267,6648,California
Calaveras,2021-02-16,279,8256,150,2430,129,5826,0,0,231,5382,48,1507,241,6889,California
Calaveras,2021-02-17,519,8775,38,2468,481,6307,0,0,204,5300,293,1800,211,7100,California
Calaveras,2021-02-18,509,9284,96,2564,413,6720,0,0,99,5023,377,2177,100,7200,California
Calaveras,2021-02-19,444,9728,42,2606,402,7122,0,0,99,4796,326,2503,99,7299,California
Calaveras,2021-02-20,57,9785,15,2621,42,7164,0,0,46,4831,11,2514,46,7345,California
Calaveras,2021-02-21,27,9812,16,2637,11,7175,0,0,21,4847,5,2519,21,7366,California
Calaveras,2021-02-22,69,9881,40,2677,29,7204,0,0,35,4851,31,2550,35,7401,California
Calaveras,2021-02-23,136,10017,47,2724,89,7293,0,0,93,4903,42,2592,94,7495,California
Calaveras,2021-02-24,105,10122,49,2773,56,7349,0,0,71,4942,32,2624,71,7566,California
Calaveras,2021-02-25,557,10679,105,2878,452,7801,0,0,352,5112,192,2816,362,7928,California
Calaveras,2021-02-26,796,11475,48,2926,748,8549,0,0,380,5114,382,3198,384,8312,California
Calaveras,2021-02-27,212,11687,29,2955,183,8732,0,0,186,5274,26,3224,186,8498,California
Calaveras,2021-02-28,98,11785,15,2970,83,8815,0,0,93,5362,5,3229,93,8591,California
Calaveras,2021-03-01,260,12045,51,3021,209,9024,0,0,159,5427,95,3324,160,8751,California
Calaveras,2021-03-02,269,12314,110,3131,159,9183,0,0,209,5583,57,3381,213,8964,California
Calaveras,2021-03-03,576,12890,114,3245,462,9645,0,0,218,5450,352,3733,219,9183,California
Calaveras,2021-03-04,768,13658,78,3323,689,10334,1,1,354,5404,403,4136,357,9540,California
Calaveras,2021-03-05,469,14127,275,3598,190,10524,4,5,149,5258,299,4435,153,9693,California
Calaveras,2021-03-06,161,14288,45,3643,110,10634,6,11,117,5340,42,4477,124,9817,California
Calaveras,2021-03-07,84,14372,33,3676,43,10677,8,19,38,5341,45,4522,46,9863,California
Calaveras,2021-03-08,175,14547,34,3710,133,10810,8,27,135,5446,38,4560,143,10006,California
Calaveras,2021-03-09,389,14936,146,3856,237,11047,6,33,37,5152,337,4897,43,10049,California
Calaveras,2021-03-10,439,15375,36,3892,399,11446,4,37,60,4852,364,5261,64,10113,California
Calaveras,2021-03-11,889,16264,441,4333,435,11881,13,50,437,4874,430,5691,452,10565,California
Calaveras,2021-03-12,431,16695,223,4556,199,12080,9,59,320,5107,108,5799,341,10906,California
Calaveras,2021-03-13,191,16886,18,4574,165,12245,8,67,134,5198,55,5854,146,11052,California
Calaveras,2021-03-14,160,17046,12,4586,147,12392,1,68,17,5079,143,5997,24,11076,California
Calaveras,2021-03-15,339,17385,50,4636,263,12655,26,94,56,4884,281,6278,86,11162,California
Calaveras,2021-03-16,708,18093,566,5202,122,12777,20,114,557,5312,149,6427,577,11739,California
Calaveras,2021-03-17,291,18384,53,5255,224,13001,14,128,50,5145,232,6659,65,11804,California
Calaveras,2021-03-18,679,19063,580,5835,83,13084,16,144,552,5590,126,6785,571,12375,California
Calaveras,2021-03-19,239,19302,52,5887,112,13196,75,219,60,5548,175,6960,133,12508,California
Calaveras,2021-03-20,82,19384,24,5911,57,13253,1,220,23,5513,59,7019,24,12532,California
Calaveras,2021-03-21,46,19430,29,5940,6,13259,11,231,8,5496,37,7056,20,12552,California
Calaveras,2021-03-22,85,19515,40,5980,24,13283,21,252,27,5487,57,7113,48,12600,California
Calaveras,2021-03-23,300,19815,208,6188,82,13365,10,262,119,5448,167,7280,128,12728,California
Calaveras,2021-03-24,141,19956,54,6242,77,13442,10,272,45,5410,93,7373,55,12783,California
Calaveras,2021-03-25,758,20714,111,6353,643,14085,4,276,452,5573,293,7666,456,13239,California
Calaveras,2021-03-26,443,21157,29,6382,407,14492,7,283,91,5330,342,8008,99,13338,California
Calaveras,2021-03-27,215,21372,23,6405,188,14680,4,287,36,5197,176,8184,43,13381,California
Calaveras,2021-03-28,110,21482,11,6416,96,14776,3,290,7,5105,102,8286,10,13391,California
Calaveras,2021-03-29,186,21668,23,6439,160,14936,3,293,57,5044,122,8408,61,13452,California
Calaveras,2021-03-30,546,22214,28,6467,502,15438,16,309,365,5245,181,8589,382,13834,California
Calaveras,2021-03-31,326,22540,144,6611,172,15610,10,319,157,5248,166,8755,169,14003,California
Calaveras,2021-04-01,702,23242,451,7062,250,15860,1,320,181,4920,515,9270,187,14190,California
Calaveras,2021-04-02,400,23642,231,7293,160,16020,9,329,112,4765,277,9547,122,14312,California
Calaveras,2021-04-03,147,23789,35,7328,108,16128,4,333,41,4704,106,9653,45,14357,California
Calaveras,2021-04-04,84,23873,28,7356,56,16184,0,333,52,4724,32,9685,52,14409,California
Calaveras,2021-04-05,219,24092,85,7441,125,16309,9,342,101,4716,118,9803,110,14519,California
Calaveras,2021-04-06,670,24762,586,8027,69,16378,15,357,115,4296,550,10353,130,14649,California
Calaveras,2021-04-07,761,25523,663,8690,60,16438,38,395,619,4812,141,10494,657,15306,California
Calaveras,2021-04-08,959,26482,866,9556,70,16508,23,418,437,4755,518,11012,461,15767,California
Calaveras,2021-04-09,159,26641,60,9616,50,16558,49,467,55,4759,99,11111,103,15870,California
Calaveras,2021-04-10,200,26841,45,9661,134,16692,21,488,151,4884,48,11159,173,16043,California
Calaveras,2021-04-11,69,26910,46,9707,21,16713,2,490,51,4918,18,11177,52,16095,California
Calaveras,2021-04-12,104,27014,45,9752,41,16754,18,508,55,4943,49,11226,74,16169,California
Calaveras,2021-04-13,428,27442,371,10123,57,16811,0,508,367,5252,60,11286,369,16538,California
Calaveras,2021-04-14,189,27631,32,10155,157,16968,0,508,138,5341,50,11336,139,16677,California
Calaveras,2021-04-15,337,27968,285,10440,52,17020,0,508,244,5499,86,11422,244,16921,California
Calaveras,2021-04-16,107,28075,30,10470,77,17097,0,508,49,5497,51,11473,49,16970,California
Calaveras,2021-04-17,334,28409,128,10598,206,17303,0,508,291,5745,43,11516,291,17261,California
Calaveras,2021-04-18,21,28430,9,10607,12,17315,0,508,12,5749,8,11524,12,17273,California
Calaveras,2021-04-19,77,28507,26,10633,51,17366,0,508,44,5762,32,11556,45,17318,California
Calaveras,2021-04-20,267,28774,90,10723,177,17543,0,508,194,5889,67,11623,194,17512,California
Calaveras,2021-04-21,219,28993,147,10870,72,17615,0,508,84,5842,132,11755,85,17597,California
Calaveras,2021-04-22,550,29543,97,10967,453,18068,0,508,144,5587,401,12156,146,17743,California
Calaveras,2021-04-23,161,29704,79,11046,82,18150,0,508,64,5557,94,12250,64,17807,California
Calaveras,2021-04-24,173,29877,37,11083,136,18286,0,508,129,5644,43,12293,130,17937,California
Calaveras,2021-04-25,43,29920,27,11110,16,18302,0,508,23,5650,20,12313,26,17963,California
Calaveras,2021-04-26,120,30040,76,11186,44,18346,0,508,34,5600,85,12398,35,17998,California
Calaveras,2021-04-27,444,30484,72,11258,359,18705,13,521,54,5283,384,12782,67,18065,California
Calaveras,2021-04-28,651,31135,582,11840,38,18743,31,552,56,4789,589,13371,95,18160,California
Calaveras,2021-04-29,524,31659,447,12287,58,18801,19,571,70,4433,449,13820,93,18253,California
Calaveras,2021-04-30,160,31819,64,12351,90,18891,6,577,72,4431,85,13905,83,18336,California
Calaveras,2021-05-01,204,32023,112,12463,89,18980,3,580,135,4506,66,13971,141,18477,California
Calaveras,2021-05-02,52,32075,35,12498,16,18996,1,581,18,4495,32,14003,21,18498,California
Calaveras,2021-05-03,97,32172,72,12570,20,19016,5,586,30,4469,66,14069,40,18538,California
Calaveras,2021-05-04,420,32592,328,12898,55,19071,37,623,45,4179,373,14442,83,18621,California
Calaveras,2021-05-05,113,32705,58,12956,22,19093,33,656,48,4196,63,14505,80,18701,California
Calaveras,2021-05-06,259,32964,195,13151,40,19133,24,680,50,4064,207,14712,75,18776,California
Calaveras,2021-05-07,87,33051,23,13174,58,19191,6,686,57,4097,30,14742,63,18839,California
Calaveras,2021-05-08,292,33343,142,13316,147,19338,3,689,89,3991,198,14940,92,18931,California
Calaveras,2021-05-09,29,33372,13,13329,13,19351,3,692,13,3992,15,14955,16,18947,California
Calaveras,2021-05-10,66,33438,31,13360,34,19385,1,693,29,3988,35,14990,31,18978,California
Calaveras,2021-05-11,136,33574,89,13449,34,19419,13,706,95,4057,40,15030,109,19087,California
Calaveras,2021-05-12,174,33748,51,13500,123,19542,0,706,53,3992,119,15149,54,19141,California
Calaveras,2021-05-13,121,33869,65,13565,41,19583,15,721,65,4019,54,15203,81,19222,California
Calaveras,2021-05-14,150,34019,94,13659,53,19636,3,724,100,4074,48,15251,103,19325,California
Calaveras,2021-05-15,268,34287,98,13757,167,19803,3,727,106,4027,156,15407,109,19434,California
Calaveras,2021-05-16,30,34317,12,13769,18,19821,0,727,14,4026,16,15423,15,19449,California
Calaveras,2021-05-17,90,34407,42,13811,41,19862,7,734,47,4039,42,15465,55,19504,California
Calaveras,2021-05-18,229,34636,65,13876,142,20004,22,756,75,3983,153,15618,97,19601,California
Calaveras,2021-05-19,152,34788,65,13941,83,20087,4,760,72,3981,79,15697,77,19678,California
Calaveras,2021-05-20,203,34991,80,14021,97,20184,26,786,67,3940,133,15830,92,19770,California
Calaveras,2021-05-21,101,35092,58,14079,39,20223,4,790,60,3963,40,15870,63,19833,California
Calaveras,2021-05-22,302,35394,160,14239,142,20365,0,790,148,3959,153,16023,149,19982,California
Calaveras,2021-05-23,29,35423,14,14253,15,20380,0,790,12,3954,17,16040,12,19994,California
Calaveras,2021-05-24,76,35499,40,14293,20,20400,16,806,32,3959,44,16084,49,20043,California
Calaveras,2021-05-25,126,35625,49,14342,60,20460,17,823,58,3966,68,16152,75,20118,California
Calaveras,2021-05-26,122,35747,88,14430,30,20490,4,827,84,4016,37,16189,87,20205,California
Calaveras,2021-05-27,86,35833,44,14474,38,20528,4,831,30,3998,53,16242,35,20240,California
Calaveras,2021-05-28,83,35916,43,14517,36,20564,4,835,38,3995,45,16287,42,20282,California
Calaveras,2021-05-29,70,35986,24,14541,41,20605,5,840,33,3997,37,16324,39,20321,California
Calaveras,2021-05-30,36,36022,14,14555,17,20622,5,845,11,3987,25,16349,15,20336,California
Calaveras,2021-05-31,5,36027,0,14555,3,20625,2,847,0,3984,5,16354,2,20338,California
Calaveras,2021-06-01,148,36175,99,14654,43,20668,6,853,46,3934,102,16456,52,20390,California
Calaveras,2021-06-02,88,36263,57,14711,27,20695,4,857,40,3930,48,16504,44,20434,California
Calaveras,2021-06-03,93,36356,55,14766,31,20726,7,864,42,3932,49,16553,51,20485,California
Calaveras,2021-06-04,141,36497,94,14860,35,20761,12,876,36,3877,104,16657,49,20534,California
Calaveras,2021-06-05,86,36583,29,14889,55,20816,2,878,34,3862,51,16708,36,20570,California
Calaveras,2021-06-06,38,36621,27,14916,9,20825,2,880,20,3866,18,16726,22,20592,California
Calaveras,2021-06-07,62,36683,45,14961,9,20834,8,888,25,3863,36,16762,33,20625,California
Calaveras,2021-06-08,126,36809,82,15043,38,20872,6,894,58,3859,68,16830,64,20689,California
Calaveras,2021-06-09,95,36904,51,15094,38,20910,6,900,29,3830,66,16896,37,20726,California
Calaveras,2021-06-10,117,37021,57,15151,51,20961,9,909,40,3804,75,16971,49,20775,California
Calaveras,2021-06-11,106,37127,62,15213,39,21000,5,914,34,3771,72,17043,39,20814,California
Calaveras,2021-06-12,62,37189,36,15249,24,21024,2,916,19,3750,43,17086,22,20836,California
Calaveras,2021-06-13,31,37220,18,15267,9,21033,4,920,8,3739,23,17109,12,20848,California
Calaveras,2021-06-14,59,37279,39,15306,16,21049,4,924,22,3730,37,17146,28,20876,California
Calaveras,2021-06-15,92,37371,57,15363,26,21075,9,933,23,3695,68,17214,33,20909,California
Calaveras,2021-06-16,181,37552,139,15502,27,21102,15,948,39,3608,141,17355,54,20963,California
Calaveras,2021-06-17,60,37612,33,15535,23,21125,4,952,25,3605,32,17387,29,20992,California
Calaveras,2021-06-18,62,37674,41,15576,16,21141,5,957,25,3598,36,17423,29,21021,California
Calaveras,2021-06-19,66,37740,23,15599,26,21167,17,974,23,3595,43,17466,40,21061,California
Calaveras,2021-06-20,5,37745,2,15601,2,21169,1,975,1,3593,4,17470,2,21063,California
Calaveras,2021-06-21,39,37784,15,15616,18,21187,6,981,24,3609,15,17485,31,21094,California
Calaveras,2021-06-22,64,37848,33,15649,29,21216,2,983,29,3608,32,17517,31,21125,California
Calaveras,2021-06-23,65,37913,39,15688,19,21235,7,990,31,3612,34,17551,38,21163,California
Calaveras,2021-06-24,69,37982,37,15725,30,21265,2,992,34,3613,35,17586,36,21199,California
Calaveras,2021-06-25,54,38036,34,15759,12,21277,8,1000,24,3615,30,17616,32,21231,California
Calaveras,2021-06-26,37,38073,17,15776,18,21295,2,1002,20,3621,17,17633,23,21254,California
Calaveras,2021-06-27,19,38092,16,15792,2,21297,1,1003,8,3619,11,17644,9,21263,California
Calaveras,2021-06-28,49,38141,29,15821,15,21312,5,1008,21,3619,27,17671,27,21290,California
Calaveras,2021-06-29,73,38214,50,15871,20,21332,3,1011,31,3613,40,17711,34,21324,California
Calaveras,2021-06-30,48,38262,30,15901,11,21343,7,1018,27,3627,20,17731,34,21358,California
Calaveras,2021-07-01,44,38306,25,15926,14,21357,5,1023,22,3633,21,17752,27,21385,California
Calaveras,2021-07-02,47,38353,32,15958,13,21370,2,1025,29,3646,18,17770,31,21416,California
Calaveras,2021-07-03,23,38376,15,15973,8,21378,0,1025,13,3649,10,17780,13,21429,California
Calaveras,2021-07-04,4,38380,1,15974,3,21381,0,1025,3,3651,1,17781,3,21432,California
Calaveras,2021-07-05,24,38404,14,15988,7,21388,3,1028,5,3641,19,17800,9,21441,California
Calaveras,2021-07-06,77,38481,27,16015,34,21422,16,1044,37,3655,40,17840,54,21495,California
Calaveras,2021-07-07,53,38534,26,16041,23,21445,4,1048,28,3663,24,17864,32,21527,California
Calaveras,2021-07-08,57,38591,19,16060,33,21478,5,1053,27,3666,29,17893,32,21559,California
Calaveras,2021-07-09,39,38630,19,16079,16,21494,4,1057,19,3669,20,17913,23,21582,California
Calaveras,2021-07-10,46,38676,27,16106,17,21511,2,1059,25,3676,21,17934,28,21610,California
Calaveras,2021-07-11,21,38697,12,16118,8,21519,1,1060,16,3688,5,17939,17,21627,California
Calaveras,2021-07-12,39,38736,20,16138,19,21538,0,1060,22,3693,17,17956,22,21649,California
Calaveras,2021-07-13,39,38775,18,16156,20,21558,1,1061,19,3694,19,17975,20,21669,California
Calaveras,2021-07-14,42,38817,29,16185,13,21571,0,1061,23,3699,18,17993,23,21692,California
Calaveras,2021-07-15,47,38864,30,16215,16,21587,1,1062,32,3718,14,18007,33,21725,California
Calaveras,2021-07-16,45,38909,32,16247,13,21600,0,1062,28,3729,17,18024,28,21753,California
Calaveras,2021-07-17,34,38943,14,16261,14,21614,6,1068,16,3734,17,18041,22,21775,California
Calaveras,2021-07-18,32,38975,22,16283,7,21621,3,1071,23,3751,9,18050,26,21801,California
Calaveras,2021-07-19,40,39015,18,16301,18,21639,4,1075,22,3759,18,18068,26,21827,California
Calaveras,2021-07-20,56,39071,31,16332,22,21661,3,1078,33,3772,23,18091,36,21863,California
Calaveras,2021-07-21,65,39136,32,16364,29,21690,4,1082,37,3786,27,18118,41,21904,California
Calaveras,2021-07-22,63,39199,21,16385,31,21721,11,1093,28,3793,33,18151,40,21944,California
Calaveras,2021-07-23,80,39279,51,16436,24,21745,5,1098,50,3819,30,18181,56,22000,California
Calaveras,2021-07-24,46,39325,22,16458,24,21769,0,1098,29,3832,16,18197,29,22029,California
Calaveras,2021-07-25,29,39354,18,16476,7,21776,4,1102,21,3849,8,18205,25,22054,California
Calaveras,2021-07-26,58,39412,31,16507,27,21803,0,1102,41,3873,17,18222,41,22095,California
Calaveras,2021-07-27,74,39486,37,16544,36,21839,1,1103,50,3900,24,18246,51,22146,California
Calaveras,2021-07-28,53,39539,18,16562,30,21869,5,1108,37,3926,16,18262,42,22188,California
Calaveras,2021-07-29,61,39600,28,16590,28,21897,5,1113,41,3952,20,18282,46,22234,California
Calaveras,2021-07-30,115,39715,71,16661,33,21930,11,1124,75,4000,39,18321,87,22321,California
Calaveras,2021-07-31,52,39767,24,16685,22,21952,6,1130,32,4017,20,18341,37,22358,California
Calaveras,2021-08-01,30,39797,15,16700,6,21958,9,1139,14,4024,16,18357,23,22381,California
Calaveras,2021-08-02,63,39860,33,16733,28,21986,2,1141,44,4052,19,18376,47,22428,California
Calaveras,2021-08-03,63,39923,33,16766,28,22014,2,1143,42,4075,21,18397,44,22472,California
Calaveras,2021-08-04,53,39976,35,16801,14,22028,4,1147,30,4087,23,18420,35,22507,California
Calaveras,2021-08-05,77,40053,34,16835,38,22066,5,1152,52,4119,25,18445,57,22564,California
Calaveras,2021-08-06,72,40125,55,16890,16,22082,1,1153,51,4151,20,18465,52,22616,California
Calaveras,2021-08-07,51,40176,30,16920,17,22099,4,1157,34,4172,17,18482,38,22654,California
Calaveras,2021-08-08,39,40215,18,16938,14,22113,7,1164,15,4170,24,18506,22,22676,California
Calaveras,2021-08-09,56,40271,29,16967,22,22135,5,1169,38,4195,18,18524,43,22719,California
Calaveras,2021-08-10,67,40338,40,17007,25,22160,2,1171,42,4216,23,18547,44,22763,California
Calaveras,2021-08-11,83,40421,48,17055,23,22183,12,1183,47,4239,36,18583,59,22822,California
Calaveras,2021-08-12,89,40510,39,17094,44,22227,6,1189,55,4268,31,18614,60,22882,California
Calaveras,2021-08-13,114,40624,80,17174,29,22256,5,1194,79,4318,33,18647,83,22965,California
Calaveras,2021-08-14,87,40711,53,17227,25,22281,9,1203,55,4356,26,18673,64,23029,California
Calaveras,2021-08-15,23,40734,14,17241,8,22289,1,1204,6,4346,17,18690,7,23036,California
Calaveras,2021-08-16,87,40821,37,17278,43,22332,7,1211,54,4375,30,18720,59,23095,California
Calaveras,2021-08-17,91,40912,42,17320,40,22372,9,1220,48,4398,35,18755,58,23153,California
Calaveras,2021-08-18,93,41005,42,17362,42,22414,9,1229,49,4418,38,18793,58,23211,California
Calaveras,2021-08-19,91,41096,40,17402,49,22463,2,1231,59,4452,27,18820,61,23272,California
Calaveras,2021-08-20,135,41231,79,17481,45,22508,11,1242,65,4468,61,18881,77,23349,California
Calaveras,2021-08-21,64,41295,31,17512,25,22533,8,1250,28,4473,31,18912,36,23385,California
Calaveras,2021-08-22,36,41331,13,17525,19,22552,4,1254,15,4473,19,18931,19,23404,California
Calaveras,2021-08-23,90,41421,49,17574,41,22593,0,1254,52,4492,34,18965,53,23457,California
Calaveras,2021-08-24,76,41497,40,17614,35,22628,1,1255,39,4501,32,18997,41,23498,California
Calaveras,2021-08-25,124,41621,77,17691,37,22665,10,1265,76,4548,41,19038,88,23586,California
Calaveras,2021-08-26,105,41726,52,17743,45,22710,8,1273,51,4561,48,19086,61,23647,California
Calaveras,2021-08-27,102,41828,67,17810,27,22737,8,1281,45,4560,57,19143,56,23703,California
Calaveras,2021-08-28,68,41896,32,17842,36,22773,0,1281,32,4565,30,19173,35,23738,California
Calaveras,2021-08-29,45,41941,34,17876,10,22783,1,1282,26,4574,18,19191,27,23765,California
Calaveras,2021-08-30,54,41995,29,17905,22,22805,3,1285,23,4573,28,19219,27,23792,California
Colusa,2020-12-18,1,1,1,1,0,0,0,0,1,1,0,0,1,1,California
Colusa,2020-12-21,3,4,3,4,0,0,0,0,3,4,0,0,3,4,California
Colusa,2020-12-22,10,14,10,14,0,0,0,0,10,14,0,0,10,14,California
Colusa,2020-12-23,10,24,10,24,0,0,0,0,10,24,0,0,10,24,California
Colusa,2020-12-24,2,26,1,25,1,1,0,0,2,26,0,0,2,26,California
Colusa,2020-12-27,1,27,1,26,0,1,0,0,1,27,0,0,1,27,California
Colusa,2020-12-28,7,34,3,29,4,5,0,0,7,34,0,0,7,34,California
Colusa,2020-12-29,9,43,7,36,2,7,0,0,9,43,0,0,9,43,California
Colusa,2020-12-30,51,94,14,50,37,44,0,0,51,94,0,0,51,94,California
Colusa,2020-12-31,18,112,1,51,17,61,0,0,18,112,0,0,18,112,California
Colusa,2021-01-04,4,116,1,52,3,64,0,0,4,116,0,0,4,116,California
Colusa,2021-01-05,68,184,1,53,67,131,0,0,68,184,0,0,68,184,California
Colusa,2021-01-06,15,199,9,62,6,137,0,0,15,199,0,0,15,199,California
Colusa,2021-01-07,42,241,6,68,36,173,0,0,40,237,2,2,40,239,California
Colusa,2021-01-08,11,252,9,77,2,175,0,0,9,244,2,4,9,248,California
Colusa,2021-01-09,2,254,1,78,1,176,0,0,2,246,0,4,2,250,California
Colusa,2021-01-10,1,255,0,78,1,177,0,0,1,247,0,4,1,251,California
Colusa,2021-01-11,12,267,6,84,6,183,0,0,7,249,5,9,7,258,California
Colusa,2021-01-12,11,278,9,93,2,185,0,0,6,250,5,14,6,264,California
Colusa,2021-01-13,21,299,14,107,7,192,0,0,12,253,9,23,12,276,California
Colusa,2021-01-14,37,336,30,137,7,199,0,0,35,286,2,25,35,311,California
Colusa,2021-01-15,46,382,5,142,41,240,0,0,44,328,2,27,44,355,California
Colusa,2021-01-16,14,396,1,143,13,253,0,0,13,340,1,28,13,368,California
Colusa,2021-01-17,2,398,1,144,1,254,0,0,2,342,0,28,2,370,California
Colusa,2021-01-18,4,402,0,144,4,258,0,0,4,346,0,28,4,374,California
Colusa,2021-01-19,10,412,9,153,1,259,0,0,6,348,4,32,6,380,California
Colusa,2021-01-20,113,525,100,253,13,272,0,0,99,433,14,46,99,479,California
Colusa,2021-01-21,68,593,53,306,15,287,0,0,67,499,1,47,67,546,California
Colusa,2021-01-22,36,629,17,323,19,306,0,0,31,525,5,52,31,577,California
Colusa,2021-01-23,34,663,6,329,28,334,0,0,34,559,0,52,34,611,California
Colusa,2021-01-25,7,670,0,329,7,341,0,0,7,566,0,52,7,618,California
Colusa,2021-01-26,8,678,5,334,3,344,0,0,5,568,3,55,5,623,California
Colusa,2021-01-27,107,785,31,365,76,420,0,0,105,671,2,57,105,728,California
Colusa,2021-01-28,128,913,49,414,79,499,0,0,80,703,48,105,80,808,California
Colusa,2021-01-29,45,958,12,426,33,532,0,0,39,736,6,111,39,847,California
Colusa,2021-01-30,28,986,4,430,24,556,0,0,28,764,0,111,28,875,California
Colusa,2021-01-31,7,993,7,437,0,556,0,0,7,771,0,111,7,882,California
Colusa,2021-02-01,28,1021,11,448,17,573,0,0,22,787,6,117,22,904,California
Colusa,2021-02-02,42,1063,8,456,34,607,0,0,36,817,6,123,36,940,California
Colusa,2021-02-03,77,1140,12,468,65,672,0,0,64,868,13,136,64,1004,California
Colusa,2021-02-04,174,1314,84,552,90,762,0,0,117,929,56,192,117,1121,California
Colusa,2021-02-05,29,1343,9,561,20,782,0,0,26,952,3,195,26,1147,California
Colusa,2021-02-06,284,1627,9,570,275,1057,0,0,273,1214,11,206,273,1420,California
Colusa,2021-02-07,2,1629,1,571,1,1058,0,0,0,1212,2,208,0,1420,California
Colusa,2021-02-08,42,1671,5,576,37,1095,0,0,39,1248,3,211,39,1459,California
Colusa,2021-02-09,231,1902,14,590,217,1312,0,0,177,1371,54,265,177,1636,California
Colusa,2021-02-10,116,2018,43,633,73,1385,0,0,72,1399,44,309,72,1708,California
Colusa,2021-02-11,106,2124,43,676,63,1448,0,0,80,1453,26,335,80,1788,California
Colusa,2021-02-12,120,2244,9,685,111,1559,0,0,77,1486,44,379,77,1865,California
Colusa,2021-02-13,60,2304,8,693,52,1611,0,0,50,1526,10,389,50,1915,California
Colusa,2021-02-14,20,2324,8,701,12,1623,0,0,14,1534,6,395,14,1929,California
Colusa,2021-02-15,47,2371,10,711,37,1660,0,0,40,1567,7,402,40,1969,California
Colusa,2021-02-16,70,2441,4,715,66,1726,0,0,69,1635,1,403,69,2038,California
Colusa,2021-02-17,205,2646,141,856,64,1790,0,0,60,1550,145,548,60,2098,California
Colusa,2021-02-18,143,2789,40,896,103,1893,0,0,119,1645,24,572,119,2217,California
Colusa,2021-02-19,154,2943,19,915,135,2028,0,0,132,1755,22,594,132,2349,California
Colusa,2021-02-20,30,2973,5,920,25,2053,0,0,12,1749,18,612,12,2361,California
Colusa,2021-02-21,4,2977,2,922,2,2055,0,0,2,1749,2,614,2,2363,California
Colusa,2021-02-22,45,3022,27,949,18,2073,0,0,30,1764,15,629,30,2393,California
Colusa,2021-02-23,21,3043,6,955,15,2088,0,0,17,1777,4,633,17,2410,California
Colusa,2021-02-24,309,3352,57,1012,252,2340,0,0,159,1786,150,783,159,2569,California
Colusa,2021-02-25,128,3480,67,1079,61,2401,0,0,83,1824,45,828,83,2652,California
Colusa,2021-02-26,98,3578,14,1093,84,2485,0,0,56,1838,42,870,56,2708,California
Colusa,2021-02-27,58,3636,5,1098,53,2538,0,0,42,1864,16,886,42,2750,California
Colusa,2021-02-28,29,3665,16,1114,13,2551,0,0,20,1875,9,895,20,2770,California
Colusa,2021-03-01,48,3713,16,1130,32,2583,0,0,29,1885,19,914,29,2799,California
Colusa,2021-03-02,56,3769,13,1143,43,2626,0,0,26,1882,29,943,26,2825,California
Colusa,2021-03-03,264,4033,47,1190,217,2843,0,0,193,2004,71,1014,193,3018,California
Colusa,2021-03-04,151,4184,60,1250,91,2934,0,0,79,2011,72,1086,79,3097,California
Colusa,2021-03-05,106,4290,25,1275,72,3006,9,9,48,2010,58,1144,57,3154,California
Colusa,2021-03-06,271,4561,9,1284,262,3268,0,9,39,1817,232,1376,39,3193,California
Colusa,2021-03-07,9,4570,6,1290,3,3271,0,9,7,1822,2,1378,7,3200,California
Colusa,2021-03-08,111,4681,23,1313,53,3324,35,44,49,1845,61,1439,84,3284,California
Colusa,2021-03-09,289,4970,74,1387,192,3516,23,67,94,1767,195,1634,117,3401,California
Colusa,2021-03-10,310,5280,37,1424,237,3753,36,103,212,1917,98,1732,248,3649,California
Colusa,2021-03-11,433,5713,61,1485,351,4104,21,124,336,2175,97,1829,355,4004,California
Colusa,2021-03-12,109,5822,18,1503,79,4183,12,136,20,2118,89,1918,32,4036,California
Colusa,2021-03-13,65,5887,13,1516,43,4226,9,145,19,2100,46,1964,28,4064,California
Colusa,2021-03-14,23,5910,0,1516,21,4247,2,147,7,2094,15,1979,9,4073,California
Colusa,2021-03-15,82,5992,28,1544,46,4293,8,155,24,2068,58,2037,32,4105,California
Colusa,2021-03-16,300,6292,16,1560,238,4531,46,201,190,2194,110,2147,236,4341,California
Colusa,2021-03-17,198,6490,50,1610,148,4679,0,201,108,2212,90,2237,108,4449,California
Colusa,2021-03-18,327,6817,39,1649,217,4896,71,272,191,2339,136,2373,263,4712,California
Colusa,2021-03-19,78,6895,19,1668,57,4953,2,274,51,2365,27,2400,53,4765,California
Colusa,2021-03-20,51,6946,8,1676,42,4995,1,275,37,2389,14,2414,38,4803,California
Colusa,2021-03-21,6,6952,4,1680,2,4997,0,275,1,2385,5,2419,1,4804,California
Colusa,2021-03-22,63,7015,10,1690,44,5041,9,284,41,2413,22,2441,50,4854,California
Colusa,2021-03-23,82,7097,17,1707,63,5104,2,286,54,2442,27,2468,56,4910,California
Colusa,2021-03-24,340,7437,57,1764,277,5381,6,292,66,2239,274,2742,71,4981,California
Colusa,2021-03-25,118,7555,71,1835,42,5423,5,297,58,2242,60,2802,63,5044,California
Colusa,2021-03-26,299,7854,50,1885,245,5668,4,301,244,2435,55,2857,248,5292,California
Colusa,2021-03-27,62,7916,5,1890,57,5725,0,301,23,2419,39,2896,23,5315,California
Colusa,2021-03-28,17,7933,8,1898,9,5734,0,301,6,2414,11,2907,6,5321,California
Colusa,2021-03-29,73,8006,21,1919,46,5780,6,307,31,2409,42,2949,37,5358,California
Colusa,2021-03-30,151,8157,85,2004,64,5844,2,309,70,2400,81,3030,72,5430,California
Colusa,2021-03-31,232,8389,38,2042,194,6038,0,309,63,2295,168,3198,63,5493,California
Colusa,2021-04-01,445,8834,80,2122,310,6348,55,364,319,2543,125,3323,373,5866,California
Colusa,2021-04-02,83,8917,17,2139,52,6400,14,378,38,2550,45,3368,52,5918,California
Colusa,2021-04-03,61,8978,9,2148,29,6429,23,401,14,2539,47,3415,36,5954,California
Colusa,2021-04-04,17,8995,0,2148,7,6436,10,411,3,2538,14,3429,13,5967,California
Colusa,2021-04-05,102,9097,27,2175,58,6494,17,428,36,2524,66,3495,52,6019,California
Colusa,2021-04-06,131,9228,34,2209,46,6540,51,479,36,2516,95,3590,87,6106,California
Colusa,2021-04-07,357,9585,42,2251,292,6832,23,502,124,2432,232,3822,148,6254,California
Colusa,2021-04-08,432,10017,36,2287,367,7199,29,531,121,2274,308,4130,150,6404,California
Colusa,2021-04-09,78,10095,22,2309,32,7231,24,555,28,2276,50,4180,52,6456,California
Colusa,2021-04-10,46,10141,9,2318,16,7247,21,576,11,2273,35,4215,32,6488,California
Colusa,2021-04-11,18,10159,4,2322,12,7259,2,578,9,2275,9,4224,11,6499,California
Colusa,2021-04-12,31,10190,3,2325,28,7287,0,578,14,2272,17,4241,14,6513,California
Colusa,2021-04-13,283,10473,22,2347,261,7548,0,578,95,2180,187,4428,95,6608,California
Colusa,2021-04-14,95,10568,19,2366,76,7624,0,578,31,2147,64,4492,31,6639,California
Colusa,2021-04-15,330,10898,49,2415,281,7905,0,578,125,2068,205,4697,126,6765,California
Colusa,2021-04-16,81,10979,13,2428,68,7973,0,578,36,2060,44,4741,36,6801,California
Colusa,2021-04-17,54,11033,7,2435,47,8020,0,578,30,2066,24,4765,30,6831,California
Colusa,2021-04-18,8,11041,2,2437,6,8026,0,578,7,2072,1,4766,7,6838,California
Colusa,2021-04-19,62,11103,22,2459,40,8066,0,578,16,2042,46,4812,16,6854,California
Colusa,2021-04-20,186,11289,36,2495,150,8216,0,578,130,2116,56,4868,130,6984,California
Colusa,2021-04-21,189,11478,77,2572,112,8328,0,578,115,2157,74,4942,115,7099,California
Colusa,2021-04-22,421,11899,27,2599,393,8721,1,579,220,2177,200,5142,220,7319,California
Colusa,2021-04-23,97,11996,24,2623,73,8794,0,579,37,2154,60,5202,37,7356,California
Colusa,2021-04-24,238,12234,17,2640,220,9014,1,580,210,2336,28,5230,210,7566,California
Colusa,2021-04-25,12,12246,6,2646,6,9020,0,580,8,2340,4,5234,8,7574,California
Colusa,2021-04-26,25,12271,5,2651,19,9039,1,581,6,2328,18,5252,6,7580,California
Colusa,2021-04-27,95,12366,25,2676,66,9105,4,585,44,2325,51,5303,48,7628,California
Colusa,2021-04-28,197,12563,34,2710,160,9265,3,588,143,2418,53,5356,146,7774,California
Colusa,2021-04-29,324,12887,30,2740,290,9555,4,592,47,2194,275,5631,51,7825,California
Colusa,2021-04-30,69,12956,24,2764,45,9600,0,592,47,2219,22,5653,47,7872,California
Colusa,2021-05-01,19,12975,8,2772,8,9608,3,595,8,2219,11,5664,11,7883,California
Colusa,2021-05-02,6,12981,2,2774,3,9611,1,596,2,2218,4,5668,3,7886,California
Colusa,2021-05-03,32,13013,8,2782,24,9635,0,596,15,2216,17,5685,15,7901,California
Colusa,2021-05-04,97,13110,54,2836,42,9677,1,597,68,2256,29,5714,69,7970,California
Colusa,2021-05-05,85,13195,21,2857,63,9740,1,598,36,2244,49,5763,37,8007,California
Colusa,2021-05-06,265,13460,18,2875,245,9985,2,600,119,2219,146,5909,121,8128,California
Colusa,2021-05-07,69,13529,4,2879,60,10045,5,605,31,2218,37,5946,36,8164,California
Colusa,2021-05-08,20,13549,6,2885,14,10059,0,605,9,2216,11,5957,9,8173,California
Colusa,2021-05-09,13,13562,5,2890,5,10064,3,608,6,2218,7,5964,9,8182,California
Colusa,2021-05-10,26,13588,6,2896,20,10084,0,608,9,2210,17,5981,9,8191,California
Colusa,2021-05-11,94,13682,33,2929,61,10145,0,608,48,2212,46,6027,48,8239,California
Colusa,2021-05-12,83,13765,37,2966,42,10187,4,612,22,2177,61,6088,26,8265,California
Colusa,2021-05-13,252,14017,23,2989,228,10415,1,613,79,2084,173,6261,80,8345,California
Colusa,2021-05-14,95,14112,19,3008,61,10476,15,628,32,2069,62,6323,47,8392,California
Colusa,2021-05-15,42,14154,11,3019,29,10505,2,630,22,2073,20,6343,24,8416,California
Colusa,2021-05-16,21,14175,5,3024,9,10514,7,637,8,2075,13,6356,15,8431,California
Colusa,2021-05-17,27,14202,6,3030,19,10533,2,639,15,2080,12,6368,17,8448,California
Colusa,2021-05-18,102,14304,28,3058,72,10605,2,641,46,2073,55,6423,48,8496,California
Colusa,2021-05-19,225,14529,45,3103,160,10765,20,661,67,2002,158,6581,87,8583,California
Colusa,2021-05-20,287,14816,36,3139,247,11012,4,665,69,1857,218,6799,73,8656,California
Colusa,2021-05-21,80,14896,26,3165,52,11064,2,667,35,1849,45,6844,37,8693,California
Colusa,2021-05-22,222,15118,24,3189,197,11261,1,668,34,1696,188,7032,35,8728,California
Colusa,2021-05-23,19,15137,8,3197,7,11268,4,672,5,1691,14,7046,9,8737,California
Colusa,2021-05-24,30,15167,3,3200,22,11290,5,677,16,1698,14,7060,21,8758,California
Colusa,2021-05-25,138,15305,77,3277,59,11349,2,679,55,1672,83,7143,57,8815,California
Colusa,2021-05-26,74,15379,25,3302,48,11397,1,680,33,1665,41,7184,34,8849,California
Colusa,2021-05-27,170,15549,18,3320,152,11549,0,680,54,1603,116,7300,54,8903,California
Colusa,2021-05-28,81,15630,25,3345,55,11604,1,681,42,1607,39,7339,43,8946,California
Colusa,2021-05-29,40,15670,18,3363,18,11622,4,685,29,1629,11,7350,33,8979,California
Colusa,2021-05-30,8,15678,1,3364,2,11624,5,690,1,1628,7,7357,6,8985,California
Colusa,2021-05-31,4,15682,0,3364,4,11628,0,690,1,1626,3,7360,1,8986,California
Colusa,2021-06-01,50,15732,16,3380,33,11661,1,691,26,1629,24,7384,27,9013,California
Colusa,2021-06-02,148,15880,22,3402,124,11785,2,693,51,1586,96,7480,53,9066,California
Colusa,2021-06-03,66,15946,19,3421,46,11831,1,694,26,1576,37,7517,27,9093,California
Colusa,2021-06-04,60,16006,20,3441,39,11870,1,695,23,1563,37,7554,24,9117,California
Colusa,2021-06-05,35,16041,16,3457,18,11888,1,696,17,1563,18,7572,18,9135,California
Colusa,2021-06-06,10,16051,5,3462,4,11892,1,697,6,1566,4,7576,7,9142,California
Colusa,2021-06-07,26,16077,8,3470,18,11910,0,697,10,1560,16,7592,10,9152,California
Colusa,2021-06-08,77,16154,22,3492,55,11965,0,697,30,1543,47,7639,30,9182,California
Colusa,2021-06-09,72,16226,42,3534,30,11995,0,697,28,1527,44,7683,28,9210,California
Colusa,2021-06-10,59,16285,24,3558,32,12027,3,700,15,1501,44,7727,18,9228,California
Colusa,2021-06-11,58,16343,30,3588,28,12055,0,700,25,1493,33,7760,25,9253,California
Colusa,2021-06-12,37,16380,23,3611,14,12069,0,700,9,1474,28,7788,9,9262,California
Colusa,2021-06-13,10,16390,3,3614,5,12074,2,702,2,1470,8,7796,4,9266,California
Colusa,2021-06-14,19,16409,9,3623,10,12084,0,702,7,1465,12,7808,7,9273,California
Colusa,2021-06-15,75,16484,36,3659,38,12122,1,703,15,1421,60,7868,16,9289,California
Colusa,2021-06-16,56,16540,16,3675,39,12161,1,704,15,1396,41,7909,16,9305,California
Colusa,2021-06-17,116,16656,10,3685,105,12266,1,705,17,1315,99,8008,18,9323,California
Colusa,2021-06-18,66,16722,32,3717,30,12296,4,709,28,1309,38,8046,32,9355,California
Colusa,2021-06-19,26,16748,21,3738,4,12300,1,710,6,1296,20,8066,7,9362,California
Colusa,2021-06-20,9,16757,6,3744,3,12303,0,710,7,1301,2,8068,7,9369,California
Colusa,2021-06-21,20,16777,3,3747,16,12319,1,711,7,1296,13,8081,8,9377,California
Colusa,2021-06-22,65,16842,28,3775,32,12351,5,716,26,1289,38,8119,31,9408,California
Colusa,2021-06-23,50,16892,27,3802,22,12373,1,717,21,1282,29,8148,22,9430,California
Colusa,2021-06-24,61,16953,28,3830,31,12404,2,719,23,1269,38,8186,25,9455,California
Colusa,2021-06-25,41,16994,16,3846,25,12429,0,719,25,1278,16,8202,25,9480,California
Colusa,2021-06-26,18,17012,13,3859,5,12434,0,719,5,1270,13,8215,5,9485,California
Colusa,2021-06-27,8,17020,5,3864,3,12437,0,719,6,1274,2,8217,6,9491,California
Colusa,2021-06-28,9,17029,1,3865,7,12444,1,720,6,1278,3,8220,7,9498,California
Colusa,2021-06-29,43,17072,19,3884,20,12464,4,724,19,1278,23,8243,23,9521,California
Colusa,2021-06-30,76,17148,37,3921,38,12502,1,725,27,1258,49,8292,29,9550,California
Colusa,2021-07-01,48,17196,23,3944,24,12526,1,726,20,1251,28,8320,21,9571,California
Colusa,2021-07-02,48,17244,26,3970,21,12547,1,727,24,1252,24,8344,25,9596,California
Colusa,2021-07-03,21,17265,8,3978,13,12560,0,727,11,1253,10,8354,11,9607,California
Colusa,2021-07-04,3,17268,2,3980,1,12561,0,727,1,1252,2,8356,1,9608,California
Colusa,2021-07-05,10,17278,6,3986,4,12565,0,727,4,1250,6,8362,4,9612,California
Colusa,2021-07-06,43,17321,17,4003,25,12590,1,728,21,1252,20,8382,22,9634,California
Colusa,2021-07-07,56,17377,30,4033,25,12615,1,729,34,1265,22,8404,35,9669,California
Colusa,2021-07-08,27,17404,12,4045,14,12629,1,730,18,1275,9,8413,19,9688,California
Colusa,2021-07-09,29,17433,21,4066,6,12635,2,732,10,1267,19,8432,11,9699,California
Colusa,2021-07-10,13,17446,6,4072,7,12642,0,732,8,1270,5,8437,8,9707,California
Colusa,2021-07-11,4,17450,4,4076,0,12642,0,732,1,1268,3,8440,1,9708,California
Colusa,2021-07-12,23,17473,10,4086,12,12654,1,733,6,1258,17,8457,7,9715,California
Colusa,2021-07-13,48,17521,27,4113,21,12675,0,733,26,1262,22,8479,26,9741,California
Colusa,2021-07-14,44,17565,21,4134,21,12696,2,735,19,1258,25,8504,21,9762,California
Colusa,2021-07-15,58,17623,32,4166,18,12714,8,743,23,1256,33,8537,31,9793,California
Colusa,2021-07-16,55,17678,36,4202,19,12733,0,743,31,1263,24,8561,31,9824,California
Colusa,2021-07-17,19,17697,13,4215,6,12739,0,743,9,1263,9,8570,9,9833,California
Colusa,2021-07-18,7,17704,4,4219,3,12742,0,743,2,1260,5,8575,2,9835,California
Colusa,2021-07-19,6,17710,0,4219,6,12748,0,743,2,1258,4,8579,2,9837,California
Colusa,2021-07-20,38,17748,16,4235,21,12769,1,744,22,1265,16,8595,23,9860,California
Colusa,2021-07-21,56,17804,37,4272,18,12787,1,745,31,1272,25,8620,32,9892,California
Colusa,2021-07-22,34,17838,20,4292,10,12797,4,749,15,1273,18,8638,19,9911,California
Colusa,2021-07-23,64,17902,44,4336,20,12817,0,749,36,1281,28,8666,36,9947,California
Colusa,2021-07-24,20,17922,14,4350,6,12823,0,749,18,1297,2,8668,18,9965,California
Colusa,2021-07-25,15,17937,11,4361,4,12827,0,749,13,1308,2,8670,13,9978,California
Colusa,2021-07-26,23,17960,13,4374,10,12837,0,749,17,1319,6,8676,17,9995,California
Colusa,2021-07-27,52,18012,32,4406,20,12857,0,749,29,1325,23,8699,29,10024,California
Colusa,2021-07-28,64,18076,40,4446,23,12880,1,750,28,1318,36,8735,29,10053,California
Colusa,2021-07-29,33,18109,19,4465,12,12892,2,752,21,1329,12,8747,23,10076,California
Colusa,2021-07-30,55,18164,37,4502,17,12909,1,753,37,1350,17,8764,38,10114,California
Colusa,2021-07-31,39,18203,25,4527,14,12923,0,753,31,1373,8,8772,31,10145,California
Colusa,2021-08-01,19,18222,8,4535,11,12934,0,753,19,1392,0,8772,19,10164,California
Colusa,2021-08-02,29,18251,18,4553,9,12943,2,755,22,1409,7,8779,24,10188,California
Colusa,2021-08-03,48,18299,29,4582,19,12962,0,755,27,1416,20,8799,27,10215,California
Colusa,2021-08-04,63,18362,23,4605,39,13001,1,756,38,1430,25,8824,39,10254,California
Colusa,2021-08-05,22,18384,11,4616,10,13011,1,757,8,1426,13,8837,9,10263,California
Colusa,2021-08-06,61,18445,36,4652,24,13035,1,758,39,1444,22,8859,40,10303,California
Colusa,2021-08-07,33,18478,16,4668,16,13051,1,759,20,1452,13,8872,21,10324,California
Colusa,2021-08-08,29,18507,24,4692,5,13056,0,759,27,1477,2,8874,27,10351,California
Colusa,2021-08-09,37,18544,16,4708,21,13077,0,759,26,1492,11,8885,26,10377,California
Colusa,2021-08-10,49,18593,27,4735,20,13097,2,761,22,1489,27,8912,24,10401,California
Colusa,2021-08-11,77,18670,47,4782,29,13126,1,762,44,1501,33,8945,45,10446,California
Colusa,2021-08-12,54,18724,30,4812,22,13148,2,764,31,1512,22,8967,33,10479,California
Colusa,2021-08-13,77,18801,54,4866,22,13170,1,765,45,1528,30,8997,46,10525,California
Colusa,2021-08-14,55,18856,41,4907,14,13184,0,765,35,1545,18,9015,35,10560,California
Colusa,2021-08-15,41,18897,22,4929,19,13203,0,765,28,1561,12,9027,28,10588,California
Colusa,2021-08-16,67,18964,43,4972,24,13227,0,765,45,1586,20,9047,45,10633,California
Colusa,2021-08-17,47,19011,28,5000,19,13246,0,765,26,1591,21,9068,26,10659,California
Colusa,2021-08-18,63,19074,41,5041,22,13268,0,765,38,1605,24,9092,38,10697,California
Colusa,2021-08-19,48,19122,33,5074,15,13283,0,765,30,1618,17,9109,30,10727,California
Colusa,2021-08-20,66,19188,42,5116,23,13306,1,766,29,1615,33,9142,30,10757,California
Colusa,2021-08-21,42,19230,33,5149,9,13315,0,766,17,1607,25,9167,17,10774,California
Colusa,2021-08-22,39,19269,24,5173,14,13329,1,767,27,1623,12,9179,28,10802,California
Colusa,2021-08-23,65,19334,38,5211,24,13353,3,770,33,1627,32,9211,36,10838,California
Colusa,2021-08-24,49,19383,31,5242,18,13371,0,770,28,1634,21,9232,28,10866,California
Colusa,2021-08-25,76,19459,47,5289,28,13399,1,771,44,1650,29,9261,45,10911,California
Colusa,2021-08-26,35,19494,18,5307,15,13414,2,773,20,1660,12,9273,22,10933,California
Colusa,2021-08-27,68,19562,40,5347,23,13437,5,778,32,1661,35,9308,36,10969,California
Colusa,2021-08-28,48,19610,35,5382,13,13450,0,778,22,1662,21,9329,22,10991,California
Colusa,2021-08-29,45,19655,27,5409,18,13468,0,778,22,1661,23,9352,22,11013,California
Colusa,2021-08-30,18,19673,3,5412,14,13482,1,779,11,1666,7,9359,12,11025,California
Contra Costa,2020-12-15,21,21,21,21,0,0,0,0,21,21,0,0,21,21,California
Contra Costa,2020-12-16,536,557,536,557,0,0,0,0,537,558,0,0,537,558,California
Contra Costa,2020-12-17,1076,1633,1076,1633,0,0,0,0,1075,1633,0,0,1075,1633,California
Contra Costa,2020-12-18,1817,3450,1815,3448,2,2,0,0,1823,3456,0,0,1823,3456,California
Contra Costa,2020-12-19,1150,4600,1149,4597,1,3,0,0,1152,4608,0,0,1152,4608,California
Contra Costa,2020-12-20,625,5225,623,5220,2,5,0,0,623,5231,0,0,623,5231,California
Contra Costa,2020-12-21,1710,6935,1707,6927,3,8,0,0,1710,6941,0,0,1710,6941,California
Contra Costa,2020-12-22,1719,8654,1606,8533,113,121,0,0,1720,8660,1,1,1720,8661,California
Contra Costa,2020-12-23,1695,10349,1430,9963,265,386,0,0,1692,10352,0,1,1692,10353,California
Contra Costa,2020-12-24,679,11028,349,10312,330,716,0,0,682,11034,0,1,682,11035,California
Contra Costa,2020-12-25,46,11074,20,10332,26,742,0,0,47,11081,0,1,47,11082,California
Contra Costa,2020-12-26,679,11753,142,10474,537,1279,0,0,679,11760,0,1,679,11761,California
Contra Costa,2020-12-27,247,12000,89,10563,158,1437,0,0,247,12007,0,1,247,12008,California
Contra Costa,2020-12-28,1897,13897,887,11450,1010,2447,0,0,1898,13905,0,1,1898,13906,California
Contra Costa,2020-12-29,1933,15830,875,12325,1058,3505,0,0,1934,15839,0,1,1934,15840,California
Contra Costa,2020-12-30,2516,18346,1265,13590,1251,4756,0,0,2514,18352,2,3,2515,18355,California
Contra Costa,2020-12-31,952,19298,313,13903,639,5395,0,0,950,19302,0,3,950,19305,California
Contra Costa,2021-01-01,72,19370,26,13929,46,5441,0,0,72,19374,0,3,72,19377,California
Contra Costa,2021-01-02,355,19725,183,14112,172,5613,0,0,352,19726,0,3,352,19729,California
Contra Costa,2021-01-03,191,19916,129,14241,62,5675,0,0,189,19915,0,3,189,19918,California
Contra Costa,2021-01-04,1934,21850,1255,15496,679,6354,0,0,1915,21814,16,19,1915,21833,California
Contra Costa,2021-01-05,2163,24013,1293,16789,870,7224,0,0,1872,23396,291,310,1873,23706,California
Contra Costa,2021-01-06,3381,27394,2310,19099,1071,8295,0,0,2533,25088,844,1154,2536,26242,California
Contra Costa,2021-01-07,3194,30588,2138,21237,1056,9351,0,0,1830,25555,1363,2517,1830,28072,California
Contra Costa,2021-01-08,3496,34084,2473,23710,1023,10374,0,0,1793,25653,1698,4215,1796,29868,California
Contra Costa,2021-01-09,1626,35710,1164,24874,462,10836,0,0,750,25525,881,5096,753,30621,California
Contra Costa,2021-01-10,399,36109,315,25189,84,10920,0,0,170,25466,229,5325,170,30791,California
Contra Costa,2021-01-11,3949,40058,3236,28425,713,11633,0,0,2260,26038,1692,7017,2264,33055,California
Contra Costa,2021-01-12,4029,44087,3014,31439,1015,12648,0,0,2653,27316,1379,8396,2657,35712,California
Contra Costa,2021-01-13,4888,48975,3036,34475,1852,14500,0,0,3891,30212,996,9392,3892,39604,California
Contra Costa,2021-01-14,4429,53404,1614,36089,2815,17315,0,0,4024,33827,409,9801,4024,43628,California
Contra Costa,2021-01-15,5471,58875,2515,38604,2956,20271,0,0,5133,38622,341,10142,5136,48764,California
Contra Costa,2021-01-16,1797,60672,590,39194,1207,21478,0,0,1709,40243,88,10230,1709,50473,California
Contra Costa,2021-01-17,1690,62362,993,40187,697,22175,0,0,1553,41662,137,10367,1556,52029,California
Contra Costa,2021-01-18,3328,65690,1339,41526,1989,24164,0,0,2675,43688,650,11017,2676,54705,California
Contra Costa,2021-01-19,7169,72859,3217,44743,3952,28116,0,0,6096,48722,1068,12085,6102,60807,California
Contra Costa,2021-01-20,7014,79873,4373,49116,2641,30757,0,0,5743,53206,1265,13350,5749,66556,California
Contra Costa,2021-01-21,7179,87052,3186,52302,3993,34750,0,0,6420,58880,754,14104,6428,72984,California
Contra Costa,2021-01-22,6541,93593,2775,55077,3766,38516,0,0,5651,63646,888,14992,5654,78638,California
Contra Costa,2021-01-23,2112,95705,370,55447,1742,40258,0,0,1831,65202,277,15269,1833,80471,California
Contra Costa,2021-01-24,1662,97367,228,55675,1434,41692,0,0,1507,66558,155,15424,1511,81982,California
Contra Costa,2021-01-25,6811,104178,3084,58759,3727,45419,0,0,5182,70118,1626,17050,5186,87168,California
Contra Costa,2021-01-26,8290,112468,4770,63529,3520,48939,0,0,6358,74561,1921,18971,6364,93532,California
Contra Costa,2021-01-27,8372,120840,5482,69011,2890,51829,0,0,6452,79108,1909,20880,6456,99988,California
Contra Costa,2021-01-28,7647,128487,4139,73150,3508,55337,0,0,5969,83409,1674,22554,5975,105963,California
Contra Costa,2021-01-29,7636,136123,3951,77101,3685,59022,0,0,6260,88302,1369,23923,6262,112225,California
Contra Costa,2021-01-30,2203,138326,672,77773,1531,60553,0,0,1785,89678,409,24332,1785,114010,California
Contra Costa,2021-01-31,703,139029,462,78235,241,60794,0,0,595,90171,102,24434,595,114605,California
Contra Costa,2021-02-01,5965,144994,4116,82351,1849,62643,0,0,4014,92249,1942,26376,4020,118625,California
Contra Costa,2021-02-02,7749,152743,5164,87515,2585,65228,0,0,5995,96499,1747,28123,5997,124622,California
Contra Costa,2021-02-03,8505,161248,5589,93104,2916,68144,0,0,5730,99463,2767,30890,5731,130353,California
Contra Costa,2021-02-04,7698,168946,3655,96759,4043,72187,0,0,5881,103537,1813,32703,5887,136240,California
Contra Costa,2021-02-05,8657,177603,4916,101675,3741,75928,0,0,5879,106651,2765,35468,5879,142119,California
Contra Costa,2021-02-06,3589,181192,2211,103886,1378,77306,0,0,2910,108887,675,36143,2911,145030,California
Contra Costa,2021-02-07,1015,182207,732,104618,283,77589,0,0,607,109087,407,36550,607,145637,California
Contra Costa,2021-02-08,6029,188236,3575,108193,2454,80043,0,0,4451,111966,1574,38124,4453,150090,California
Contra Costa,2021-02-09,8921,197157,4923,113116,3998,84041,0,0,5924,114904,2987,41111,5925,156015,California
Contra Costa,2021-02-10,8887,206044,4784,117900,4103,88144,0,0,5420,116876,3452,44563,5424,161439,California
Contra Costa,2021-02-11,9596,215640,4331,122231,5265,93409,0,0,5278,117846,4313,48876,5283,166722,California
Contra Costa,2021-02-12,10342,225982,4719,126950,5623,99032,0,0,5562,118640,4772,53648,5566,172288,California
Contra Costa,2021-02-13,5020,231002,1415,128365,3605,102637,0,0,3491,120605,1527,55175,3492,175780,California
Contra Costa,2021-02-14,2150,233152,894,129259,1256,103893,0,0,1251,120961,895,56070,1251,177031,California
Contra Costa,2021-02-15,4591,237743,2530,131789,2061,105954,0,0,2373,121127,2208,58278,2374,179405,California
Contra Costa,2021-02-16,10651,248394,5022,136811,5629,111583,0,0,4745,119983,5893,64171,4749,184154,California
Contra Costa,2021-02-17,12612,261006,6332,143143,6280,117863,0,0,5777,118950,6812,70983,5779,189933,California
Contra Costa,2021-02-18,11761,272767,6114,149257,5647,123510,0,0,5409,118029,6332,77315,5411,195344,California
Contra Costa,2021-02-19,11759,284526,7327,156584,4432,127942,0,0,5304,116901,6435,83750,5307,200651,California
Contra Costa,2021-02-20,6730,291256,3070,159654,3660,131602,0,0,4737,119667,1975,85725,4741,205392,California
Contra Costa,2021-02-21,2445,293701,1810,161464,635,132237,0,0,1611,120449,829,86554,1611,207003,California
Contra Costa,2021-02-22,8149,301850,5524,166988,2625,134862,0,0,3756,119832,4376,90930,3759,210762,California
Contra Costa,2021-02-23,12714,314564,7843,174831,4871,139733,0,0,6404,119955,6289,97219,6412,217174,California
Contra Costa,2021-02-24,11260,325824,8269,183100,2991,142724,0,0,5462,119649,5768,102987,5462,222636,California
Contra Costa,2021-02-25,12452,338276,7876,190976,4576,147300,0,0,5729,118689,6696,109683,5736,228372,California
Contra Costa,2021-02-26,11683,349959,7397,198373,4286,151586,0,0,5790,118608,5874,115557,5793,234165,California
Contra Costa,2021-02-27,7298,357257,4715,203088,2583,154169,0,0,4573,120470,2713,118270,4575,238740,California
Contra Costa,2021-02-28,4588,361845,3811,206899,776,154945,1,1,3838,123566,744,119014,3840,242580,California
Contra Costa,2021-03-01,9147,370992,6908,213807,2229,157174,10,11,5662,125787,3455,122469,5676,248256,California
Contra Costa,2021-03-02,11198,382190,7172,220979,4025,161199,1,12,5961,126540,5211,127680,5964,254220,California
Contra Costa,2021-03-03,11868,394058,7488,228467,4379,165578,1,13,6693,128085,5151,132831,6696,260916,California
Contra Costa,2021-03-04,12461,406519,7463,235930,4996,170574,2,15,6455,128563,5980,138811,6458,267374,California
Contra Costa,2021-03-05,11910,418429,7146,243076,4752,175326,12,27,6811,130305,5080,143891,6822,274196,California
Contra Costa,2021-03-06,7721,426150,4319,247395,3085,178411,317,344,5037,132980,2669,146560,5344,279540,California
Contra Costa,2021-03-07,4155,430305,2547,249942,1416,179827,192,536,3303,135622,846,147406,3488,283028,California
Contra Costa,2021-03-08,8523,438828,4042,253984,4148,183975,333,869,5734,138906,2774,150180,6058,289086,California
Contra Costa,2021-03-09,11474,450302,6083,260067,5083,189058,308,1177,6005,139763,5450,155630,6307,295393,California
Contra Costa,2021-03-10,12822,463124,6447,266514,4853,193911,1522,2699,5861,140167,6941,162571,7345,302738,California
Contra Costa,2021-03-11,12839,475963,6746,273260,5509,199420,584,3283,6563,141049,6243,168814,7125,309863,California
Contra Costa,2021-03-12,12990,488953,5347,278607,7050,206470,593,3876,6478,141606,6487,175301,7044,316907,California
Contra Costa,2021-03-13,8109,497062,3290,281897,4379,210849,440,4316,3193,140330,4894,180195,3618,320525,California
Contra Costa,2021-03-14,4570,501632,2694,284591,1372,212221,504,4820,1771,139803,2787,182982,2260,322785,California
Contra Costa,2021-03-15,9734,511366,5305,289896,3653,215874,776,5596,4770,140398,4939,187921,5534,328319,California
Contra Costa,2021-03-16,14706,526072,8785,298681,5505,221379,416,6012,7189,140512,7483,195404,7597,335916,California
Contra Costa,2021-03-17,15501,541573,10701,309382,4564,225943,236,6248,8599,142477,6871,202275,8836,344752,California
Contra Costa,2021-03-18,15753,557326,8818,318200,6446,232389,489,6737,8631,144507,7081,209356,9111,353863,California
Contra Costa,2021-03-19,16078,573404,9303,327503,5329,237718,1446,8183,8226,146345,7826,217182,9664,363527,California
Contra Costa,2021-03-20,11024,584428,6618,334121,4079,241797,327,8510,5142,145962,5851,223033,5468,368995,California
Contra Costa,2021-03-21,4746,589174,4140,338261,503,242300,103,8613,1807,144944,2923,225956,1905,370900,California
Contra Costa,2021-03-22,11987,601161,9032,347293,2692,244992,263,8876,6878,146992,5084,231040,7132,378032,California
Contra Costa,2021-03-23,16105,617266,11088,358381,4839,249831,178,9054,9199,149486,6878,237918,9372,387404,California
Contra Costa,2021-03-24,15466,632732,12056,370437,3195,253026,215,9269,9251,152784,6171,244089,9469,396873,California
Contra Costa,2021-03-25,15817,648549,12314,382751,3205,256231,298,9567,9599,156501,6170,250259,9887,406760,California
Contra Costa,2021-03-26,15473,664022,11100,393851,3965,260196,408,9975,8845,159149,6595,256854,9243,416003,California
Contra Costa,2021-03-27,10869,674891,7074,400925,3270,263466,525,10500,5745,160293,5112,261966,6256,422259,California
Contra Costa,2021-03-28,4381,679272,3119,404044,1205,264671,57,10557,1660,159304,2706,264672,1717,423976,California
Contra Costa,2021-03-29,11251,690523,8743,412787,2386,267057,122,10679,7088,162383,4131,268803,7210,431186,California
Contra Costa,2021-03-30,17268,707791,9477,422264,6424,273481,1367,12046,10637,167758,6602,275405,11977,443163,California
Contra Costa,2021-03-31,18544,726335,13021,435285,4064,277545,1459,13505,11631,173969,6855,282260,13066,456229,California
Contra Costa,2021-04-01,18017,744352,12579,447864,4010,281555,1428,14933,11614,180630,6351,288611,13012,469241,California
Contra Costa,2021-04-02,17940,762292,13180,461044,3706,285261,1054,15987,11846,187437,6077,294688,12884,482125,California
Contra Costa,2021-04-03,11106,773398,6622,467666,2910,288171,1574,17561,6328,190553,4762,299450,7878,490003,California
Contra Costa,2021-04-04,3465,776863,1362,469028,1480,289651,623,18184,859,189431,2598,302048,1476,491479,California
Contra Costa,2021-04-05,12402,789265,8045,477073,3353,293004,1004,19188,6678,191399,5707,307755,7675,499154,California
Contra Costa,2021-04-06,17739,807004,12281,489354,3136,296140,2322,21510,9934,195850,7779,315534,12230,511384,California
Contra Costa,2021-04-07,18926,825930,12811,502165,3269,299409,2846,24356,10707,201224,8190,323724,13564,524948,California
Contra Costa,2021-04-08,19058,844988,12695,514860,3412,302821,2951,27307,10204,205533,8816,332540,13125,538073,California
Contra Costa,2021-04-09,19254,864242,12234,527094,4480,307301,2540,29847,10249,209339,8965,341505,12771,550844,California
Contra Costa,2021-04-10,10811,875053,3920,531014,2258,309559,4633,34480,3393,209928,7393,348898,7982,558826,California
Contra Costa,2021-04-11,3483,878536,2069,533083,730,310289,684,35164,1168,209469,2307,351205,1848,560674,California
Contra Costa,2021-04-12,12257,890793,8065,541148,3092,313381,1100,36264,5725,209781,6509,357714,6821,567495,California
Contra Costa,2021-04-13,18269,909062,11236,552384,7025,320406,8,36272,12143,215845,6096,363810,12160,579655,California
Contra Costa,2021-04-14,18060,927122,11363,563747,6693,327099,4,36276,9971,217762,8064,371874,9981,589636,California
Contra Costa,2021-04-15,17865,944987,10989,574736,6873,333972,3,36279,8250,216466,9577,381451,8281,597917,California
Contra Costa,2021-04-16,17281,962268,10758,585494,6521,340493,2,36281,7726,214684,9522,390973,7740,605657,California
Contra Costa,2021-04-17,11783,974051,6500,591994,5282,345775,1,36282,6312,215557,5447,396420,6320,611977,California
Contra Costa,2021-04-18,3032,977083,2360,594354,671,346446,1,36283,1893,216322,1129,397549,1894,613871,California
Contra Costa,2021-04-19,11684,988767,8710,603064,2974,349420,0,36283,3649,211972,8005,405554,3655,617526,California
Contra Costa,2021-04-20,17217,1005984,11223,614287,5994,355414,0,36283,6381,207561,10798,416352,6387,623913,California
Contra Costa,2021-04-21,18124,1024108,14803,629090,3320,358734,1,36284,6418,202339,11652,428004,6430,630343,California
Contra Costa,2021-04-22,17831,1041939,14442,643532,3386,362120,3,36287,6295,197156,11491,439495,6308,636651,California
Contra Costa,2021-04-23,17668,1059607,14067,657599,3599,365719,2,36289,5677,190897,11947,451442,5688,642339,California
Contra Costa,2021-04-24,11282,1070889,8680,666279,2601,368320,1,36290,4337,188323,6917,458359,4343,646682,California
Contra Costa,2021-04-25,3375,1074264,2267,668546,1105,369425,3,36293,2105,189170,1265,459624,2112,648794,California
Contra Costa,2021-04-26,10394,1084658,8644,677190,1723,371148,27,36320,3133,185109,7235,466859,3174,651968,California
Contra Costa,2021-04-27,15101,1099759,11037,688227,3886,375034,178,36498,4139,178502,10934,477793,4327,656295,California
Contra Costa,2021-04-28,14680,1114439,11425,699652,2965,377999,290,36788,3955,172078,10678,488471,4254,660549,California
Contra Costa,2021-04-29,13917,1128356,10784,710436,2959,380958,174,36962,3359,165092,10525,498996,3539,664088,California
Contra Costa,2021-04-30,14270,1142626,11217,721653,2791,383749,262,37224,3300,157724,10935,509931,3567,667655,California
Contra Costa,2021-05-01,8275,1150901,5996,727649,1952,385701,327,37551,1971,153753,6271,516202,2300,669955,California
Contra Costa,2021-05-02,2417,1153318,1641,729290,695,386396,81,37632,1008,153446,1396,517598,1089,671044,California
Contra Costa,2021-05-03,9330,1162648,8177,737467,972,387368,181,37813,1965,148254,7342,524940,2150,673194,California
Contra Costa,2021-05-04,14535,1177183,12544,750011,1657,389025,334,38147,2379,138846,12121,537061,2713,675907,California
Contra Costa,2021-05-05,12975,1190158,11199,761210,1569,390594,207,38354,2491,131098,10445,547506,2697,678604,California
Contra Costa,2021-05-06,10633,1200791,8844,770054,1447,392041,342,38696,2008,124867,8590,556096,2359,680963,California
Contra Costa,2021-05-07,9923,1210714,7966,778020,1727,393768,230,38926,2278,119763,7609,563705,2505,683468,California
Contra Costa,2021-05-08,5606,1216320,4253,782273,1181,394949,172,39098,1347,117052,4236,567941,1525,684993,California
Contra Costa,2021-05-09,2199,1218519,1858,784131,279,395228,62,39160,454,115834,1735,569676,517,685510,California
Contra Costa,2021-05-10,5088,1223607,4073,788204,792,396020,223,39383,1359,113708,3707,573383,1581,687091,California
Contra Costa,2021-05-11,9129,1232736,4838,793042,4047,400067,244,39627,1786,108422,7322,580705,2036,689127,California
Contra Costa,2021-05-12,9500,1242236,4904,797946,4323,404390,273,39900,1625,102478,7848,588553,1904,691031,California
Contra Costa,2021-05-13,12072,1254308,8096,806042,3789,408179,187,40087,4321,99272,7718,596271,4512,695543,California
Contra Costa,2021-05-14,12530,1266838,8402,814444,3840,412019,288,40375,5123,97310,7370,603641,5408,700951,California
Contra Costa,2021-05-15,10313,1277151,7512,821956,2681,414700,120,40495,4523,96189,5767,609408,4646,705597,California
Contra Costa,2021-05-16,2717,1279868,2391,824347,275,414975,51,40546,1246,96021,1464,610872,1296,706893,California
Contra Costa,2021-05-17,7255,1287123,5852,830199,1220,416195,183,40729,3605,96185,3627,614499,3791,710684,California
Contra Costa,2021-05-18,10464,1297587,7138,837337,3104,419299,222,40951,4479,94941,5951,620450,4707,715391,California
Contra Costa,2021-05-19,8636,1306223,6967,844304,1470,420769,199,41150,3868,94277,4735,625185,4071,719462,California
Contra Costa,2021-05-20,7302,1313525,5753,850057,1360,422129,189,41339,3347,93892,3921,629106,3536,722998,California
Contra Costa,2021-05-21,7271,1320796,5561,855618,1490,423619,220,41559,3281,93432,3959,633065,3499,726497,California
Contra Costa,2021-05-22,5282,1326078,4177,859795,925,424544,180,41739,2568,93489,2688,635753,2745,729242,California
Contra Costa,2021-05-23,1287,1327365,860,860655,369,424913,58,41797,604,93476,674,636427,661,729903,California
Contra Costa,2021-05-24,4833,1332198,3994,864649,659,425572,180,41977,2258,93357,2561,638988,2442,732345,California
Contra Costa,2021-05-25,6452,1338650,5246,869895,949,426521,257,42234,2696,92575,3735,642723,2953,735298,California
Contra Costa,2021-05-26,5776,1344426,3719,873614,1862,428383,195,42429,1991,90995,3766,646489,2186,737484,California
Contra Costa,2021-05-27,3890,1348316,2753,876367,958,429341,179,42608,1609,90514,2264,648753,1783,739267,California
Contra Costa,2021-05-28,5502,1353818,3837,880204,1491,430832,174,42782,2280,89772,3195,651948,2453,741720,California
Contra Costa,2021-05-29,3380,1357198,2210,882414,1051,431883,119,42901,1652,89828,1715,653663,1771,743491,California
Contra Costa,2021-05-30,959,1358157,611,883025,319,432202,29,42930,352,89605,604,654267,381,743872,California
Contra Costa,2021-05-31,407,1358564,283,883308,109,432311,15,42945,130,89478,271,654538,144,744016,California
Contra Costa,2021-06-01,4898,1363462,3643,886951,1108,433419,147,43092,1687,88122,3190,657728,1834,745850,California
Contra Costa,2021-06-02,3514,1366976,2493,889444,873,434292,148,43240,1432,87631,2070,659798,1579,747429,California
Contra Costa,2021-06-03,5571,1372547,4638,894082,812,435104,121,43361,1435,85060,4127,663925,1556,748985,California
Contra Costa,2021-06-04,6580,1379127,5527,899609,911,436015,142,43503,1636,81913,4920,668845,1773,750758,California
Contra Costa,2021-06-05,5327,1384454,4521,904130,693,436708,113,43616,1089,78891,4223,673068,1201,751959,California
Contra Costa,2021-06-06,1395,1385849,1220,905350,145,436853,30,43646,324,78177,1068,674136,354,752313,California
Contra Costa,2021-06-07,5026,1390875,4421,909771,503,437356,102,43748,1374,76017,3637,677773,1477,753790,California
Contra Costa,2021-06-08,6136,1397011,5290,915061,722,438078,124,43872,1416,72856,4702,682475,1541,755331,California
Contra Costa,2021-06-09,4911,1401922,4189,919250,574,438652,148,44020,1259,70632,3631,686106,1407,756738,California
Contra Costa,2021-06-10,4867,1406789,4085,923335,610,439262,172,44192,1248,68448,3604,689710,1420,758158,California
Contra Costa,2021-06-11,4907,1411696,4022,927357,682,439944,203,44395,1279,66317,3612,693322,1481,759639,California
Contra Costa,2021-06-12,3244,1414940,2755,930112,419,440363,70,44465,729,64611,2503,695825,797,760436,California
Contra Costa,2021-06-13,1164,1416104,869,930981,186,440549,109,44574,285,64133,872,696697,394,760830,California
Contra Costa,2021-06-14,3991,1420095,3365,934346,491,441040,135,44709,1168,62629,2804,699501,1300,762130,California
Contra Costa,2021-06-15,4265,1424360,3558,937904,545,441585,162,44871,1331,61200,2921,702422,1492,763622,California
Contra Costa,2021-06-16,3564,1427924,2914,940818,460,442045,190,45061,1241,60323,2305,704727,1428,765050,California
Contra Costa,2021-06-17,2815,1430739,2308,943126,380,442425,127,45188,1079,59800,1727,706454,1204,766254,California
Contra Costa,2021-06-18,3709,1434448,3050,946176,468,442893,191,45379,1320,58925,2377,708831,1502,767756,California
Contra Costa,2021-06-19,2054,1436502,1718,947894,230,443123,106,45485,574,58130,1476,710307,681,768437,California
Contra Costa,2021-06-20,795,1437297,669,948563,98,443221,28,45513,331,58028,460,710767,358,768795,California
Contra Costa,2021-06-21,1834,1439131,1393,949956,283,443504,158,45671,974,58308,852,711619,1132,769927,California
Contra Costa,2021-06-22,3063,1442194,2590,952546,333,443837,140,45811,1188,57776,1859,713478,1327,771254,California
Contra Costa,2021-06-23,2582,1444776,2139,954685,340,444177,103,45914,1026,57361,1544,715022,1129,772383,California
Contra Costa,2021-06-24,2379,1447155,1998,956683,252,444429,129,46043,944,57012,1420,716442,1071,773454,California
Contra Costa,2021-06-25,2802,1449957,2287,958970,360,444789,155,46198,1126,56626,1668,718110,1282,774736,California
Contra Costa,2021-06-26,1508,1451465,1236,960206,174,444963,98,46296,494,56206,1012,719122,592,775328,California
Contra Costa,2021-06-27,713,1452178,624,960830,67,445030,22,46318,274,56066,436,719558,296,775624,California
Contra Costa,2021-06-28,2399,1454577,2066,962896,181,445211,152,46470,862,55557,1522,721080,1013,776637,California
Contra Costa,2021-06-29,2589,1457166,2160,965056,297,445508,132,46602,1008,55126,1570,722650,1139,777776,California
Contra Costa,2021-06-30,2225,1459391,1812,966868,311,445819,102,46704,917,54846,1296,723946,1016,778792,California
Contra Costa,2021-07-01,2144,1461535,1796,968664,238,446057,110,46814,880,54585,1254,725200,993,779785,California
Contra Costa,2021-07-02,2242,1463777,1834,970498,305,446362,103,46917,939,54336,1290,726490,1041,780826,California
Contra Costa,2021-07-03,1094,1464871,896,971394,139,446501,59,46976,443,54193,644,727134,501,781327,California
Contra Costa,2021-07-04,56,1464927,22,971416,19,446520,15,46991,20,54192,36,727170,35,781362,California
Contra Costa,2021-07-05,843,1465770,696,972112,107,446627,40,47031,407,54206,433,727603,447,781809,California
Contra Costa,2021-07-06,2706,1468476,2294,974406,280,446907,132,47163,909,53466,1780,729383,1040,782849,California
Contra Costa,2021-07-07,2060,1470536,1720,976126,229,447136,111,47274,782,53090,1266,730649,890,783739,California
Contra Costa,2021-07-08,1895,1472431,1594,977720,208,447344,93,47367,802,52904,1081,731730,895,784634,California
Contra Costa,2021-07-09,2383,1474814,1914,979634,349,447693,120,47487,945,52543,1424,733154,1063,785697,California
Contra Costa,2021-07-10,989,1475803,821,980455,120,447813,48,47535,409,52429,569,733723,455,786152,California
Contra Costa,2021-07-11,695,1476498,471,980926,142,447955,82,47617,283,52384,410,734133,365,786517,California
Contra Costa,2021-07-12,2124,1478622,1852,982778,199,448154,73,47690,890,52122,1223,735356,961,787478,California
Contra Costa,2021-07-13,2089,1480711,1785,984563,232,448386,72,47762,850,51821,1227,736583,926,788404,California
Contra Costa,2021-07-14,1837,1482548,1540,986103,219,448605,78,47840,788,51649,1038,737621,866,789270,California
Contra Costa,2021-07-15,1741,1484289,1501,987604,167,448772,73,47913,826,51643,904,738525,898,790168,California
Contra Costa,2021-07-16,2166,1486455,1833,989437,240,449012,93,48006,1001,51581,1151,739676,1089,791257,California
Contra Costa,2021-07-17,1037,1487492,824,990261,163,449175,50,48056,497,51600,527,740203,546,791803,California
Contra Costa,2021-07-18,565,1488057,457,990718,69,449244,39,48095,287,51649,274,740477,323,792126,California
Contra Costa,2021-07-19,1858,1489915,1562,992280,210,449454,86,48181,951,51790,896,741373,1037,793163,California
Contra Costa,2021-07-20,2023,1491938,1711,993991,226,449680,86,48267,1007,51879,1004,742377,1093,794256,California
Contra Costa,2021-07-21,1922,1493860,1579,995570,264,449944,79,48346,1001,52059,900,743277,1080,795336,California
Contra Costa,2021-07-22,1972,1495832,1658,997228,237,450181,77,48423,1111,52396,850,744127,1187,796523,California
Contra Costa,2021-07-23,2244,1498076,1854,999082,292,450473,98,48521,1232,52727,996,745123,1327,797850,California
Contra Costa,2021-07-24,1204,1499280,979,1000061,165,450638,60,48581,604,52802,588,745711,663,798513,California
Contra Costa,2021-07-25,554,1499834,462,1000523,70,450708,22,48603,420,53113,130,745841,441,798954,California
Contra Costa,2021-07-26,2086,1501920,1760,1002283,239,450947,87,48690,1370,53879,693,746534,1459,800413,California
Contra Costa,2021-07-27,2416,1504336,2014,1004297,270,451217,132,48822,1386,54388,1008,747542,1517,801930,California
Contra Costa,2021-07-28,2224,1506560,1803,1006100,289,451506,132,48954,1243,54802,959,748501,1373,803303,California
Contra Costa,2021-07-29,2042,1508602,1700,1007800,237,451743,105,49059,1120,55127,899,749400,1224,804527,California
Contra Costa,2021-07-30,2513,1511115,2093,1009893,315,452058,105,49164,1430,55652,1007,750407,1532,806059,California
Contra Costa,2021-07-31,1174,1512289,981,1010874,166,452224,27,49191,706,55941,441,750848,730,806789,California
Contra Costa,2021-08-01,696,1512985,562,1011436,105,452329,29,49220,454,56190,234,751082,483,807272,California
Contra Costa,2021-08-02,2506,1515491,2093,1013529,329,452658,84,49304,1547,56874,946,752028,1630,808902,California
Contra Costa,2021-08-03,2606,1518097,2224,1015753,270,452928,112,49416,1618,57636,969,752997,1731,810633,California
Contra Costa,2021-08-04,2301,1520398,1968,1017721,238,453166,95,49511,1438,58321,847,753844,1532,812165,California
Contra Costa,2021-08-05,2420,1522818,2076,1019797,241,453407,103,49614,1484,58987,920,754764,1586,813751,California
Contra Costa,2021-08-06,2775,1525593,2302,1022099,370,453777,103,49717,1596,59543,1143,755907,1699,815450,California
Contra Costa,2021-08-07,1413,1527006,1159,1023258,176,453953,78,49795,888,60001,505,756412,963,816413,California
Contra Costa,2021-08-08,879,1527885,734,1023992,136,454089,9,49804,545,60223,333,756745,555,816968,California
Contra Costa,2021-08-09,2341,1530226,2049,1026041,221,454310,71,49875,1363,60697,958,757703,1432,818400,California
Contra Costa,2021-08-10,2537,1532763,2177,1028218,263,454573,97,49972,1520,61313,1001,758704,1617,820017,California
Contra Costa,2021-08-11,2234,1534997,1870,1030088,258,454831,106,50078,1266,61741,943,759647,1371,821388,California
Contra Costa,2021-08-12,2385,1537382,2015,1032103,254,455085,116,50194,1319,62138,1037,760684,1434,822822,California
Contra Costa,2021-08-13,3006,1540388,2518,1034621,350,455435,138,50332,1673,62663,1286,761970,1811,824633,California
Contra Costa,2021-08-14,1551,1541939,1193,1035814,287,455722,71,50403,730,62792,673,762643,802,825435,California
Contra Costa,2021-08-15,948,1542887,737,1036551,200,455922,11,50414,505,62972,336,762979,516,825951,California
Contra Costa,2021-08-16,2718,1545605,2149,1038700,464,456386,105,50519,1206,63064,1217,764196,1309,827260,California
Contra Costa,2021-08-17,2752,1548357,2206,1040906,445,456831,101,50620,1168,63096,1235,765431,1267,828527,California
Contra Costa,2021-08-18,2775,1551132,2215,1043121,444,457275,116,50736,1177,63193,1194,766625,1291,829818,California
Contra Costa,2021-08-19,2687,1553819,2084,1045205,498,457773,105,50841,1101,63312,1085,767710,1204,831022,California
Contra Costa,2021-08-20,3474,1557293,2695,1047900,665,458438,114,50955,1381,63361,1444,769154,1493,832515,California
Contra Costa,2021-08-21,1663,1558956,1287,1049187,343,458781,33,50988,680,63365,709,769863,713,833228,California
Contra Costa,2021-08-22,1061,1560017,882,1050069,168,458949,11,50999,482,63443,415,770278,493,833721,California
Contra Costa,2021-08-23,3173,1563190,2498,1052567,605,459554,70,51069,1201,63332,1383,771661,1272,834993,California
Contra Costa,2021-08-24,3412,1566602,2747,1055314,538,460092,127,51196,1209,63113,1554,773215,1335,836328,California
Contra Costa,2021-08-25,2930,1569532,2425,1057739,431,460523,74,51270,1110,63002,1295,774510,1184,837512,California
Contra Costa,2021-08-26,3081,1572613,2537,1060276,444,460967,100,51370,1186,62948,1340,775850,1286,838798,California
Contra Costa,2021-08-27,3548,1576161,2926,1063202,551,461518,71,51441,1234,62595,1660,777510,1307,840105,California
Contra Costa,2021-08-28,1680,1577841,1370,1064572,278,461796,32,51473,585,62416,795,778305,616,840721,California
Contra Costa,2021-08-29,1166,1579007,934,1065506,229,462025,3,51476,412,62265,565,778870,414,841135,California
Contra Costa,2021-08-30,2272,1581279,1742,1067248,444,462469,86,51562,734,62010,1075,779945,820,841955,California
Del Norte,2020-12-21,22,22,22,22,0,0,0,0,22,22,0,0,22,22,California
Del Norte,2020-12-22,48,70,48,70,0,0,0,0,48,70,0,0,48,70,California
Del Norte,2020-12-23,57,127,47,117,10,10,0,0,55,125,0,0,55,125,California
Del Norte,2020-12-28,36,163,36,153,0,10,0,0,36,161,0,0,36,161,California
Del Norte,2020-12-29,4,167,4,157,0,10,0,0,4,165,0,0,4,165,California
Del Norte,2020-12-30,68,235,56,213,12,22,0,0,68,233,0,0,68,233,California
Del Norte,2020-12-31,16,251,13,226,3,25,0,0,16,249,0,0,16,249,California
Del Norte,2021-01-04,103,354,50,276,53,78,0,0,103,352,0,0,103,352,California
Del Norte,2021-01-05,32,386,0,276,32,110,0,0,31,383,1,1,32,384,California
Del Norte,2021-01-06,77,463,18,294,59,169,0,0,77,460,0,1,77,461,California
Del Norte,2021-01-07,21,484,1,295,20,189,0,0,21,481,0,1,21,482,California
Del Norte,2021-01-08,79,563,7,302,72,261,0,0,79,560,0,1,79,561,California
Del Norte,2021-01-11,39,602,20,322,19,280,0,0,18,558,21,22,19,580,California
Del Norte,2021-01-12,53,655,34,356,19,299,0,0,31,567,22,44,31,611,California
Del Norte,2021-01-13,87,742,43,399,44,343,0,0,53,586,34,78,53,664,California
Del Norte,2021-01-14,54,796,14,413,40,383,0,0,48,628,6,84,48,712,California
Del Norte,2021-01-15,106,902,17,430,89,472,0,0,95,712,11,95,95,807,California
Del Norte,2021-01-17,1,903,1,431,0,472,0,0,1,713,0,95,1,808,California
Del Norte,2021-01-18,2,905,0,431,2,474,0,0,2,715,0,95,2,810,California
Del Norte,2021-01-19,121,1026,58,489,63,537,0,0,78,750,43,138,78,888,California
Del Norte,2021-01-20,160,1186,85,574,75,612,0,0,96,782,64,202,96,984,California
Del Norte,2021-01-21,43,1229,40,614,3,615,0,0,32,803,11,213,32,1016,California
Del Norte,2021-01-22,19,1248,17,631,2,617,0,0,12,808,7,220,12,1028,California
Del Norte,2021-01-23,1,1249,0,631,1,618,0,0,1,809,0,220,1,1029,California
Del Norte,2021-01-24,1,1250,0,631,1,619,0,0,1,810,0,220,1,1030,California
Del Norte,2021-01-25,101,1351,83,714,18,637,0,0,56,821,45,265,56,1086,California
Del Norte,2021-01-26,19,1370,11,725,8,645,0,0,8,818,11,276,8,1094,California
Del Norte,2021-01-27,64,1434,21,746,43,688,0,0,61,876,3,279,61,1155,California
Del Norte,2021-01-28,294,1728,20,766,274,962,0,0,288,1159,5,284,288,1443,California
Del Norte,2021-01-29,66,1794,25,791,41,1003,0,0,45,1183,21,305,45,1488,California
Del Norte,2021-01-30,8,1802,1,792,7,1010,0,0,8,1191,0,305,8,1496,California
Del Norte,2021-02-01,40,1842,1,793,39,1049,0,0,25,1201,15,320,25,1521,California
Del Norte,2021-02-02,143,1985,33,826,110,1159,0,0,73,1207,68,388,74,1595,California
Del Norte,2021-02-03,131,2116,44,870,87,1246,0,0,74,1224,57,445,74,1669,California
Del Norte,2021-02-04,70,2186,28,898,42,1288,0,0,40,1234,30,475,40,1709,California
Del Norte,2021-02-05,183,2369,21,919,162,1450,0,0,117,1286,65,540,117,1826,California
Del Norte,2021-02-06,310,2679,3,922,307,1757,0,0,310,1596,0,540,310,2136,California
Del Norte,2021-02-07,1,2680,1,923,0,1757,0,0,1,1597,0,540,1,2137,California
Del Norte,2021-02-08,35,2715,1,924,34,1791,0,0,31,1624,4,544,31,2168,California
Del Norte,2021-02-09,9,2724,6,930,3,1794,0,0,2,1619,7,551,2,2170,California
Del Norte,2021-02-10,142,2866,20,950,122,1916,0,0,85,1648,56,607,85,2255,California
Del Norte,2021-02-11,176,3042,58,1008,118,2034,0,0,63,1598,113,720,63,2318,California
Del Norte,2021-02-12,125,3167,14,1022,111,2145,0,0,70,1613,55,775,70,2388,California
Del Norte,2021-02-13,3,3170,1,1023,2,2147,0,0,2,1614,1,776,2,2390,California
Del Norte,2021-02-14,4,3174,1,1024,3,2150,0,0,3,1616,1,777,3,2393,California
Del Norte,2021-02-15,5,3179,0,1024,5,2155,0,0,3,1617,2,779,3,2396,California
Del Norte,2021-02-16,135,3314,1,1025,134,2289,0,0,15,1512,120,899,15,2411,California
Del Norte,2021-02-17,92,3406,19,1044,73,2362,0,0,24,1469,67,966,24,2435,California
Del Norte,2021-02-18,77,3483,24,1068,53,2415,0,0,51,1494,26,992,51,2486,California
Del Norte,2021-02-19,43,3526,17,1085,26,2441,0,0,33,1517,10,1002,33,2519,California
Del Norte,2021-02-20,10,3536,7,1092,3,2444,0,0,7,1521,3,1005,7,2526,California
Del Norte,2021-02-21,1,3537,0,1092,1,2445,0,0,0,1520,1,1006,0,2526,California
Del Norte,2021-02-22,2,3539,0,1092,2,2447,0,0,2,1522,0,1006,2,2528,California
Del Norte,2021-02-23,112,3651,92,1184,20,2467,0,0,32,1475,79,1085,32,2560,California
Del Norte,2021-02-24,159,3810,103,1287,56,2523,0,0,84,1484,75,1160,84,2644,California
Del Norte,2021-02-25,500,4310,149,1436,351,2874,0,0,232,1450,266,1426,232,2876,California
Del Norte,2021-02-26,212,4522,175,1611,37,2911,0,0,165,1568,47,1473,165,3041,California
Del Norte,2021-02-27,153,4675,145,1756,7,2918,1,1,145,1706,8,1481,146,3187,California
Del Norte,2021-02-28,4,4679,1,1757,3,2921,0,1,4,1710,0,1481,4,3191,California
Del Norte,2021-03-01,29,4708,3,1760,26,2947,0,1,5,1692,23,1504,5,3196,California
Del Norte,2021-03-02,235,4943,154,1914,80,3027,1,2,200,1858,35,1539,201,3397,California
Del Norte,2021-03-03,182,5125,111,2025,71,3098,0,2,139,1954,43,1582,139,3536,California
Del Norte,2021-03-04,125,5250,87,2112,38,3136,0,2,95,2020,29,1611,95,3631,California
Del Norte,2021-03-05,127,5377,12,2124,115,3251,0,2,76,2045,51,1662,76,3707,California
Del Norte,2021-03-06,464,5841,76,2200,339,3590,49,51,162,1912,302,1964,169,3876,California
Del Norte,2021-03-07,1,5842,1,2201,0,3590,0,51,1,1913,0,1964,1,3877,California
Del Norte,2021-03-08,29,5871,0,2201,27,3617,2,53,6,1899,22,1986,8,3885,California
Del Norte,2021-03-09,193,6064,113,2314,77,3694,3,56,182,2073,11,1997,185,4070,California
Del Norte,2021-03-10,236,6300,94,2408,113,3807,29,85,133,2132,103,2100,162,4232,California
Del Norte,2021-03-11,150,6450,55,2463,90,3897,5,90,102,2191,48,2148,107,4339,California
Del Norte,2021-03-12,178,6628,88,2551,90,3987,0,90,123,2260,54,2202,123,4462,California
Del Norte,2021-03-13,95,6723,94,2645,1,3988,0,90,91,2347,4,2206,91,4553,California
Del Norte,2021-03-14,2,6725,0,2645,2,3990,0,90,0,2345,2,2208,0,4553,California
Del Norte,2021-03-15,39,6764,0,2645,39,4029,0,90,35,2376,4,2212,35,4588,California
Del Norte,2021-03-16,282,7046,134,2779,148,4177,0,90,259,2612,23,2235,259,4847,California
Del Norte,2021-03-17,284,7330,95,2874,187,4364,2,92,166,2662,118,2353,168,5015,California
Del Norte,2021-03-18,288,7618,107,2981,179,4543,2,94,139,2655,148,2501,141,5156,California
Del Norte,2021-03-19,267,7885,158,3139,103,4646,6,100,89,2572,178,2679,95,5251,California
Del Norte,2021-03-20,156,8041,153,3292,3,4649,0,100,11,2438,145,2824,11,5262,California
Del Norte,2021-03-21,5,8046,3,3295,2,4651,0,100,2,2437,3,2827,2,5264,California
Del Norte,2021-03-22,43,8089,2,3297,40,4691,1,101,39,2474,3,2830,40,5304,California
Del Norte,2021-03-23,335,8424,166,3463,150,4841,19,120,154,2467,179,3009,172,5476,California
Del Norte,2021-03-24,401,8825,107,3570,254,5095,40,160,229,2564,172,3181,269,5745,California
Del Norte,2021-03-25,195,9020,89,3659,106,5201,0,160,80,2530,114,3295,80,5825,California
Del Norte,2021-03-26,233,9253,112,3771,121,5322,0,160,194,2686,38,3333,194,6019,California
Del Norte,2021-03-27,108,9361,86,3857,5,5327,17,177,17,2629,91,3424,34,6053,California
Del Norte,2021-03-28,4,9365,2,3859,2,5329,0,177,1,2627,3,3427,1,6054,California
Del Norte,2021-03-29,56,9421,6,3865,34,5363,16,193,32,2651,24,3451,48,6102,California
Del Norte,2021-03-30,339,9760,120,3985,208,5571,11,204,127,2577,212,3663,138,6240,California
Del Norte,2021-03-31,358,10118,102,4087,238,5809,18,222,200,2639,156,3819,218,6458,California
Del Norte,2021-04-01,162,10280,58,4145,70,5879,34,256,68,2648,93,3912,102,6560,California
Del Norte,2021-04-02,233,10513,79,4224,105,5984,49,305,50,2565,183,4095,100,6660,California
Del Norte,2021-04-03,109,10622,84,4308,2,5986,23,328,6,2492,102,4197,29,6689,California
Del Norte,2021-04-04,4,10626,0,4308,0,5986,4,332,0,2492,4,4201,4,6693,California
Del Norte,2021-04-05,45,10671,3,4311,38,6024,4,336,39,2529,6,4207,43,6736,California
Del Norte,2021-04-06,379,11050,118,4429,224,6248,37,373,145,2482,230,4437,183,6919,California
Del Norte,2021-04-07,437,11487,115,4544,261,6509,61,434,289,2685,148,4585,351,7270,California
Del Norte,2021-04-08,231,11718,54,4598,107,6616,70,504,106,2736,125,4710,176,7446,California
Del Norte,2021-04-09,206,11924,46,4644,83,6699,77,581,99,2804,106,4816,174,7620,California
Del Norte,2021-04-10,47,11971,26,4670,4,6703,17,598,26,2826,21,4837,43,7663,California
Del Norte,2021-04-11,10,11981,3,4673,0,6703,7,605,1,2825,9,4846,8,7671,California
Del Norte,2021-04-12,28,12009,1,4674,10,6713,17,622,1,2817,26,4872,18,7689,California
Del Norte,2021-04-13,298,12307,49,4723,249,6962,0,622,154,2827,144,5016,154,7843,California
Del Norte,2021-04-14,332,12639,24,4747,308,7270,0,622,140,2780,192,5208,145,7988,California
Del Norte,2021-04-15,166,12805,30,4777,136,7406,0,622,45,2705,121,5329,46,8034,California
Del Norte,2021-04-16,161,12966,39,4816,122,7528,0,622,59,2664,101,5430,60,8094,California
Del Norte,2021-04-17,108,13074,76,4892,32,7560,0,622,102,2760,6,5436,102,8196,California
Del Norte,2021-04-18,6,13080,5,4897,1,7561,0,622,5,2764,1,5437,5,8201,California
Del Norte,2021-04-19,52,13132,6,4903,46,7607,0,622,9,2730,43,5480,9,8210,California
Del Norte,2021-04-20,207,13339,40,4943,167,7774,0,622,73,2669,134,5614,73,8283,California
Del Norte,2021-04-21,295,13634,24,4967,271,8045,0,622,68,2513,227,5841,71,8354,California
Del Norte,2021-04-22,119,13753,17,4984,102,8147,0,622,64,2522,55,5896,64,8418,California
Del Norte,2021-04-23,154,13907,23,5007,131,8278,0,622,40,2449,113,6009,40,8458,California
Del Norte,2021-04-24,27,13934,16,5023,11,8289,0,622,21,2464,6,6015,21,8479,California
Del Norte,2021-04-25,2,13936,0,5023,2,8291,0,622,2,2466,0,6015,2,8481,California
Del Norte,2021-04-26,32,13968,1,5024,31,8322,0,622,9,2453,22,6037,9,8490,California
Del Norte,2021-04-27,180,14148,19,5043,156,8478,5,627,50,2379,130,6167,56,8546,California
Del Norte,2021-04-28,352,14500,101,5144,246,8724,5,632,63,2161,287,6454,69,8615,California
Del Norte,2021-04-29,98,14598,10,5154,84,8808,4,636,27,2121,71,6525,31,8646,California
Del Norte,2021-04-30,92,14690,8,5162,74,8882,10,646,48,2136,43,6568,58,8704,California
Del Norte,2021-05-01,7,14697,2,5164,5,8887,0,646,5,2139,2,6570,5,8709,California
Del Norte,2021-05-02,8,14705,0,5164,8,8895,0,646,8,2147,0,6570,8,8717,California
Del Norte,2021-05-03,42,14747,4,5168,35,8930,3,649,2,2114,38,6608,5,8722,California
Del Norte,2021-05-04,223,14970,36,5204,182,9112,5,654,47,1990,176,6784,52,8774,California
Del Norte,2021-05-05,236,15206,21,5225,207,9319,8,662,60,1883,175,6959,68,8842,California
Del Norte,2021-05-06,113,15319,25,5250,75,9394,13,675,25,1833,88,7047,38,8880,California
Del Norte,2021-05-07,151,15470,27,5277,120,9514,4,679,30,1746,121,7168,34,8914,California
Del Norte,2021-05-08,64,15534,54,5331,8,9522,2,681,6,1696,58,7226,8,8922,California
Del Norte,2021-05-09,11,15545,5,5336,3,9525,3,684,4,1696,7,7233,7,8929,California
Del Norte,2021-05-10,25,15570,3,5339,18,9543,4,688,15,1705,10,7243,19,8948,California
Del Norte,2021-05-11,183,15753,51,5390,130,9673,2,690,37,1598,146,7389,39,8987,California
Del Norte,2021-05-12,154,15907,24,5414,120,9793,10,700,27,1509,126,7515,37,9024,California
Del Norte,2021-05-13,69,15976,30,5444,38,9831,1,701,38,1517,31,7546,39,9063,California
Del Norte,2021-05-14,78,16054,26,5470,51,9882,1,702,41,1522,37,7583,42,9105,California
Del Norte,2021-05-15,98,16152,55,5525,37,9919,6,708,54,1538,44,7627,60,9165,California
Del Norte,2021-05-16,12,16164,0,5525,11,9930,1,709,11,1549,1,7628,12,9177,California
Del Norte,2021-05-17,27,16191,4,5529,20,9950,3,712,15,1556,11,7639,18,9195,California
Del Norte,2021-05-18,133,16324,72,5601,61,10011,0,712,85,1593,48,7687,85,9280,California
Del Norte,2021-05-19,97,16421,14,5615,66,10077,17,729,35,1582,62,7749,51,9331,California
Del Norte,2021-05-20,99,16520,31,5646,65,10142,3,732,40,1567,58,7807,43,9374,California
Del Norte,2021-05-21,81,16601,34,5680,44,10186,3,735,44,1577,37,7844,47,9421,California
Del Norte,2021-05-22,24,16625,8,5688,16,10202,0,735,11,1576,12,7856,11,9432,California
Del Norte,2021-05-23,14,16639,5,5693,9,10211,0,735,7,1576,7,7863,7,9439,California
Del Norte,2021-05-24,26,16665,9,5702,17,10228,0,735,17,1584,9,7872,17,9456,California
Del Norte,2021-05-25,47,16712,5,5707,36,10264,6,741,17,1580,27,7899,23,9479,California
Del Norte,2021-05-26,119,16831,36,5743,74,10338,9,750,54,1579,64,7963,63,9542,California
Del Norte,2021-05-27,75,16906,29,5772,42,10380,4,754,35,1579,39,8002,39,9581,California
Del Norte,2021-05-28,53,16959,7,5779,38,10418,8,762,9,1552,44,8046,17,9598,California
Del Norte,2021-05-29,9,16968,1,5780,4,10422,4,766,3,1553,6,8052,7,9605,California
Del Norte,2021-05-30,6,16974,0,5780,6,10428,0,766,1,1549,5,8057,1,9606,California
Del Norte,2021-05-31,4,16978,2,5782,2,10430,0,766,3,1551,1,8058,3,9609,California
Del Norte,2021-06-01,52,17030,6,5788,40,10470,6,772,11,1527,41,8099,17,9626,California
Del Norte,2021-06-02,85,17115,11,5799,69,10539,5,777,21,1489,64,8163,26,9652,California
Del Norte,2021-06-03,65,17180,37,5836,26,10565,2,779,30,1486,35,8198,32,9684,California
Del Norte,2021-06-04,70,17250,24,5860,41,10606,5,784,20,1462,49,8247,25,9709,California
Del Norte,2021-06-05,1,17251,0,5860,1,10607,0,784,0,1461,1,8248,0,9709,California
Del Norte,2021-06-06,11,17262,5,5865,4,10611,2,786,7,1466,4,8252,9,9718,California
Del Norte,2021-06-07,42,17304,10,5875,27,10638,5,791,15,1459,27,8279,20,9738,California
Del Norte,2021-06-08,116,17420,82,5957,29,10667,5,796,35,1418,81,8360,40,9778,California
Del Norte,2021-06-09,61,17481,11,5968,43,10710,7,803,19,1402,42,8402,26,9804,California
Del Norte,2021-06-10,57,17538,27,5995,23,10733,7,810,12,1377,44,8446,19,9823,California
Del Norte,2021-06-11,60,17598,24,6019,27,10760,9,819,14,1354,46,8492,23,9846,California
Del Norte,2021-06-12,18,17616,3,6022,12,10772,3,822,3,1345,15,8507,6,9852,California
Del Norte,2021-06-13,61,17677,44,6066,13,10785,4,826,13,1314,48,8555,17,9869,California
Del Norte,2021-06-14,38,17715,15,6081,19,10804,4,830,16,1313,21,8576,20,9889,California
Del Norte,2021-06-15,38,17753,9,6090,21,10825,8,838,4,1291,34,8610,12,9901,California
Del Norte,2021-06-16,100,17853,37,6127,50,10875,13,851,23,1250,77,8687,36,9937,California
Del Norte,2021-06-17,33,17886,15,6142,15,10890,3,854,6,1232,27,8714,9,9946,California
Del Norte,2021-06-18,49,17935,23,6165,21,10911,5,859,20,1228,29,8743,25,9971,California
Del Norte,2021-06-19,11,17946,0,6165,7,10918,4,863,3,1227,8,8751,7,9978,California
Del Norte,2021-06-20,13,17959,9,6174,4,10922,0,863,8,1230,5,8756,8,9986,California
Del Norte,2021-06-21,25,17984,9,6183,10,10932,6,869,10,1231,15,8771,16,10002,California
Del Norte,2021-06-22,39,18023,9,6192,19,10951,11,880,14,1231,25,8796,25,10027,California
Del Norte,2021-06-23,69,18092,33,6225,30,10981,6,886,32,1233,36,8832,38,10065,California
Del Norte,2021-06-24,43,18135,24,6249,12,10993,7,893,13,1223,30,8862,20,10085,California
Del Norte,2021-06-25,29,18164,14,6263,13,11006,2,895,13,1222,16,8878,15,10100,California
Del Norte,2021-06-26,5,18169,0,6263,5,11011,0,895,2,1221,3,8881,2,10102,California
Del Norte,2021-06-27,13,18182,8,6271,5,11016,0,895,9,1226,4,8885,9,10111,California
Del Norte,2021-06-28,13,18195,6,6277,5,11021,2,897,7,1229,6,8891,9,10120,California
Del Norte,2021-06-29,57,18252,42,6319,12,11033,3,900,20,1215,37,8928,23,10143,California
Del Norte,2021-06-30,35,18287,17,6336,13,11046,5,905,10,1205,25,8953,15,10158,California
Del Norte,2021-07-01,25,18312,9,6345,12,11058,4,909,9,1202,16,8969,13,10171,California
Del Norte,2021-07-02,20,18332,8,6353,11,11069,1,910,7,1197,13,8982,8,10179,California
Del Norte,2021-07-03,3,18335,2,6355,1,11070,0,910,2,1198,1,8983,2,10181,California
Del Norte,2021-07-04,12,18347,10,6365,2,11072,0,910,7,1200,5,8988,7,10188,California
Del Norte,2021-07-05,11,18358,7,6372,4,11076,0,910,2,1193,9,8997,2,10190,California
Del Norte,2021-07-06,35,18393,18,6390,15,11091,2,912,17,1195,17,9014,19,10209,California
Del Norte,2021-07-07,51,18444,24,6414,22,11113,5,917,20,1189,31,9045,25,10234,California
Del Norte,2021-07-08,31,18475,13,6427,14,11127,4,921,12,1187,18,9063,16,10250,California
Del Norte,2021-07-09,21,18496,10,6437,10,11137,1,922,8,1183,13,9076,9,10259,California
Del Norte,2021-07-10,9,18505,5,6442,4,11141,0,922,5,1184,4,9080,5,10264,California
Del Norte,2021-07-11,5,18510,4,6446,1,11142,0,922,2,1183,3,9083,2,10266,California
Del Norte,2021-07-12,22,18532,14,6460,7,11149,1,923,11,1184,11,9094,12,10278,California
Del Norte,2021-07-13,25,18557,13,6473,8,11157,4,927,8,1181,17,9111,14,10292,California
Del Norte,2021-07-14,53,18610,26,6499,20,11177,7,934,15,1165,38,9149,22,10314,California
Del Norte,2021-07-15,29,18639,20,6519,7,11184,2,936,21,1180,8,9157,23,10337,California
Del Norte,2021-07-16,20,18659,10,6529,7,11191,3,939,5,1173,14,9171,7,10344,California
Del Norte,2021-07-17,8,18667,1,6530,7,11198,0,939,4,1173,4,9175,4,10348,California
Del Norte,2021-07-18,6,18673,1,6531,4,11202,1,940,4,1176,2,9177,5,10353,California
Del Norte,2021-07-19,28,18701,17,6548,9,11211,2,942,14,1178,14,9191,16,10369,California
Del Norte,2021-07-20,36,18737,25,6573,6,11217,5,947,14,1176,22,9213,20,10389,California
Del Norte,2021-07-21,34,18771,17,6590,11,11228,6,953,17,1182,17,9230,23,10412,California
Del Norte,2021-07-22,37,18808,26,6616,7,11235,4,957,14,1177,23,9253,18,10430,California
Del Norte,2021-07-23,28,18836,14,6630,10,11245,4,961,16,1186,11,9264,20,10450,California
Del Norte,2021-07-24,12,18848,4,6634,8,11253,0,961,11,1196,1,9265,11,10461,California
Del Norte,2021-07-25,6,18854,0,6634,6,11259,0,961,3,1196,3,9268,3,10464,California
Del Norte,2021-07-26,14,18868,10,6644,4,11263,0,961,12,1206,2,9270,12,10476,California
Del Norte,2021-07-27,43,18911,16,6660,24,11287,3,964,23,1212,20,9290,26,10502,California
Del Norte,2021-07-28,35,18946,10,6670,21,11308,4,968,15,1211,20,9310,19,10521,California
Del Norte,2021-07-29,35,18981,15,6685,13,11321,7,975,21,1225,14,9324,28,10549,California
Del Norte,2021-07-30,41,19022,21,6706,14,11335,6,981,24,1238,17,9341,30,10579,California
Del Norte,2021-07-31,32,19054,16,6722,14,11349,2,983,25,1258,7,9348,27,10606,California
Del Norte,2021-08-01,5,19059,2,6724,3,11352,0,983,5,1263,0,9348,5,10611,California
Del Norte,2021-08-02,39,19098,23,6747,10,11362,6,989,25,1280,14,9362,31,10642,California
Del Norte,2021-08-03,44,19142,20,6767,18,11380,6,995,26,1294,18,9380,32,10674,California
Del Norte,2021-08-04,67,19209,28,6795,29,11409,10,1005,34,1305,33,9413,44,10718,California
Del Norte,2021-08-05,77,19286,44,6839,20,11429,13,1018,52,1345,25,9438,65,10783,California
Del Norte,2021-08-06,50,19336,20,6859,23,11452,7,1025,37,1377,12,9450,44,10827,California
Del Norte,2021-08-07,14,19350,5,6864,9,11461,0,1025,10,1383,4,9454,10,10837,California
Del Norte,2021-08-08,13,19363,2,6866,5,11466,6,1031,6,1388,7,9461,12,10849,California
Del Norte,2021-08-09,65,19428,32,6898,26,11492,7,1038,47,1425,17,9478,54,10903,California
Del Norte,2021-08-10,78,19506,39,6937,28,11520,11,1049,59,1476,19,9497,70,10973,California
Del Norte,2021-08-11,76,19582,43,6980,28,11548,5,1054,51,1509,23,9520,56,11029,California
Del Norte,2021-08-12,92,19674,44,7024,33,11581,15,1069,65,1562,27,9547,80,11109,California
Del Norte,2021-08-13,67,19741,30,7054,25,11606,12,1081,41,1590,25,9572,53,11162,California
Del Norte,2021-08-14,45,19786,19,7073,17,11623,9,1090,32,1619,12,9584,41,11203,California
Del Norte,2021-08-15,12,19798,2,7075,9,11632,1,1091,5,1621,4,9588,6,11209,California
Del Norte,2021-08-16,74,19872,31,7106,34,11666,9,1100,48,1657,21,9609,57,11266,California
Del Norte,2021-08-17,106,19978,58,7164,30,11696,18,1118,73,1721,25,9634,89,11355,California
Del Norte,2021-08-18,79,20057,28,7192,41,11737,10,1128,41,1754,18,9652,51,11406,California
Del Norte,2021-08-19,98,20155,51,7243,40,11777,7,1135,52,1791,22,9674,59,11465,California
Del Norte,2021-08-20,99,20254,43,7286,43,11820,13,1148,56,1829,31,9705,69,11534,California
Del Norte,2021-08-21,43,20297,18,7304,16,11836,9,1157,23,1844,17,9722,32,11566,California
Del Norte,2021-08-22,4,20301,0,7304,4,11840,0,1157,1,1842,3,9725,1,11567,California
Del Norte,2021-08-23,85,20386,46,7350,26,11866,13,1170,55,1887,23,9748,68,11635,California
Del Norte,2021-08-24,73,20459,43,7393,25,11891,5,1175,44,1915,21,9769,49,11684,California
Del Norte,2021-08-25,97,20556,48,7441,37,11928,12,1187,48,1941,34,9803,60,11744,California
Del Norte,2021-08-26,119,20675,71,7512,40,11968,8,1195,51,1956,44,9847,59,11803,California
Del Norte,2021-08-27,78,20753,44,7556,27,11995,7,1202,39,1977,25,9872,46,11849,California
Del Norte,2021-08-28,47,20800,19,7575,24,12019,4,1206,21,1983,19,9891,25,11874,California
Del Norte,2021-08-29,21,20821,8,7583,13,12032,0,1206,11,1989,5,9896,11,11885,California
Del Norte,2021-08-30,63,20884,34,7617,24,12056,5,1211,35,2006,23,9919,40,11925,California
El Dorado,2020-12-15,12,12,12,12,0,0,0,0,12,12,0,0,12,12,California
El Dorado,2020-12-16,40,52,40,52,0,0,0,0,40,52,0,0,40,52,California
El Dorado,2020-12-17,36,88,36,88,0,0,0,0,36,88,0,0,36,88,California
El Dorado,2020-12-18,266,354,266,354,0,0,0,0,266,354,0,0,266,354,California
El Dorado,2020-12-19,120,474,120,474,0,0,0,0,120,474,0,0,120,474,California
El Dorado,2020-12-20,83,557,83,557,0,0,0,0,83,557,0,0,83,557,California
El Dorado,2020-12-21,319,876,318,875,1,1,0,0,319,876,0,0,319,876,California
El Dorado,2020-12-22,247,1123,223,1098,24,25,0,0,247,1123,0,0,247,1123,California
El Dorado,2020-12-23,196,1319,145,1243,51,76,0,0,196,1319,0,0,196,1319,California
El Dorado,2020-12-24,84,1403,63,1306,21,97,0,0,84,1403,0,0,84,1403,California
El Dorado,2020-12-25,8,1411,8,1314,0,97,0,0,8,1411,0,0,8,1411,California
El Dorado,2020-12-26,46,1457,28,1342,18,115,0,0,46,1457,0,0,46,1457,California
El Dorado,2020-12-27,38,1495,34,1376,4,119,0,0,38,1495,0,0,38,1495,California
El Dorado,2020-12-28,220,1715,169,1545,51,170,0,0,220,1715,0,0,220,1715,California
El Dorado,2020-12-29,465,2180,143,1688,322,492,0,0,465,2180,0,0,465,2180,California
El Dorado,2020-12-30,547,2727,172,1860,375,867,0,0,547,2727,0,0,547,2727,California
El Dorado,2020-12-31,110,2837,69,1929,41,908,0,0,110,2837,0,0,110,2837,California
El Dorado,2021-01-01,8,2845,4,1933,4,912,0,0,8,2845,0,0,8,2845,California
El Dorado,2021-01-02,157,3002,144,2077,13,925,0,0,157,3002,0,0,157,3002,California
El Dorado,2021-01-03,95,3097,18,2095,77,1002,0,0,95,3097,0,0,95,3097,California
El Dorado,2021-01-04,198,3295,64,2159,134,1136,0,0,198,3295,0,0,198,3295,California
El Dorado,2021-01-05,233,3528,76,2235,157,1293,0,0,215,3492,18,18,215,3510,California
El Dorado,2021-01-06,247,3775,173,2408,74,1367,0,0,178,3602,68,86,178,3688,California
El Dorado,2021-01-07,342,4117,141,2549,201,1568,0,0,262,3784,80,166,262,3950,California
El Dorado,2021-01-08,992,5109,511,3060,481,2049,0,0,767,4326,225,391,767,4717,California
El Dorado,2021-01-09,200,5309,162,3222,38,2087,0,0,130,4386,70,461,130,4847,California
El Dorado,2021-01-10,181,5490,131,3353,50,2137,0,0,108,4422,73,534,109,4956,California
El Dorado,2021-01-11,665,6155,295,3648,370,2507,0,0,465,4689,199,733,466,5422,California
El Dorado,2021-01-12,817,6972,434,4082,383,2890,0,0,559,4990,258,991,559,5981,California
El Dorado,2021-01-13,713,7685,306,4388,407,3297,0,0,544,5365,169,1160,544,6525,California
El Dorado,2021-01-14,808,8493,223,4611,585,3882,0,0,710,5979,96,1256,710,7235,California
El Dorado,2021-01-15,811,9304,188,4799,623,4505,0,0,737,6642,74,1330,737,7972,California
El Dorado,2021-01-16,233,9537,107,4906,126,4631,0,0,207,6823,26,1356,207,8179,California
El Dorado,2021-01-17,108,9645,48,4954,60,4691,0,0,91,6897,17,1373,91,8270,California
El Dorado,2021-01-18,438,10083,147,5101,291,4982,0,0,363,7185,75,1448,363,8633,California
El Dorado,2021-01-19,755,10838,452,5553,303,5285,0,0,602,7635,153,1601,603,9236,California
El Dorado,2021-01-20,1021,11859,694,6247,327,5612,0,0,895,8406,124,1725,895,10131,California
El Dorado,2021-01-21,1294,13153,692,6939,602,6214,0,0,1071,9295,182,1907,1071,11202,California
El Dorado,2021-01-22,1257,14410,843,7782,414,6628,0,0,1187,10413,69,1976,1187,12389,California
El Dorado,2021-01-23,880,15290,619,8401,261,6889,0,0,763,11059,117,2093,763,13152,California
El Dorado,2021-01-24,137,15427,81,8482,56,6945,0,0,116,11154,21,2114,116,13268,California
El Dorado,2021-01-25,707,16134,297,8779,410,7355,0,0,610,11667,97,2211,610,13878,California
El Dorado,2021-01-26,702,16836,382,9161,320,7675,0,0,590,12145,112,2323,590,14468,California
El Dorado,2021-01-27,1009,17845,400,9561,609,8284,0,0,668,12471,342,2665,668,15136,California
El Dorado,2021-01-28,1123,18968,458,10019,665,8949,0,0,758,12864,365,3030,758,15894,California
El Dorado,2021-01-29,1061,20029,556,10575,505,9454,0,0,767,13339,293,3323,768,16662,California
El Dorado,2021-01-30,851,20880,300,10875,551,10005,0,0,750,13990,99,3422,750,17412,California
El Dorado,2021-01-31,248,21128,223,11098,25,10030,0,0,194,14130,54,3476,194,17606,California
El Dorado,2021-02-01,809,21937,372,11470,437,10467,0,0,658,14637,151,3627,658,18264,California
El Dorado,2021-02-02,868,22805,385,11855,483,10950,0,0,704,15177,164,3791,704,18968,California
El Dorado,2021-02-03,917,23722,486,12341,431,11381,0,0,702,15664,215,4006,702,19670,California
El Dorado,2021-02-04,1270,24992,717,13058,553,11934,0,0,882,16160,386,4392,882,20552,California
El Dorado,2021-02-05,1535,26527,626,13684,909,12843,0,0,893,16448,605,4997,893,21445,California
El Dorado,2021-02-06,1092,27619,332,14016,760,13603,0,0,982,17321,110,5107,983,22428,California
El Dorado,2021-02-07,262,27881,177,14193,85,13688,0,0,194,17448,67,5174,194,22622,California
El Dorado,2021-02-08,899,28780,425,14618,474,14162,0,0,613,17777,284,5458,613,23235,California
El Dorado,2021-02-09,992,29772,559,15177,433,14595,0,0,557,17899,435,5893,557,23792,California
El Dorado,2021-02-10,1281,31053,747,15924,534,15129,0,0,675,17969,605,6498,675,24467,California
El Dorado,2021-02-11,2187,33240,904,16828,1283,16412,0,0,753,17294,1430,7928,755,25222,California
El Dorado,2021-02-12,1599,34839,835,17663,764,17176,0,0,683,17064,915,8843,685,25907,California
El Dorado,2021-02-13,1260,36099,670,18333,590,17766,0,0,657,17120,601,9444,657,26564,California
El Dorado,2021-02-14,504,36603,157,18490,347,18113,0,0,405,17426,99,9543,405,26969,California
El Dorado,2021-02-15,1196,37799,394,18884,802,18915,0,0,826,17886,370,9913,830,27799,California
El Dorado,2021-02-16,1224,39023,540,19424,684,19599,0,0,675,18014,548,10461,676,28475,California
El Dorado,2021-02-17,978,40001,433,19857,545,20144,0,0,469,17974,509,10970,469,28944,California
El Dorado,2021-02-18,2141,42142,1047,20904,1094,21238,0,0,1081,17998,1057,12027,1081,30025,California
El Dorado,2021-02-19,1256,43398,670,21574,586,21824,0,0,699,18143,554,12581,699,30724,California
El Dorado,2021-02-20,1116,44514,464,22038,652,22476,0,0,699,18431,412,12993,700,31424,California
El Dorado,2021-02-21,382,44896,245,22283,137,22613,0,0,181,18411,201,13194,181,31605,California
El Dorado,2021-02-22,936,45832,467,22750,469,23082,0,0,298,18075,635,13829,299,31904,California
El Dorado,2021-02-23,923,46755,522,23272,401,23483,0,0,365,17886,554,14383,365,32269,California
El Dorado,2021-02-24,1083,47838,476,23748,607,24090,0,0,449,17703,632,15015,449,32718,California
El Dorado,2021-02-25,2001,49839,1206,24954,795,24885,0,0,714,17144,1277,16292,718,33436,California
El Dorado,2021-02-26,2518,52357,1579,26533,939,25824,0,0,1687,18009,822,17114,1687,35123,California
El Dorado,2021-02-27,1792,54149,454,26987,1338,27162,0,0,1335,18891,453,17567,1335,36458,California
El Dorado,2021-02-28,998,55147,243,27230,755,27917,0,0,519,18935,476,18043,520,36978,California
El Dorado,2021-03-01,1209,56356,480,27710,727,28644,2,2,671,19071,537,18580,673,37651,California
El Dorado,2021-03-02,981,57337,297,28007,683,29327,1,3,507,19109,471,19051,509,38160,California
El Dorado,2021-03-03,1806,59143,501,28508,1305,30632,0,3,1225,19764,573,19624,1228,39388,California
El Dorado,2021-03-04,2584,61727,1587,30095,996,31628,1,4,1216,19619,1362,20986,1217,40605,California
El Dorado,2021-03-05,1631,63358,451,30546,1174,32802,6,10,1077,20154,548,21534,1083,41688,California
El Dorado,2021-03-06,763,64121,232,30778,500,33302,31,41,402,20226,358,21892,430,42118,California
El Dorado,2021-03-07,894,65015,202,30980,657,33959,35,76,259,19889,631,22523,294,42412,California
El Dorado,2021-03-08,1394,66409,392,31372,927,34886,75,151,902,20376,488,23011,975,43387,California
El Dorado,2021-03-09,1031,67440,244,31616,717,35603,70,221,611,20653,404,23415,681,44068,California
El Dorado,2021-03-10,998,68438,348,31964,592,36195,58,279,579,20877,412,23827,636,44704,California
El Dorado,2021-03-11,3102,71540,1877,33841,1035,37230,190,469,1315,20616,1762,25589,1501,46205,California
El Dorado,2021-03-12,1840,73380,635,34476,952,38182,253,722,771,20587,1052,26641,1023,47228,California
El Dorado,2021-03-13,1152,74532,350,34826,518,38700,284,1006,440,20600,708,27349,721,47949,California
El Dorado,2021-03-14,1034,75566,206,35032,716,39416,112,1118,286,20252,746,28095,398,48347,California
El Dorado,2021-03-15,1427,76993,306,35338,991,40407,130,1248,617,20191,806,28901,745,49092,California
El Dorado,2021-03-16,1254,78247,440,35778,668,41075,146,1394,577,20241,672,29573,722,49814,California
El Dorado,2021-03-17,1199,79446,393,36171,705,41780,101,1495,775,20692,422,29995,873,50687,California
El Dorado,2021-03-18,3071,82517,1812,37983,1217,42997,42,1537,2012,21701,1045,31040,2054,52741,California
El Dorado,2021-03-19,1143,83660,366,38349,618,43615,159,1696,631,21979,509,31549,787,53528,California
El Dorado,2021-03-20,1109,84769,273,38622,821,44436,15,1711,509,21916,587,32136,524,54052,California
El Dorado,2021-03-21,1118,85887,427,39049,686,45122,5,1716,922,22651,193,32329,928,54980,California
El Dorado,2021-03-22,1531,87418,505,39554,943,46065,83,1799,1195,23597,332,32661,1278,56258,California
El Dorado,2021-03-23,1180,88598,467,40021,618,46683,95,1894,739,24004,427,33088,834,57092,California
El Dorado,2021-03-24,1485,90083,644,40665,641,47324,200,2094,644,24034,813,33901,843,57935,California
El Dorado,2021-03-25,2555,92638,1713,42378,734,48058,108,2202,1374,24345,1172,35073,1483,59418,California
El Dorado,2021-03-26,1865,94503,714,43092,1035,49093,116,2318,927,24475,912,35985,1042,60460,California
El Dorado,2021-03-27,1525,96028,195,43287,1326,50419,4,2322,475,23911,1043,37028,479,60939,California
El Dorado,2021-03-28,701,96729,186,43473,503,50922,12,2334,156,23539,540,37568,168,61107,California
El Dorado,2021-03-29,1345,98074,453,43926,876,51798,16,2350,826,23866,515,38083,842,61949,California
El Dorado,2021-03-30,1398,99472,435,44361,866,52664,97,2447,693,23959,696,38779,789,62738,California
El Dorado,2021-03-31,1593,101065,597,44958,925,53589,71,2518,657,23752,932,39711,725,63463,California
El Dorado,2021-04-01,3266,104331,1788,46746,1395,54984,83,2601,1542,23658,1719,41430,1625,65088,California
El Dorado,2021-04-02,1911,106242,576,47322,1239,56223,96,2697,733,23315,1172,42602,829,65917,California
El Dorado,2021-04-03,761,107003,304,47626,339,56562,118,2815,228,23132,529,43131,346,66263,California
El Dorado,2021-04-04,277,107280,84,47710,144,56706,49,2864,96,23098,180,43311,146,66409,California
El Dorado,2021-04-05,1459,108739,435,48145,929,57635,95,2959,590,22921,860,44171,683,67092,California
El Dorado,2021-04-06,1439,110178,538,48683,682,58317,219,3178,442,22586,992,45163,657,67749,California
El Dorado,2021-04-07,1630,111808,581,49264,591,58908,458,3636,546,22504,1080,46243,998,68747,California
El Dorado,2021-04-08,2741,114549,1753,51017,748,59656,240,3876,1121,22250,1613,47856,1359,70106,California
El Dorado,2021-04-09,1455,116004,455,51472,775,60431,225,4101,569,22154,883,48739,787,70893,California
El Dorado,2021-04-10,1017,117021,225,51697,681,61112,111,4212,662,22573,352,49091,771,71664,California
El Dorado,2021-04-11,783,117804,460,52157,307,61419,16,4228,213,22233,569,49660,229,71893,California
El Dorado,2021-04-12,1313,119117,514,52671,648,62067,151,4379,560,22200,744,50404,711,72604,California
El Dorado,2021-04-13,1151,120268,622,53293,529,62596,0,4379,512,22079,633,51037,512,73116,California
El Dorado,2021-04-14,1115,121383,477,53770,637,63233,1,4380,375,21732,723,51760,376,73492,California
El Dorado,2021-04-15,2556,123939,1713,55483,843,64076,0,4380,955,21093,1595,53355,956,74448,California
El Dorado,2021-04-16,1489,125428,525,56008,964,65040,0,4380,612,20836,870,54225,613,75061,California
El Dorado,2021-04-17,1034,126462,210,56218,823,65863,1,4381,714,21233,317,54542,714,75775,California
El Dorado,2021-04-18,1227,127689,118,56336,1109,66972,0,4381,426,20861,798,55340,426,76201,California
El Dorado,2021-04-19,1742,129431,448,56784,1294,68266,0,4381,684,20495,1050,56390,684,76885,California
El Dorado,2021-04-20,1165,130596,410,57194,755,69021,0,4381,478,20292,682,57072,479,77364,California
El Dorado,2021-04-21,1253,131849,544,57738,705,69726,4,4385,641,20331,604,57676,643,78007,California
El Dorado,2021-04-22,2639,134488,1750,59488,889,70615,0,4385,1090,19878,1544,59220,1091,79098,California
El Dorado,2021-04-23,1471,135959,546,60034,924,71539,1,4386,742,19896,727,59947,745,79843,California
El Dorado,2021-04-24,1059,137018,526,60560,533,72072,0,4386,815,20470,241,60188,815,80658,California
El Dorado,2021-04-25,842,137860,456,61016,386,72458,0,4386,481,20590,361,60549,481,81139,California
El Dorado,2021-04-26,1239,139099,516,61532,706,73164,17,4403,581,20535,652,61201,597,81736,California
El Dorado,2021-04-27,1178,140277,463,61995,677,73841,38,4441,537,20476,634,61835,575,82311,California
El Dorado,2021-04-28,1149,141426,437,62432,673,74514,39,4480,497,20364,649,62484,537,82848,California
El Dorado,2021-04-29,2061,143487,1423,63855,606,75120,32,4512,626,19590,1432,63916,658,83506,California
El Dorado,2021-04-30,2206,145693,1404,65259,757,75877,45,4557,1419,20283,770,64686,1463,84969,California
El Dorado,2021-05-01,629,146322,285,65544,315,76192,29,4586,286,20262,336,65022,315,85284,California
El Dorado,2021-05-02,305,146627,215,65759,59,76251,31,4617,98,20186,204,65226,128,85412,California
El Dorado,2021-05-03,846,147473,419,66178,376,76627,51,4668,290,19976,552,65778,342,85754,California
El Dorado,2021-05-04,937,148410,480,66658,397,77024,60,4728,341,19785,592,66370,401,86155,California
El Dorado,2021-05-05,920,149330,465,67123,380,77404,75,4803,441,19824,477,66847,516,86671,California
El Dorado,2021-05-06,1154,150484,512,67635,594,77998,48,4851,479,19685,665,67512,526,87197,California
El Dorado,2021-05-07,1015,151499,403,68038,553,78551,59,4910,410,19548,605,68117,468,87665,California
El Dorado,2021-05-08,691,152190,166,68204,488,79039,37,4947,211,19319,477,68594,248,87913,California
El Dorado,2021-05-09,239,152429,96,68300,115,79154,28,4975,106,19320,133,68727,134,88047,California
El Dorado,2021-05-10,836,153265,279,68579,497,79651,60,5035,242,19036,584,69311,300,88347,California
El Dorado,2021-05-11,712,153977,320,68899,330,79981,62,5097,287,18964,422,69733,350,88697,California
El Dorado,2021-05-12,654,154631,346,69245,267,80248,41,5138,250,18852,404,70137,292,88989,California
El Dorado,2021-05-13,1288,155919,812,70057,436,80684,40,5178,473,18555,809,70946,512,89501,California
El Dorado,2021-05-14,1443,157362,837,70894,522,81206,84,5262,674,18549,764,71710,758,90259,California
El Dorado,2021-05-15,913,158275,565,71459,290,81496,58,5320,323,18340,590,72300,381,90640,California
El Dorado,2021-05-16,886,159161,471,71930,389,81885,26,5346,239,17959,646,72946,265,90905,California
El Dorado,2021-05-17,1617,160778,693,72623,874,82759,50,5396,562,17519,1051,73997,611,91516,California
El Dorado,2021-05-18,1055,161833,545,73168,456,83215,54,5450,436,17393,617,74614,491,92007,California
El Dorado,2021-05-19,882,162715,388,73556,440,83655,54,5504,311,17193,564,75178,364,92371,California
El Dorado,2021-05-20,1234,163949,697,74253,457,84112,80,5584,451,16941,780,75958,528,92899,California
El Dorado,2021-05-21,2379,166328,1784,76037,555,84667,40,5624,818,16245,1554,77512,858,93757,California
El Dorado,2021-05-22,718,167046,207,76244,474,85141,37,5661,223,16011,494,78006,260,94017,California
El Dorado,2021-05-23,389,167435,135,76379,226,85367,28,5689,95,15843,291,78297,123,94140,California
El Dorado,2021-05-24,922,168357,483,76862,370,85737,69,5758,333,15658,585,78882,400,94540,California
El Dorado,2021-05-25,642,168999,282,77144,322,86059,38,5796,236,15529,402,79284,273,94813,California
El Dorado,2021-05-26,832,169831,416,77560,393,86452,23,5819,285,15290,547,79831,308,95121,California
El Dorado,2021-05-27,633,170464,251,77811,347,86799,35,5854,311,15314,321,80152,345,95466,California
El Dorado,2021-05-28,766,171230,287,78098,414,87213,65,5919,320,15256,443,80595,385,95851,California
El Dorado,2021-05-29,398,171628,113,78211,268,87481,17,5936,171,15219,225,80820,188,96039,California
El Dorado,2021-05-30,174,171802,101,78312,59,87540,14,5950,82,15224,91,80911,96,96135,California
El Dorado,2021-05-31,38,171840,12,78324,14,87554,12,5962,8,15214,30,80941,20,96155,California
El Dorado,2021-06-01,694,172534,300,78624,354,87908,40,6002,235,15033,456,81397,275,96430,California
El Dorado,2021-06-02,639,173173,310,78934,278,88186,51,6053,266,14979,371,81768,317,96747,California
El Dorado,2021-06-03,738,173911,344,79278,351,88537,43,6096,179,14642,559,82327,222,96969,California
El Dorado,2021-06-04,914,174825,549,79827,331,88868,34,6130,200,14164,712,83039,234,97203,California
El Dorado,2021-06-05,392,175217,227,80054,153,89021,12,6142,84,13953,307,83346,96,97299,California
El Dorado,2021-06-06,285,175502,199,80253,70,89091,16,6158,52,13788,232,83578,67,97366,California
El Dorado,2021-06-07,796,176298,496,80749,260,89351,40,6198,173,13386,615,84193,213,97579,California
El Dorado,2021-06-08,634,176932,385,81134,215,89566,34,6232,132,13052,499,84692,165,97744,California
El Dorado,2021-06-09,466,177398,277,81411,164,89730,25,6257,111,12833,355,85047,136,97880,California
El Dorado,2021-06-10,595,177993,372,81783,192,89922,31,6288,162,12595,431,85478,193,98073,California
El Dorado,2021-06-11,663,178656,399,82182,220,90142,44,6332,131,12239,531,86009,175,98248,California
El Dorado,2021-06-12,262,178918,153,82335,90,90232,19,6351,61,12118,201,86210,80,98328,California
El Dorado,2021-06-13,162,179080,90,82425,54,90286,18,6369,32,12039,129,86339,50,98378,California
El Dorado,2021-06-14,524,179604,367,82792,127,90413,30,6399,123,11791,401,86740,153,98531,California
El Dorado,2021-06-15,466,180070,257,83049,172,90585,37,6436,124,11614,338,87078,161,98692,California
El Dorado,2021-06-16,518,180588,367,83416,109,90694,42,6478,132,11405,383,87461,174,98866,California
El Dorado,2021-06-17,438,181026,266,83682,139,90833,33,6511,137,11279,298,87759,172,99038,California
El Dorado,2021-06-18,415,181441,270,83952,110,90943,35,6546,119,11138,295,88054,154,99192,California
El Dorado,2021-06-19,248,181689,151,84103,83,91026,14,6560,90,11085,157,88211,104,99296,California
El Dorado,2021-06-20,125,181814,91,84194,28,91054,6,6566,52,11070,73,88284,58,99354,California
El Dorado,2021-06-21,325,182139,167,84361,131,91185,27,6593,121,11017,200,88484,147,99501,California
El Dorado,2021-06-22,399,182538,256,84617,115,91300,28,6621,128,10903,270,88754,156,99657,California
El Dorado,2021-06-23,427,182965,294,84911,111,91411,22,6643,134,10768,291,89045,156,99813,California
El Dorado,2021-06-24,399,183364,246,85157,138,91549,15,6658,148,10681,250,89295,163,99976,California
El Dorado,2021-06-25,357,183721,217,85374,101,91650,39,6697,138,10644,213,89508,176,100152,California
El Dorado,2021-06-26,209,183930,122,85496,72,91722,15,6712,69,10590,139,89647,85,100237,California
El Dorado,2021-06-27,120,184050,83,85579,31,91753,6,6718,55,10586,65,89712,61,100298,California
El Dorado,2021-06-28,306,184356,216,85795,64,91817,26,6744,133,10573,172,89884,159,100457,California
El Dorado,2021-06-29,298,184654,175,85970,102,91919,21,6765,120,10538,176,90060,141,100598,California
El Dorado,2021-06-30,248,184902,175,86145,60,91979,13,6778,123,10550,124,90184,136,100734,California
El Dorado,2021-07-01,233,185135,135,86280,82,92061,16,6794,88,10507,145,90329,102,100836,California
El Dorado,2021-07-02,263,185398,166,86446,71,92132,26,6820,114,10499,148,90477,140,100976,California
El Dorado,2021-07-03,102,185500,78,86524,19,92151,5,6825,48,10498,54,90531,53,101029,California
El Dorado,2021-07-04,4,185504,0,86524,1,92152,3,6828,0,10497,4,90535,3,101032,California
El Dorado,2021-07-05,159,185663,99,86623,53,92205,7,6835,87,10518,72,90607,93,101125,California
El Dorado,2021-07-06,297,185960,190,86813,75,92280,32,6867,116,10487,179,90786,148,101273,California
El Dorado,2021-07-07,267,186227,173,86986,79,92359,15,6882,125,10486,141,90927,140,101413,California
El Dorado,2021-07-08,307,186534,178,87164,116,92475,13,6895,152,10497,153,91080,164,101577,California
El Dorado,2021-07-09,290,186824,188,87352,80,92555,22,6917,114,10458,175,91255,136,101713,California
El Dorado,2021-07-10,143,186967,106,87458,30,92585,7,6924,51,10425,91,91346,58,101771,California
El Dorado,2021-07-11,91,187058,68,87526,14,92599,9,6933,31,10405,60,91406,40,101811,California
El Dorado,2021-07-12,257,187315,181,87707,67,92666,9,6942,123,10403,134,91540,132,101943,California
El Dorado,2021-07-13,316,187631,208,87915,83,92749,25,6967,136,10387,178,91718,162,102105,California
El Dorado,2021-07-14,198,187829,119,88034,65,92814,14,6981,86,10377,108,91826,98,102203,California
El Dorado,2021-07-15,324,188153,232,88266,79,92893,13,6994,167,10402,155,91981,180,102383,California
El Dorado,2021-07-16,300,188453,202,88468,70,92963,28,7022,160,10451,139,92120,188,102571,California
El Dorado,2021-07-17,117,188570,79,88547,30,92993,8,7030,48,10439,68,92188,56,102627,California
El Dorado,2021-07-18,98,188668,71,88618,24,93017,3,7033,48,10441,49,92237,51,102678,California
El Dorado,2021-07-19,305,188973,210,88828,87,93104,8,7041,150,10447,152,92389,158,102836,California
El Dorado,2021-07-20,312,189285,198,89026,99,93203,15,7056,174,10503,133,92522,189,103025,California
El Dorado,2021-07-21,266,189551,175,89201,79,93282,12,7068,124,10497,142,92664,136,103161,California
El Dorado,2021-07-22,271,189822,177,89378,81,93363,13,7081,162,10563,109,92773,175,103336,California
El Dorado,2021-07-23,314,190136,210,89588,86,93449,18,7099,180,10627,133,92906,197,103533,California
El Dorado,2021-07-24,140,190276,94,89682,44,93493,2,7101,68,10626,71,92977,70,103603,California
El Dorado,2021-07-25,93,190369,56,89738,29,93522,8,7109,60,10663,31,93008,68,103671,California
El Dorado,2021-07-26,321,190690,218,89956,91,93613,12,7121,222,10799,98,93106,234,103905,California
El Dorado,2021-07-27,401,191091,269,90225,103,93716,29,7150,251,10932,147,93253,280,104185,California
El Dorado,2021-07-28,311,191402,195,90420,92,93808,24,7174,192,11031,117,93370,216,104401,California
El Dorado,2021-07-29,345,191747,237,90657,88,93896,20,7194,220,11150,121,93491,240,104641,California
El Dorado,2021-07-30,385,192132,249,90906,97,93993,39,7233,221,11250,160,93651,260,104901,California
El Dorado,2021-07-31,172,192304,126,91032,35,94028,11,7244,112,11316,57,93708,123,105024,California
El Dorado,2021-08-01,107,192411,79,91111,28,94056,0,7244,75,11359,32,93740,75,105099,California
El Dorado,2021-08-02,347,192758,257,91368,75,94131,15,7259,223,11473,123,93863,237,105336,California
El Dorado,2021-08-03,340,193098,225,91593,84,94215,31,7290,212,11588,128,93991,243,105579,California
El Dorado,2021-08-04,344,193442,228,91821,95,94310,21,7311,233,11733,109,94100,254,105833,California
El Dorado,2021-08-05,410,193852,270,92091,100,94410,40,7351,235,11833,174,94274,274,106107,California
El Dorado,2021-08-06,439,194291,307,92398,97,94507,35,7386,276,11983,161,94435,311,106418,California
El Dorado,2021-08-07,177,194468,138,92536,35,94542,4,7390,114,12044,57,94492,118,106536,California
El Dorado,2021-08-08,98,194566,75,92611,21,94563,2,7392,64,12078,32,94524,66,106602,California
El Dorado,2021-08-09,362,194928,258,92869,85,94648,19,7411,220,12177,140,94664,239,106841,California
El Dorado,2021-08-10,349,195277,225,93094,94,94742,30,7441,199,12258,148,94812,229,107070,California
El Dorado,2021-08-11,278,195555,187,93281,71,94813,20,7461,172,12348,102,94914,192,107262,California
El Dorado,2021-08-12,380,195935,249,93530,108,94921,23,7484,199,12394,176,95090,222,107484,California
El Dorado,2021-08-13,445,196380,311,93841,105,95026,29,7513,215,12412,226,95316,244,107728,California
El Dorado,2021-08-14,220,196600,139,93980,60,95086,21,7534,116,12466,83,95399,137,107865,California
El Dorado,2021-08-15,160,196760,108,94088,26,95112,26,7560,82,12504,70,95469,108,107973,California
El Dorado,2021-08-16,404,197164,261,94349,123,95235,20,7580,174,12502,196,95665,194,108167,California
El Dorado,2021-08-17,391,197555,214,94563,143,95378,34,7614,177,12529,184,95849,211,108378,California
El Dorado,2021-08-18,325,197880,211,94774,95,95473,19,7633,155,12567,136,95985,174,108552,California
El Dorado,2021-08-19,417,198297,269,95043,122,95595,26,7659,181,12588,186,96171,207,108759,California
El Dorado,2021-08-20,469,198766,301,95344,134,95729,34,7693,208,12613,217,96388,242,109001,California
El Dorado,2021-08-21,205,198971,128,95472,66,95795,11,7704,80,12598,106,96494,91,109092,California
El Dorado,2021-08-22,150,199121,102,95574,45,95840,3,7707,73,12609,65,96559,76,109168,California
El Dorado,2021-08-23,499,199620,363,95937,120,95960,16,7723,242,12664,203,96762,258,109426,California
El Dorado,2021-08-24,446,200066,306,96243,122,96082,18,7741,174,12652,204,96966,192,109618,California
El Dorado,2021-08-25,424,200490,284,96527,107,96189,33,7774,176,12668,193,97159,209,109827,California
El Dorado,2021-08-26,432,200922,299,96826,108,96297,25,7799,177,12666,204,97363,202,110029,California
El Dorado,2021-08-27,518,201440,363,97189,136,96433,19,7818,172,12588,269,97632,191,110220,California
El Dorado,2021-08-28,225,201665,158,97347,62,96495,5,7823,92,12576,109,97741,97,110317,California
El Dorado,2021-08-29,163,201828,115,97462,42,96537,6,7829,65,12563,84,97825,71,110388,California
El Dorado,2021-08-30,242,202070,176,97638,55,96592,11,7840,83,12551,106,97931,94,110482,California
Fresno,2020-12-15,4,4,4,4,0,0,0,0,4,4,0,0,4,4,California
Fresno,2020-12-16,128,132,128,132,0,0,0,0,128,132,0,0,128,132,California
Fresno,2020-12-17,126,258,126,258,0,0,0,0,126,258,0,0,126,258,California
Fresno,2020-12-18,359,617,358,616,1,1,0,0,359,617,0,0,359,617,California
Fresno,2020-12-19,163,780,163,779,0,1,0,0,163,780,0,0,163,780,California
Fresno,2020-12-20,260,1040,257,1036,3,4,0,0,260,1040,0,0,260,1040,California
Fresno,2020-12-21,936,1976,934,1970,2,6,0,0,965,2005,0,0,965,2005,California
Fresno,2020-12-22,909,2885,874,2844,35,41,0,0,913,2918,0,0,913,2918,California
Fresno,2020-12-23,1108,3993,1053,3897,55,96,0,0,1109,4027,0,0,1109,4027,California
Fresno,2020-12-24,593,4586,567,4464,26,122,0,0,593,4620,0,0,593,4620,California
Fresno,2020-12-25,3,4589,1,4465,2,124,0,0,3,4623,0,0,3,4623,California
Fresno,2020-12-26,724,5313,714,5179,10,134,0,0,724,5347,0,0,724,5347,California
Fresno,2020-12-27,307,5620,208,5387,99,233,0,0,307,5654,0,0,307,5654,California
Fresno,2020-12-28,1106,6726,802,6189,304,537,0,0,1106,6760,0,0,1106,6760,California
Fresno,2020-12-29,1763,8489,996,7185,767,1304,0,0,1762,8522,0,0,1762,8522,California
Fresno,2020-12-30,993,9482,446,7631,547,1851,0,0,992,9513,1,1,992,9514,California
Fresno,2020-12-31,932,10414,310,7941,622,2473,0,0,932,10445,0,1,932,10446,California
Fresno,2021-01-01,9,10423,3,7944,6,2479,0,0,9,10454,0,1,9,10455,California
Fresno,2021-01-02,1027,11450,711,8655,316,2795,0,0,1027,11481,0,1,1027,11482,California
Fresno,2021-01-03,156,11606,129,8784,27,2822,0,0,156,11637,0,1,156,11638,California
Fresno,2021-01-04,629,12235,376,9160,253,3075,0,0,629,12266,0,1,629,12267,California
Fresno,2021-01-05,795,13030,313,9473,482,3557,0,0,720,12912,75,76,721,12988,California
Fresno,2021-01-06,1007,14037,354,9827,653,4210,0,0,829,13563,178,254,829,13817,California
Fresno,2021-01-07,1930,15967,926,10753,1004,5214,0,0,1671,14980,259,513,1676,15493,California
Fresno,2021-01-08,1812,17779,622,11375,1190,6404,0,0,1438,16048,372,885,1440,16933,California
Fresno,2021-01-09,645,18424,393,11768,252,6656,0,0,366,16135,279,1164,366,17299,California
Fresno,2021-01-10,511,18935,481,12249,30,6686,0,0,200,16024,311,1475,200,17499,California
Fresno,2021-01-11,2254,21189,1822,14071,432,7118,0,0,1551,16876,703,2178,1555,19054,California
Fresno,2021-01-12,2548,23737,1830,15901,718,7836,0,0,1694,17716,856,3034,1696,20750,California
Fresno,2021-01-13,3597,27334,2444,18345,1153,8989,0,0,2731,19585,865,3899,2734,23484,California
Fresno,2021-01-14,4200,31534,2213,20558,1987,10976,0,0,3719,22824,480,4379,3719,27203,California
Fresno,2021-01-15,3707,35241,2543,23101,1164,12140,0,0,3348,25818,358,4737,3352,30555,California
Fresno,2021-01-16,3147,38388,2312,25413,835,12975,0,0,2677,28027,470,5207,2679,33234,California
Fresno,2021-01-17,976,39364,556,25969,420,13395,0,0,777,28605,199,5406,777,34011,California
Fresno,2021-01-18,3084,42448,2368,28337,716,14111,0,0,2427,30378,656,6062,2429,36440,California
Fresno,2021-01-19,4369,46817,2561,30898,1808,15919,0,0,3698,33408,671,6733,3701,40141,California
Fresno,2021-01-20,3054,49871,1228,32126,1826,17745,0,0,2734,35831,314,7047,2737,42878,California
Fresno,2021-01-21,4459,54330,2090,34216,2369,20114,0,0,4089,39577,349,7396,4095,46973,California
Fresno,2021-01-22,3330,57660,1353,35569,1977,22091,0,0,2945,42155,368,7764,2946,49919,California
Fresno,2021-01-23,3063,60723,1983,37552,1080,23171,0,0,2338,43773,725,8489,2343,52262,California
Fresno,2021-01-24,563,61286,378,37930,185,23356,0,0,352,43916,211,8700,354,52616,California
Fresno,2021-01-25,2452,63738,864,38794,1588,24944,0,0,1861,45189,591,9291,1864,54480,California
Fresno,2021-01-26,2106,65844,608,39402,1498,26442,0,0,1333,45752,771,10062,1334,55814,California
Fresno,2021-01-27,2432,68276,1249,40651,1183,27625,0,0,1745,46827,681,10743,1756,57570,California
Fresno,2021-01-28,4587,72863,3077,43728,1510,29135,0,0,3481,49209,1102,11845,3484,61054,California
Fresno,2021-01-29,1678,74541,955,44683,723,29858,0,0,1372,50281,301,12146,1373,62427,California
Fresno,2021-01-30,1424,75965,523,45206,901,30759,0,0,1002,50861,422,12568,1002,63429,California
Fresno,2021-01-31,227,76192,215,45421,12,30771,0,0,73,50780,154,12722,73,63502,California
Fresno,2021-02-01,3369,79561,1664,47085,1705,32476,0,0,1769,50963,1598,14320,1781,65283,California
Fresno,2021-02-02,2756,82317,565,47650,2191,34667,0,0,1586,51410,1155,15475,1602,66885,California
Fresno,2021-02-03,3590,85907,2116,49766,1474,36141,0,0,1543,50923,2031,17506,1544,68429,California
Fresno,2021-02-04,4243,90150,1914,51680,2329,38470,0,0,1924,50563,2289,19795,1929,70358,California
Fresno,2021-02-05,5371,95521,2733,54413,2638,41108,0,0,2295,49793,3069,22864,2299,72657,California
Fresno,2021-02-06,2934,98455,2040,56453,894,42002,0,0,957,48781,1970,24834,958,73615,California
Fresno,2021-02-07,469,98924,283,56736,186,42188,0,0,267,48847,201,25035,267,73882,California
Fresno,2021-02-08,4301,103225,2287,59023,2014,44202,0,0,1816,48202,2470,27505,1825,75707,California
Fresno,2021-02-09,5350,108575,2090,61113,3260,47462,0,0,3117,49174,2155,29660,3127,78834,California
Fresno,2021-02-10,3909,112484,1230,62343,2679,50141,0,0,1951,49234,1903,31563,1963,80797,California
Fresno,2021-02-11,6484,118968,2092,64435,4392,54533,0,0,3308,49388,3159,34722,3313,84110,California
Fresno,2021-02-12,5445,124413,1392,65827,4053,58586,0,0,2702,49376,2724,37446,2712,86822,California
Fresno,2021-02-13,3762,128175,1576,67403,2186,60772,0,0,2087,49806,1662,39108,2092,88914,California
Fresno,2021-02-14,1586,129761,290,67693,1296,62068,0,0,849,49923,734,39842,851,89765,California
Fresno,2021-02-15,2904,132665,275,67968,2629,64697,0,0,1802,50631,1098,40940,1806,91571,California
Fresno,2021-02-16,6770,139435,2421,70389,4349,69046,0,0,4230,52350,2519,43459,4238,95809,California
Fresno,2021-02-17,5369,144804,2486,72875,2883,71929,0,0,2992,53012,2334,45793,2996,98805,California
Fresno,2021-02-18,6949,151753,2945,75820,4004,75933,0,0,2583,51284,4322,50115,2594,101399,California
Fresno,2021-02-19,3997,155750,1146,76966,2851,78784,0,0,1850,51004,2133,52248,1853,103252,California
Fresno,2021-02-20,4649,160399,2551,79517,2098,80882,0,0,3126,52621,1516,53764,3133,106385,California
Fresno,2021-02-21,207,160606,187,79704,20,80902,0,0,134,52697,58,53822,134,106519,California
Fresno,2021-02-22,2351,162957,1054,80758,1297,82199,0,0,1280,52920,1060,54882,1283,107802,California
Fresno,2021-02-23,4813,167770,2337,83095,2476,84675,0,0,3891,55906,907,55789,3893,111695,California
Fresno,2021-02-24,4338,172108,1550,84645,2788,87463,0,0,3522,58631,801,56590,3526,115221,California
Fresno,2021-02-25,8937,181045,3843,88488,5094,92557,0,0,7360,64491,1508,58098,7368,122589,California
Fresno,2021-02-26,9363,190408,3855,92343,5508,98065,0,0,7964,71089,1371,59469,7969,130558,California
Fresno,2021-02-27,7539,197947,3243,95586,4295,102360,1,1,6786,77146,735,60204,6792,137350,California
Fresno,2021-02-28,1718,199665,551,96137,1167,103527,0,1,1614,78673,88,60292,1615,138965,California
Fresno,2021-03-01,5280,204945,1400,97537,3879,107406,1,2,3824,81067,1435,61727,3829,142794,California
Fresno,2021-03-02,10046,214991,3459,100996,6587,113993,0,2,8611,88296,1410,63137,8639,151433,California
Fresno,2021-03-03,7162,222153,1810,102806,5350,119343,2,4,6125,93510,1024,64161,6238,157671,California
Fresno,2021-03-04,10655,232808,4182,106988,6473,125816,0,4,8858,100610,1769,65930,8869,166540,California
Fresno,2021-03-05,9649,242457,3750,110738,5897,131713,2,6,8308,107781,1214,67144,8385,174925,California
Fresno,2021-03-06,7155,249612,3988,114726,3047,134760,120,126,6141,113044,1003,68147,6266,181191,California
Fresno,2021-03-07,1573,251185,694,115420,797,135557,82,208,1298,114153,272,68419,1381,182572,California
Fresno,2021-03-08,5383,256568,2070,117490,3145,138702,168,376,4061,117085,1309,69728,4241,186813,California
Fresno,2021-03-09,8704,265272,3812,121302,4617,143319,275,651,4684,118084,3997,73725,4996,191809,California
Fresno,2021-03-10,6915,272187,2895,124197,3629,146948,391,1042,5381,122338,1524,75249,5778,197587,California
Fresno,2021-03-11,11639,283826,4602,128799,6485,153433,552,1594,6320,123990,5292,80541,6944,204531,California
Fresno,2021-03-12,12089,295915,5166,133965,6493,159926,430,2024,9065,130621,2998,83539,9629,214160,California
Fresno,2021-03-13,8360,304275,4080,138045,3260,163186,1020,3044,4002,131385,4332,87871,5096,219256,California
Fresno,2021-03-14,1786,306061,483,138528,1015,164201,288,3332,675,131249,1099,88970,963,220219,California
Fresno,2021-03-15,7155,313216,3189,141717,3791,167992,175,3507,4934,134354,2206,91176,5311,225530,California
Fresno,2021-03-16,10248,323464,4565,146282,5287,173279,396,3903,5403,135436,4811,95987,5893,231423,California
Fresno,2021-03-17,8769,332233,3996,150278,4060,177339,713,4616,5918,139653,2823,98810,7040,238463,California
Fresno,2021-03-18,12604,344837,6830,157108,5098,182437,676,5292,7024,142316,5531,104341,8194,246657,California
Fresno,2021-03-19,11294,356131,5994,163102,4683,187120,617,5909,6874,145800,4383,108724,7867,254524,California
Fresno,2021-03-20,7694,363825,4670,167772,2698,189818,326,6235,3754,146286,3911,112635,4397,258921,California
Fresno,2021-03-21,1853,365678,1263,169035,212,190030,378,6613,1012,146839,838,113473,1391,260312,California
Fresno,2021-03-22,5742,371420,2950,171985,2193,192223,599,7212,3795,149547,1926,115399,4634,264946,California
Fresno,2021-03-23,10726,382146,5382,177367,4836,197059,508,7720,5081,149967,5618,121017,6038,270984,California
Fresno,2021-03-24,8965,391111,3879,181246,4246,201305,840,8560,4964,151856,3961,124978,5850,276834,California
Fresno,2021-03-25,12314,403425,5736,186982,5752,207057,826,9386,4705,149915,7551,132529,5610,282444,California
Fresno,2021-03-26,12322,415747,5498,192480,6173,213230,651,10037,4320,146967,7941,140470,4993,287437,California
Fresno,2021-03-27,10179,425926,4888,197368,4209,217439,1082,11119,2879,143672,7257,147727,3962,291399,California
Fresno,2021-03-28,3454,429380,1336,198704,1417,218856,701,11820,1090,143562,2350,150077,2240,293639,California
Fresno,2021-03-29,6034,435414,2035,200739,3458,222314,541,12361,2847,143803,3159,153236,3400,297039,California
Fresno,2021-03-30,11065,446479,4293,205032,5864,228178,908,13269,3749,141182,7277,160513,4656,301695,California
Fresno,2021-03-31,9793,456272,3419,208451,5352,233530,1022,14291,3643,139736,6100,166613,4654,306349,California
Fresno,2021-04-01,12281,468553,4221,212672,7196,240726,864,15155,3968,136316,8202,174815,4782,311131,California
Fresno,2021-04-02,12163,480716,4652,217324,6716,247442,795,15950,4108,133312,7908,182723,4904,316035,California
Fresno,2021-04-03,6455,487171,3541,220865,2644,250086,270,16220,2117,131417,4316,187039,2421,318456,California
Fresno,2021-04-04,1511,488682,537,221402,927,251013,47,16267,536,131036,964,188003,583,319039,California
Fresno,2021-04-05,8405,497087,4509,225911,3080,254093,816,17083,2453,128441,5932,193935,3337,322376,California
Fresno,2021-04-06,9734,506821,4072,229983,4456,258549,1206,18289,3553,127078,6138,200073,4775,327151,California
Fresno,2021-04-07,10684,517505,5521,235504,3925,262474,1238,19527,3548,124799,7085,207158,4806,331957,California
Fresno,2021-04-08,11070,528575,5247,240751,4645,267119,1178,20705,3479,121956,7531,214689,4688,336645,California
Fresno,2021-04-09,11844,540419,5536,246287,4882,272001,1426,22131,3706,119017,8086,222775,5147,341792,California
Fresno,2021-04-10,7940,548359,5187,251474,2227,274228,526,22657,3677,118977,4240,227015,4200,345992,California
Fresno,2021-04-11,1406,549765,945,252419,369,274597,92,22749,448,118568,950,227965,541,346533,California
Fresno,2021-04-12,7669,557434,4134,256553,2579,277176,956,23705,2459,116803,5178,233143,3413,349946,California
Fresno,2021-04-13,9098,566532,4356,260909,4673,281849,69,23774,3539,114994,5513,238656,3704,353650,California
Fresno,2021-04-14,9782,576314,5820,266729,3961,285810,1,23775,3781,112873,5951,244607,3830,357480,California
Fresno,2021-04-15,8511,584825,4228,270957,4279,290089,4,23779,3150,110702,5327,249934,3156,360636,California
Fresno,2021-04-16,9659,594484,4705,275662,4952,295041,2,23781,3923,108945,5688,255622,3931,364567,California
Fresno,2021-04-17,5687,600171,3794,279456,1893,296934,0,23781,2668,108625,2991,258613,2671,367238,California
Fresno,2021-04-18,1172,601343,687,280143,485,297419,0,23781,525,108509,641,259254,525,367763,California
Fresno,2021-04-19,5831,607174,3252,283395,2576,299995,3,23784,2250,107227,3538,262792,2256,370019,California
Fresno,2021-04-20,7209,614383,3678,287073,3523,303518,8,23792,2654,105363,4525,267317,2661,372680,California
Fresno,2021-04-21,7120,621503,4230,291303,2881,306399,9,23801,2871,104047,4200,271517,2884,375564,California
Fresno,2021-04-22,6636,628139,3399,294702,3236,309635,1,23802,2432,102348,4135,275652,2436,378000,California
Fresno,2021-04-23,7467,635606,4124,298826,3326,312961,17,23819,2851,100686,4519,280171,2857,380857,California
Fresno,2021-04-24,4235,639841,2536,301362,1699,314660,0,23819,1922,100323,2285,282456,1922,382779,California
Fresno,2021-04-25,1392,641233,563,301925,826,315486,3,23822,695,100332,689,283145,698,383477,California
Fresno,2021-04-26,4394,645627,2260,304185,2088,317574,46,23868,1846,99710,2513,285658,1891,385368,California
Fresno,2021-04-27,4978,650605,2561,306746,2291,319865,126,23994,1947,98779,3002,288660,2071,387439,California
Fresno,2021-04-28,4975,655580,2845,309591,2000,321865,130,24124,2087,98139,2857,291517,2217,389656,California
Fresno,2021-04-29,4986,660566,2796,312387,2052,323917,138,24262,1900,97122,3051,294568,2034,391690,California
Fresno,2021-04-30,5641,666207,3465,315852,2043,325960,133,24395,2259,96172,3341,297909,2391,394081,California
Fresno,2021-05-01,4222,670429,3464,319316,621,326581,137,24532,1260,94631,2937,300846,1396,395477,California
Fresno,2021-05-02,1276,671705,792,320108,431,327012,53,24585,630,94680,631,301477,680,396157,California
Fresno,2021-05-03,4162,675867,2780,322888,1185,328197,197,24782,1329,93399,2801,304278,1520,397677,California
Fresno,2021-05-04,5027,680894,2664,325552,2210,330407,153,24935,1591,91737,3408,307686,1746,399423,California
Fresno,2021-05-05,5458,686352,3470,329022,1761,332168,227,25162,1695,89923,3732,311418,1918,401341,California
Fresno,2021-05-06,4603,690955,3001,332023,1499,333667,103,25265,1580,88618,2988,314406,1683,403024,California
Fresno,2021-05-07,5196,696151,3452,335475,1578,335245,166,25431,1604,86819,3565,317971,1766,404790,California
Fresno,2021-05-08,4143,700294,2697,338172,1295,336540,151,25582,1286,85427,2828,320799,1436,406226,California
Fresno,2021-05-09,723,701017,391,338563,287,336827,45,25627,350,85455,367,321166,395,406621,California
Fresno,2021-05-10,3024,704041,1621,340184,1260,338087,143,25770,937,84459,2076,323242,1080,407701,California
Fresno,2021-05-11,3992,708033,2132,342316,1762,339849,98,25868,1286,83153,2690,325932,1384,409085,California
Fresno,2021-05-12,4213,712246,2742,345058,1307,341156,164,26032,1416,81969,2765,328697,1581,410666,California
Fresno,2021-05-13,4236,716482,2482,347540,1652,342808,102,26134,1890,81657,2305,331002,1993,412659,California
Fresno,2021-05-14,5192,721674,3134,350674,1872,344680,186,26320,2184,81055,2973,333975,2371,415030,California
Fresno,2021-05-15,3686,725360,2768,353442,785,345465,133,26453,1885,81285,1785,335760,2015,417045,California
Fresno,2021-05-16,1599,726959,1092,354534,473,345938,34,26487,920,81568,672,336432,955,418000,California
Fresno,2021-05-17,4240,731199,2869,357403,1211,347149,160,26647,2237,81992,1971,338403,2395,420395,California
Fresno,2021-05-18,4148,735347,2564,359967,1430,348579,154,26801,2085,82193,2035,340438,2236,422631,California
Fresno,2021-05-19,4388,739735,2787,362754,1426,350005,175,26976,2080,82166,2283,342721,2256,424887,California
Fresno,2021-05-20,4188,743923,2514,365268,1482,351487,192,27168,1921,82034,2242,344963,2110,426997,California
Fresno,2021-05-21,4720,748643,3098,368366,1524,353011,98,27266,2126,81695,2560,347523,2221,429218,California
Fresno,2021-05-22,4028,752671,2988,371354,865,353876,175,27441,2311,82481,1698,349221,2484,431702,California
Fresno,2021-05-23,1030,753701,696,372050,304,354180,30,27471,530,82551,490,349711,560,432262,California
Fresno,2021-05-24,3360,757061,2147,374197,1096,355276,117,27588,1555,82443,1779,351490,1671,433933,California
Fresno,2021-05-25,3258,760319,1950,376147,1182,356458,126,27714,1370,82062,1875,353365,1494,435427,California
Fresno,2021-05-26,3291,763610,2171,378318,1012,357470,108,27822,1596,82090,1674,355039,1702,437129,California
Fresno,2021-05-27,3214,766824,1964,380282,1143,358613,107,27929,1342,81693,1848,356887,1451,438580,California
Fresno,2021-05-28,3511,770335,2254,382536,1159,359772,98,28027,1905,82118,1577,358464,2002,440582,California
Fresno,2021-05-29,2320,772655,1685,384221,563,360335,72,28099,1203,82288,1106,359570,1276,441858,California
Fresno,2021-05-30,906,773561,544,384765,326,360661,36,28135,418,82273,468,360038,453,442311,California
Fresno,2021-05-31,326,773887,161,384926,154,360815,11,28146,135,82233,184,360222,144,442455,California
Fresno,2021-06-01,3073,776960,1852,386778,1120,361935,101,28247,1154,81590,1895,362117,1252,443707,California
Fresno,2021-06-02,2712,779672,1755,388533,868,362803,89,28336,1078,81159,1600,363717,1169,444876,California
Fresno,2021-06-03,3026,782698,2081,390614,841,363644,104,28440,1144,80543,1861,365578,1245,446121,California
Fresno,2021-06-04,3309,786007,2405,393019,802,364446,102,28542,1103,79570,2178,367756,1205,447326,California
Fresno,2021-06-05,3162,789169,2335,395354,701,365147,126,28668,1235,79028,1901,369657,1359,448685,California
Fresno,2021-06-06,1189,790358,943,396297,208,365355,38,28706,345,78576,836,370493,384,449069,California
Fresno,2021-06-07,3146,793504,2470,398767,585,365940,91,28797,912,77369,2210,372703,1003,450072,California
Fresno,2021-06-08,2790,796294,2048,400815,656,366596,86,28883,812,76302,1964,374667,897,450969,California
Fresno,2021-06-09,2977,799271,2215,403030,663,367259,99,28982,980,75402,1977,376644,1077,452046,California
Fresno,2021-06-10,2686,801957,1951,404981,663,367922,72,29054,913,74636,1750,378394,984,453030,California
Fresno,2021-06-11,3274,805231,2299,407280,862,368784,113,29167,1199,73911,2036,380430,1311,454341,California
Fresno,2021-06-12,2948,808179,2338,409618,444,369228,166,29333,785,72709,2148,382578,946,455287,California
Fresno,2021-06-13,714,808893,461,410079,237,369465,16,29349,188,72391,522,383100,204,455491,California
Fresno,2021-06-14,2576,811469,1871,411950,569,370034,136,29485,971,71914,1582,384682,1105,456596,California
Fresno,2021-06-15,2422,813891,1737,413687,603,370637,82,29567,958,71505,1446,386128,1037,457633,California
Fresno,2021-06-16,2681,816572,1923,415610,644,371281,114,29681,1065,71081,1601,387729,1177,458810,California
Fresno,2021-06-17,2290,818862,1603,417213,591,371872,96,29777,957,70817,1315,389044,1051,459861,California
Fresno,2021-06-18,3039,821901,2168,419381,753,372625,118,29895,1202,70317,1820,390864,1320,461181,California
Fresno,2021-06-19,1701,823602,1257,420638,368,372993,76,29971,579,69853,1117,391981,653,461834,California
Fresno,2021-06-20,503,824105,354,420992,138,373131,11,29982,194,69757,301,392282,205,462039,California
Fresno,2021-06-21,1646,825751,1096,422088,484,373615,66,30048,948,70086,685,392967,1014,463053,California
Fresno,2021-06-22,2193,827944,1517,423605,566,374181,110,30158,1017,70049,1161,394128,1124,464177,California
Fresno,2021-06-23,2073,830017,1484,425089,522,374703,67,30225,1016,70091,1039,395167,1081,465258,California
Fresno,2021-06-24,2035,832052,1441,426530,517,375220,77,30302,911,69972,1106,396273,987,466245,California
Fresno,2021-06-25,2078,834130,1443,427973,551,375771,84,30386,971,69942,1085,397358,1055,467300,California
Fresno,2021-06-26,1842,835972,1426,429399,316,376087,100,30486,717,69639,1120,398478,817,468117,California
Fresno,2021-06-27,924,836896,683,430082,142,376229,99,30585,472,69760,447,398925,568,468685,California
Fresno,2021-06-28,1651,838547,1250,431332,303,376532,98,30683,736,69685,906,399831,831,469516,California
Fresno,2021-06-29,1824,840371,1206,432538,531,377063,87,30770,820,69598,993,400824,906,470422,California
Fresno,2021-06-30,1760,842131,1202,433740,467,377530,91,30861,778,69500,967,401791,869,471291,California
Fresno,2021-07-01,1615,843746,1171,434911,376,377906,68,30929,703,69368,901,402692,769,472060,California
Fresno,2021-07-02,1753,845499,1251,436162,436,378342,66,30995,838,69366,905,403597,903,472963,California
Fresno,2021-07-03,1098,846597,808,436970,259,378601,31,31026,544,69401,540,404137,575,473538,California
Fresno,2021-07-04,88,846685,28,436998,53,378654,7,31033,34,69387,54,404191,40,473578,California
Fresno,2021-07-05,1022,847707,737,437735,244,378898,41,31074,454,69317,564,404755,494,474072,California
Fresno,2021-07-06,2089,849796,1462,439197,538,379436,89,31163,838,69019,1224,405979,926,474998,California
Fresno,2021-07-07,1816,851612,1378,440575,365,379801,73,31236,788,68865,1013,406992,859,475857,California
Fresno,2021-07-08,1771,853383,1158,441733,492,380293,121,31357,758,68741,1001,407993,877,476734,California
Fresno,2021-07-09,2105,855488,1529,443262,490,380783,86,31443,926,68588,1165,409158,1012,477746,California
Fresno,2021-07-10,1188,856676,834,444096,270,381053,84,31527,475,68444,703,409861,559,478305,California
Fresno,2021-07-11,482,857158,356,444452,116,381169,10,31537,249,68477,226,410087,259,478564,California
Fresno,2021-07-12,1671,858829,1269,445721,336,381505,66,31603,728,68340,930,411017,793,479357,California
Fresno,2021-07-13,1630,860459,1161,446882,434,381939,35,31638,682,68123,936,411953,719,480076,California
Fresno,2021-07-14,1925,862384,1386,448268,474,382413,65,31703,842,67961,1069,413022,907,480983,California
Fresno,2021-07-15,1569,863953,1104,449372,431,382844,34,31737,799,68033,761,413783,833,481816,California
Fresno,2021-07-16,2130,866083,1512,450884,544,383388,74,31811,1014,68021,1100,414883,1088,482904,California
Fresno,2021-07-17,1342,867425,1011,451895,279,383667,52,31863,635,68017,691,415574,687,483591,California
Fresno,2021-07-18,628,868053,499,452394,122,383789,7,31870,323,68049,297,415871,329,483920,California
Fresno,2021-07-19,1798,869851,1364,453758,364,384153,70,31940,939,68209,850,416721,1010,484930,California
Fresno,2021-07-20,1780,871631,1234,454992,494,384647,52,31992,940,68380,822,417543,993,485923,California
Fresno,2021-07-21,1904,873535,1398,456390,454,385101,52,32044,1057,68665,824,418367,1109,487032,California
Fresno,2021-07-22,1804,875339,1290,457680,451,385552,63,32107,1048,69044,729,419096,1108,488140,California
Fresno,2021-07-23,2294,877633,1675,459355,543,386095,76,32183,1333,69505,946,420042,1407,489547,California
Fresno,2021-07-24,1289,878922,956,460311,305,386400,28,32211,778,69810,500,420542,805,490352,California
Fresno,2021-07-25,547,879469,394,460705,151,386551,2,32213,424,70117,120,420662,427,490779,California
Fresno,2021-07-26,1887,881356,1420,462125,416,386967,51,32264,1227,70745,648,421310,1276,492055,California
Fresno,2021-07-27,1906,883262,1318,463443,544,387511,44,32308,1160,71211,737,422047,1203,493258,California
Fresno,2021-07-28,2388,885650,1764,465207,555,388066,69,32377,1474,71855,895,422942,1539,494797,California
Fresno,2021-07-29,2063,887713,1492,466699,517,388583,54,32431,1286,72436,759,423701,1340,496137,California
Fresno,2021-07-30,2609,890322,1931,468630,606,389189,72,32503,1659,73234,933,424634,1731,497868,California
Fresno,2021-07-31,1431,891753,1027,469657,363,389552,41,32544,911,73683,504,425138,953,498821,California
Fresno,2021-08-01,802,892555,636,470293,160,389712,6,32550,573,74035,227,425365,579,499400,California
Fresno,2021-08-02,2207,894762,1693,471986,447,390159,67,32617,1470,74847,724,426089,1536,500936,California
Fresno,2021-08-03,2463,897225,1850,473836,555,390714,58,32675,1685,75842,745,426834,1740,502676,California
Fresno,2021-08-04,2545,899770,1891,475727,536,391250,118,32793,1711,76854,815,427649,1827,504503,California
Fresno,2021-08-05,2434,902204,1837,477564,524,391774,73,32866,1635,77774,783,428432,1703,506206,California
Fresno,2021-08-06,2917,905121,2217,479781,628,392402,72,32938,1921,78797,970,429402,1993,508199,California
Fresno,2021-08-07,1654,906775,1228,481009,364,392766,62,33000,1098,79414,543,429945,1160,509359,California
Fresno,2021-08-08,1000,907775,711,481720,261,393027,28,33028,674,79796,320,430265,702,510061,California
Fresno,2021-08-09,2755,910530,2104,483824,583,393610,68,33096,1826,80780,908,431173,1892,511953,California
Fresno,2021-08-10,2592,913122,2022,485846,504,394114,66,33162,1698,81671,872,432045,1763,513716,California
Fresno,2021-08-11,2555,915677,1928,487774,544,394658,83,33245,1604,82426,930,432975,1685,515401,California
Fresno,2021-08-12,2358,918035,1631,489405,619,395277,108,33353,1426,83051,905,433880,1530,516931,California
Fresno,2021-08-13,3116,921151,2293,491698,736,396013,87,33440,1819,83697,1258,435138,1904,518835,California
Fresno,2021-08-14,1786,922937,1321,493019,427,396440,38,33478,1049,84111,673,435811,1087,519922,California
Fresno,2021-08-15,882,923819,657,493676,215,396655,10,33488,515,84311,325,436136,525,520447,California
Fresno,2021-08-16,2561,926380,1866,495542,623,397278,72,33560,1333,84629,1086,437222,1404,521851,California
Fresno,2021-08-17,2583,928963,1832,497374,686,397964,65,33625,1458,85161,992,438214,1524,523375,California
Fresno,2021-08-18,2876,931839,2067,499441,710,398674,99,33724,1460,85457,1264,439478,1560,524935,California
Fresno,2021-08-19,2706,934545,1943,501384,691,399365,72,33796,1486,85971,1045,440523,1559,526494,California
Fresno,2021-08-20,3745,938290,2616,504000,983,400348,146,33942,1950,86506,1561,442084,2096,528590,California
Fresno,2021-08-21,2002,940292,1533,505533,432,400780,37,33979,976,86597,921,443005,1012,529602,California
Fresno,2021-08-22,1102,941394,833,506366,259,401039,10,33989,514,86601,519,443524,523,530125,California
Fresno,2021-08-23,2967,944361,2290,508656,607,401646,70,34059,1497,86856,1312,444836,1567,531692,California
Fresno,2021-08-24,2868,947229,2227,510883,579,402225,62,34121,1397,86985,1331,446167,1460,533152,California
Fresno,2021-08-25,2981,950210,2257,513140,648,402873,76,34197,1340,86915,1487,447654,1417,534569,California
Fresno,2021-08-26,2746,952956,1992,515132,688,403561,66,34263,1274,87012,1243,448897,1340,535909,California
Fresno,2021-08-27,3513,956469,2685,517817,722,404283,106,34369,1504,86847,1777,450674,1612,537521,California
Fresno,2021-08-28,2197,958666,1750,519567,417,404700,30,34399,974,86741,1111,451785,1005,538526,California
Fresno,2021-08-29,1105,959771,826,520393,265,404965,14,34413,490,86685,560,452345,504,539030,California
Fresno,2021-08-30,1849,961620,1334,521727,453,405418,62,34475,699,86442,1006,453351,763,539793,California
Glenn,2020-12-17,1,1,1,1,0,0,0,0,1,1,0,0,1,1,California
Glenn,2020-12-20,1,2,1,2,0,0,0,0,1,2,0,0,1,2,California
Glenn,2020-12-21,10,12,10,12,0,0,0,0,10,12,0,0,10,12,California
Glenn,2020-12-22,60,72,60,72,0,0,0,0,60,72,0,0,60,72,California
Glenn,2020-12-23,28,100,28,100,0,0,0,0,28,100,0,0,28,100,California
Glenn,2020-12-24,10,110,10,110,0,0,0,0,10,110,0,0,10,110,California
Glenn,2020-12-26,2,112,2,112,0,0,0,0,2,112,0,0,2,112,California
Glenn,2020-12-27,4,116,4,116,0,0,0,0,4,116,0,0,4,116,California
Glenn,2020-12-28,21,137,21,137,0,0,0,0,21,137,0,0,21,137,California
Glenn,2020-12-29,82,219,82,219,0,0,0,0,82,219,0,0,82,219,California
Glenn,2020-12-30,127,346,104,323,23,23,0,0,127,346,0,0,127,346,California
Glenn,2020-12-31,36,382,8,331,28,51,0,0,36,382,0,0,36,382,California
Glenn,2021-01-02,4,386,4,335,0,51,0,0,4,386,0,0,4,386,California
Glenn,2021-01-04,7,393,5,340,2,53,0,0,7,393,0,0,7,393,California
Glenn,2021-01-05,12,405,9,349,3,56,0,0,12,405,0,0,12,405,California
Glenn,2021-01-06,59,464,8,357,51,107,0,0,59,464,0,0,59,464,California
Glenn,2021-01-07,64,528,10,367,54,161,0,0,63,526,1,1,63,527,California
Glenn,2021-01-08,12,540,9,376,3,164,0,0,12,538,0,1,12,539,California
Glenn,2021-01-10,1,541,1,377,0,164,0,0,0,537,1,2,0,539,California
Glenn,2021-01-11,31,572,30,407,1,165,0,0,13,532,18,20,13,552,California
Glenn,2021-01-12,45,617,39,446,6,171,0,0,15,517,30,50,15,567,California
Glenn,2021-01-13,221,838,157,603,64,235,0,0,178,652,43,93,178,745,California
Glenn,2021-01-14,120,958,30,633,90,325,0,0,109,751,10,103,109,854,California
Glenn,2021-01-15,42,1000,34,667,8,333,0,0,37,783,5,108,37,891,California
Glenn,2021-01-16,35,1035,14,681,21,354,0,0,25,798,10,118,25,916,California
Glenn,2021-01-17,5,1040,3,684,2,356,0,0,2,797,3,121,2,918,California
Glenn,2021-01-18,18,1058,17,701,1,357,0,0,9,797,9,130,9,927,California
Glenn,2021-01-19,30,1088,20,721,10,367,0,0,13,793,17,147,13,940,California
Glenn,2021-01-20,162,1250,93,814,69,436,0,0,82,795,80,227,82,1022,California
Glenn,2021-01-21,120,1370,94,908,26,462,0,0,29,733,91,318,29,1051,California
Glenn,2021-01-22,340,1710,65,973,275,737,0,0,333,1059,7,325,333,1384,California
Glenn,2021-01-23,16,1726,10,983,6,743,0,0,12,1067,4,329,12,1396,California
Glenn,2021-01-24,2,1728,2,985,0,743,0,0,2,1069,0,329,2,1398,California
Glenn,2021-01-25,27,1755,9,994,18,761,0,0,24,1090,3,332,24,1422,California
Glenn,2021-01-26,34,1789,15,1009,19,780,0,0,27,1110,7,339,27,1449,California
Glenn,2021-01-27,186,1975,11,1020,175,955,0,0,165,1254,21,360,165,1614,California
Glenn,2021-01-28,155,2130,9,1029,146,1101,0,0,118,1335,37,397,118,1732,California
Glenn,2021-01-29,300,2430,12,1041,288,1389,0,0,287,1609,13,410,287,2019,California
Glenn,2021-01-30,3,2433,0,1041,3,1392,0,0,3,1612,0,410,3,2022,California
Glenn,2021-01-31,1,2434,0,1041,1,1393,0,0,1,1613,0,410,1,2023,California
Glenn,2021-02-01,31,2465,11,1052,20,1413,0,0,19,1620,12,422,19,2042,California
Glenn,2021-02-02,32,2497,16,1068,16,1429,0,0,22,1632,10,432,22,2064,California
Glenn,2021-02-03,285,2782,129,1197,156,1585,0,0,137,1622,148,580,138,2202,California
Glenn,2021-02-04,81,2863,14,1211,67,1652,0,0,24,1589,57,637,24,2226,California
Glenn,2021-02-05,324,3187,25,1236,299,1951,0,0,303,1871,21,658,303,2529,California
Glenn,2021-02-06,20,3207,2,1238,18,1969,0,0,19,1889,1,659,19,2548,California
Glenn,2021-02-07,2,3209,2,1240,0,1969,0,0,2,1891,0,659,2,2550,California
Glenn,2021-02-08,22,3231,17,1257,5,1974,0,0,6,1881,16,675,6,2556,California
Glenn,2021-02-09,52,3283,19,1276,33,2007,0,0,37,1903,15,690,37,2593,California
Glenn,2021-02-10,143,3426,18,1294,125,2132,0,0,74,1908,69,759,74,2667,California
Glenn,2021-02-11,270,3696,168,1462,102,2234,0,0,185,2009,85,844,186,2853,California
Glenn,2021-02-12,414,4110,96,1558,318,2552,0,0,349,2293,65,909,349,3202,California
Glenn,2021-02-13,38,4148,9,1567,29,2581,0,0,16,2287,22,931,16,3218,California
Glenn,2021-02-14,1,4149,0,1567,1,2582,0,0,1,2288,0,931,1,3219,California
Glenn,2021-02-15,10,4159,1,1568,9,2591,0,0,8,2294,2,933,8,3227,California
Glenn,2021-02-16,45,4204,9,1577,36,2627,0,0,26,2301,19,952,26,3253,California
Glenn,2021-02-17,385,4589,14,1591,371,2998,0,0,305,2526,80,1032,305,3558,California
Glenn,2021-02-18,186,4775,151,1742,35,3033,0,0,161,2663,24,1056,161,3719,California
Glenn,2021-02-19,305,5080,16,1758,289,3322,0,0,29,2416,276,1332,29,3748,California
Glenn,2021-02-20,10,5090,0,1758,10,3332,0,0,2,2410,8,1340,2,3750,California
Glenn,2021-02-22,38,5128,18,1776,20,3352,0,0,19,2411,18,1358,19,3769,California
Glenn,2021-02-23,45,5173,12,1788,33,3385,0,0,30,2426,15,1373,30,3799,California
Glenn,2021-02-24,270,5443,54,1842,216,3601,0,0,58,2272,212,1585,58,3857,California
Glenn,2021-02-25,345,5788,227,2069,118,3719,0,0,230,2385,117,1702,230,4087,California
Glenn,2021-02-26,311,6099,25,2094,286,4005,0,0,22,2119,288,1990,22,4109,California
Glenn,2021-02-27,13,6112,4,2098,9,4014,0,0,5,2117,7,1997,5,4114,California
Glenn,2021-02-28,6,6118,3,2101,3,4017,0,0,3,2118,2,1999,3,4117,California
Glenn,2021-03-01,29,6147,7,2108,22,4039,0,0,12,2114,16,2015,12,4129,California
Glenn,2021-03-02,40,6187,10,2118,30,4069,0,0,21,2116,19,2034,21,4150,California
Glenn,2021-03-03,222,6409,39,2157,183,4252,0,0,121,2138,99,2133,121,4271,California
Glenn,2021-03-04,546,6955,204,2361,342,4594,0,0,362,2316,184,2317,362,4633,California
Glenn,2021-03-05,362,7317,47,2408,315,4909,0,0,36,2026,326,2643,36,4669,California
Glenn,2021-03-06,33,7350,3,2411,29,4938,1,1,10,2014,23,2666,11,4680,California
Glenn,2021-03-07,5,7355,0,2411,5,4943,0,1,3,2016,1,2667,3,4683,California
Glenn,2021-03-08,20,7375,3,2414,16,4959,1,2,18,2033,2,2669,19,4702,California
Glenn,2021-03-09,84,7459,11,2425,69,5028,4,6,52,2056,32,2701,55,4757,California
Glenn,2021-03-10,191,7650,81,2506,108,5136,2,8,105,2077,86,2787,107,4864,California
Glenn,2021-03-11,601,8251,184,2690,394,5530,23,31,416,2334,185,2972,442,5306,California
Glenn,2021-03-12,417,8668,13,2703,340,5870,64,95,40,2061,377,3349,104,5410,California
Glenn,2021-03-13,12,8680,1,2704,3,5873,8,103,1,2059,11,3360,9,5419,California
Glenn,2021-03-14,1,8681,0,2704,1,5874,0,103,0,2058,1,3361,0,5419,California
Glenn,2021-03-15,77,8758,16,2720,56,5930,5,108,60,2106,17,3378,65,5484,California
Glenn,2021-03-16,116,8874,34,2754,71,6001,11,119,70,2141,46,3424,81,5565,California
Glenn,2021-03-17,421,9295,103,2857,311,6312,7,126,116,1957,305,3729,121,5686,California
Glenn,2021-03-18,539,9834,235,3092,49,6361,255,381,54,1779,485,4214,307,5993,California
Glenn,2021-03-19,98,9932,16,3108,75,6436,7,388,75,1839,22,4236,82,6075,California
Glenn,2021-03-20,134,10066,2,3110,131,6567,1,389,130,1966,4,4240,131,6206,California
Glenn,2021-03-21,6,10072,5,3115,0,6567,1,390,3,1968,2,4242,4,6210,California
Glenn,2021-03-22,123,10195,56,3171,60,6627,7,397,104,2061,17,4259,110,6320,California
Glenn,2021-03-23,178,10373,67,3238,62,6689,49,446,107,2146,70,4329,155,6475,California
Glenn,2021-03-24,213,10586,105,3343,103,6792,5,451,122,2184,89,4418,127,6602,California
Glenn,2021-03-25,520,11106,277,3620,150,6942,93,544,385,2529,133,4551,478,7080,California
Glenn,2021-03-26,244,11350,37,3657,171,7113,36,580,194,2709,50,4601,230,7310,California
Glenn,2021-03-27,168,11518,20,3677,142,7255,6,586,155,2858,12,4613,161,7471,California
Glenn,2021-03-28,16,11534,11,3688,5,7260,0,586,11,2864,5,4618,11,7482,California
Glenn,2021-03-29,60,11594,20,3708,37,7297,3,589,45,2897,15,4633,48,7530,California
Glenn,2021-03-30,71,11665,40,3748,30,7327,1,590,40,2909,29,4662,41,7571,California
Glenn,2021-03-31,132,11797,36,3784,95,7422,1,591,43,2865,88,4750,44,7615,California
Glenn,2021-04-01,672,12469,206,3990,457,7879,9,600,248,2700,422,5172,257,7872,California
Glenn,2021-04-02,169,12638,26,4016,132,8011,11,611,131,2804,38,5210,142,8014,California
Glenn,2021-04-03,95,12733,4,4020,84,8095,7,618,84,2884,11,5221,91,8105,California
Glenn,2021-04-04,11,12744,5,4025,4,8099,2,620,7,2889,4,5225,9,8114,California
Glenn,2021-04-05,70,12814,28,4053,29,8128,13,633,32,2896,38,5263,45,8159,California
Glenn,2021-04-06,142,12956,52,4105,51,8179,39,672,36,2865,105,5368,74,8233,California
Glenn,2021-04-07,162,13118,48,4153,60,8239,54,726,75,2907,87,5455,129,8362,California
Glenn,2021-04-08,672,13790,214,4367,423,8662,35,761,159,2590,511,5966,194,8556,California
Glenn,2021-04-09,160,13950,57,4424,86,8748,17,778,103,2652,57,6023,119,8675,California
Glenn,2021-04-10,81,14031,1,4425,60,8808,20,798,58,2708,22,6045,78,8753,California
Glenn,2021-04-11,16,14047,8,4433,3,8811,5,803,7,2711,9,6054,12,8765,California
Glenn,2021-04-12,118,14165,26,4459,62,8873,30,833,22,2667,96,6150,52,8817,California
Glenn,2021-04-13,119,14284,64,4523,55,8928,0,833,29,2606,90,6240,29,8846,California
Glenn,2021-04-14,122,14406,45,4568,77,9005,0,833,69,2622,53,6293,69,8915,California
Glenn,2021-04-15,360,14766,276,4844,84,9089,0,833,74,2411,285,6578,74,8989,California
Glenn,2021-04-16,166,14932,40,4884,126,9215,0,833,77,2399,89,6667,77,9066,California
Glenn,2021-04-17,169,15101,16,4900,153,9368,0,833,31,2300,130,6797,31,9097,California
Glenn,2021-04-18,21,15122,7,4907,14,9382,0,833,16,2311,5,6802,16,9113,California
Glenn,2021-04-19,85,15207,17,4924,68,9450,0,833,24,2275,60,6862,24,9137,California
Glenn,2021-04-20,134,15341,88,5012,46,9496,0,833,56,2253,78,6940,56,9193,California
Glenn,2021-04-21,449,15790,349,5361,100,9596,0,833,291,2387,157,7097,291,9484,California
Glenn,2021-04-22,220,16010,54,5415,166,9762,0,833,39,2246,180,7277,39,9523,California
Glenn,2021-04-23,198,16208,37,5452,161,9923,0,833,50,2149,147,7424,50,9573,California
Glenn,2021-04-24,183,16391,32,5484,151,10074,0,833,30,2027,152,7576,30,9603,California
Glenn,2021-04-25,28,16419,17,5501,11,10085,0,833,20,2039,8,7584,20,9623,California
Glenn,2021-04-26,51,16470,15,5516,36,10121,0,833,19,2026,32,7616,19,9642,California
Glenn,2021-04-27,65,16535,50,5566,10,10131,5,838,33,2032,31,7647,37,9679,California
Glenn,2021-04-28,268,16803,189,5755,68,10199,11,849,117,2009,151,7798,128,9807,California
Glenn,2021-04-29,191,16994,28,5783,161,10360,2,851,42,1904,149,7947,44,9851,California
Glenn,2021-04-30,167,17161,41,5824,124,10484,2,853,42,1823,125,8072,44,9895,California
Glenn,2021-05-01,107,17268,13,5837,93,10577,1,854,25,1767,82,8154,26,9921,California
Glenn,2021-05-02,31,17299,13,5850,9,10586,9,863,14,1773,17,8171,23,9944,California
Glenn,2021-05-03,41,17340,26,5876,14,10600,1,864,14,1761,27,8198,15,9959,California
Glenn,2021-05-04,60,17400,36,5912,19,10619,5,869,28,1762,32,8230,33,9992,California
Glenn,2021-05-05,128,17528,39,5951,78,10697,11,880,52,1749,76,8306,63,10055,California
Glenn,2021-05-06,115,17643,42,5993,67,10764,6,886,43,1726,72,8378,49,10104,California
Glenn,2021-05-07,122,17765,35,6028,78,10842,9,895,30,1674,91,8469,39,10143,California
Glenn,2021-05-08,66,17831,12,6040,50,10892,4,899,21,1655,44,8513,25,10168,California
Glenn,2021-05-09,17,17848,11,6051,6,10898,0,899,11,1660,6,8519,11,10179,California
Glenn,2021-05-10,37,17885,15,6066,17,10915,5,904,13,1654,24,8543,18,10197,California
Glenn,2021-05-11,87,17972,61,6127,17,10932,9,913,16,1608,71,8614,25,10222,California
Glenn,2021-05-12,347,18319,264,6391,69,11001,14,927,37,1349,310,8924,51,10273,California
Glenn,2021-05-13,160,18479,60,6451,80,11081,20,947,65,1339,95,9019,85,10358,California
Glenn,2021-05-14,107,18586,24,6475,78,11159,5,952,33,1303,74,9093,38,10396,California
Glenn,2021-05-15,67,18653,40,6515,25,11184,2,954,32,1302,35,9128,34,10430,California
Glenn,2021-05-16,31,18684,17,6532,14,11198,0,954,8,1287,23,9151,8,10438,California
Glenn,2021-05-17,87,18771,61,6593,22,11220,4,958,62,1328,25,9176,66,10504,California
Glenn,2021-05-18,71,18842,50,6643,17,11237,4,962,22,1305,49,9225,26,10530,California
Glenn,2021-05-19,203,19045,120,6763,71,11308,12,974,74,1262,128,9353,85,10615,California
Glenn,2021-05-20,123,19168,80,6843,41,11349,2,976,83,1307,40,9393,85,10700,California
Glenn,2021-05-21,72,19240,27,6870,44,11393,1,977,28,1292,44,9437,29,10729,California
Glenn,2021-05-22,56,19296,23,6893,33,11426,0,977,29,1294,27,9464,29,10758,California
Glenn,2021-05-23,28,19324,15,6908,13,11439,0,977,12,1291,15,9479,12,10770,California
Glenn,2021-05-24,30,19354,11,6919,15,11454,4,981,11,1288,18,9497,15,10785,California
Glenn,2021-05-25,47,19401,35,6954,10,11464,2,983,23,1289,24,9521,25,10810,California
Glenn,2021-05-26,74,19475,15,6969,55,11519,4,987,25,1269,49,9570,29,10839,California
Glenn,2021-05-27,107,19582,67,7036,39,11558,1,988,51,1267,54,9624,52,10891,California
Glenn,2021-05-28,63,19645,19,7055,37,11595,7,995,31,1273,32,9656,38,10929,California
Glenn,2021-05-29,48,19693,12,7067,32,11627,4,999,22,1273,26,9682,26,10955,California
Glenn,2021-05-30,21,19714,13,7080,8,11635,0,999,8,1269,12,9694,8,10963,California
Glenn,2021-05-31,4,19718,0,7080,4,11639,0,999,0,1265,4,9698,0,10963,California
Glenn,2021-06-01,61,19779,35,7115,22,11661,4,1003,26,1260,35,9733,30,10993,California
Glenn,2021-06-02,100,19879,50,7165,47,11708,3,1006,41,1245,59,9792,44,11037,California
Glenn,2021-06-03,79,19958,44,7209,28,11736,7,1013,18,1210,60,9852,25,11062,California
Glenn,2021-06-04,79,20037,38,7247,37,11773,4,1017,43,1221,36,9888,47,11109,California
Glenn,2021-06-05,55,20092,30,7277,22,11795,3,1020,17,1203,38,9926,20,11129,California
Glenn,2021-06-06,32,20124,28,7305,3,11798,1,1021,16,1205,15,9941,17,11146,California
Glenn,2021-06-07,69,20193,60,7365,7,11805,2,1023,13,1165,55,9996,15,11161,California
Glenn,2021-06-08,36,20229,20,7385,11,11816,5,1028,17,1168,19,10015,22,11183,California
Glenn,2021-06-09,64,20293,37,7422,20,11836,7,1035,33,1177,31,10046,40,11223,California
Glenn,2021-06-10,121,20414,90,7512,25,11861,6,1041,35,1132,86,10132,41,11264,California
Glenn,2021-06-11,92,20506,61,7573,28,11889,3,1044,27,1097,65,10197,30,11294,California
Glenn,2021-06-12,35,20541,19,7592,13,11902,3,1047,13,1091,22,10219,16,11310,California
Glenn,2021-06-13,12,20553,11,7603,1,11903,0,1047,5,1089,7,10226,5,11315,California
Glenn,2021-06-14,40,20593,26,7629,10,11913,4,1051,15,1084,24,10250,19,11334,California
Glenn,2021-06-15,50,20643,34,7663,15,11928,1,1052,23,1081,27,10277,24,11358,California
Glenn,2021-06-16,86,20729,50,7713,35,11963,1,1053,57,1112,27,10304,58,11416,California
Glenn,2021-06-17,67,20796,40,7753,23,11986,4,1057,12,1073,55,10359,16,11432,California
Glenn,2021-06-18,82,20878,44,7797,17,12003,21,1078,27,1066,55,10414,48,11480,California
Glenn,2021-06-19,41,20919,20,7817,21,12024,0,1078,23,1071,18,10432,23,11503,California
Glenn,2021-06-20,15,20934,11,7828,4,12028,0,1078,4,1064,11,10443,4,11507,California
Glenn,2021-06-21,25,20959,17,7845,6,12034,2,1080,18,1077,7,10450,20,11527,California
Glenn,2021-06-22,49,21008,34,7879,13,12047,2,1082,22,1075,26,10476,24,11551,California
Glenn,2021-06-23,54,21062,37,7916,14,12061,3,1085,27,1078,27,10503,30,11581,California
Glenn,2021-06-24,44,21106,27,7943,13,12074,4,1089,17,1072,27,10530,21,11602,California
Glenn,2021-06-25,69,21175,49,7992,19,12093,1,1090,32,1068,37,10567,33,11635,California
Glenn,2021-06-26,35,21210,20,8012,14,12107,1,1091,16,1066,19,10586,17,11652,California
Glenn,2021-06-27,17,21227,13,8025,4,12111,0,1091,4,1057,13,10599,4,11656,California
Glenn,2021-06-28,27,21254,23,8048,1,12112,3,1094,12,1056,15,10614,14,11670,California
Glenn,2021-06-29,33,21287,16,8064,12,12124,5,1099,10,1048,23,10637,15,11685,California
Glenn,2021-06-30,75,21362,51,8115,20,12144,4,1103,36,1049,39,10676,40,11725,California
Glenn,2021-07-01,56,21418,40,8155,13,12157,3,1106,16,1028,40,10716,19,11744,California
Glenn,2021-07-02,61,21479,37,8192,19,12176,5,1111,21,1015,39,10755,26,11770,California
Glenn,2021-07-03,35,21514,27,8219,7,12183,1,1112,23,1027,12,10767,24,11794,California
Glenn,2021-07-04,3,21517,2,8221,0,12183,1,1113,0,1025,3,10770,1,11795,California
Glenn,2021-07-05,21,21538,18,8239,1,12184,2,1115,7,1020,14,10784,9,11804,California
Glenn,2021-07-06,47,21585,36,8275,10,12194,1,1116,24,1022,23,10807,25,11829,California
Glenn,2021-07-07,71,21656,65,8340,4,12198,2,1118,35,1023,36,10843,37,11866,California
Glenn,2021-07-08,33,21689,16,8356,10,12208,7,1125,11,1019,22,10865,18,11884,California
Glenn,2021-07-09,72,21761,45,8401,18,12226,9,1134,29,1014,43,10908,38,11922,California
Glenn,2021-07-10,14,21775,10,8411,4,12230,0,1134,5,1010,9,10917,5,11927,California
Glenn,2021-07-11,9,21784,8,8419,1,12231,0,1134,2,1005,7,10924,2,11929,California
Glenn,2021-07-12,29,21813,24,8443,3,12234,2,1136,13,1004,16,10940,15,11944,California
Glenn,2021-07-13,38,21851,25,8468,11,12245,2,1138,15,998,23,10963,17,11961,California
Glenn,2021-07-14,58,21909,45,8513,11,12256,2,1140,25,993,32,10995,27,11988,California
Glenn,2021-07-15,55,21964,28,8541,18,12274,9,1149,15,978,39,11034,24,12012,California
Glenn,2021-07-16,54,22018,42,8583,8,12282,4,1153,29,986,25,11059,33,12045,California
Glenn,2021-07-17,26,22044,14,8597,12,12294,0,1153,10,980,16,11075,10,12055,California
Glenn,2021-07-18,9,22053,9,8606,0,12294,0,1153,7,985,2,11077,7,12062,California
Glenn,2021-07-19,39,22092,33,8639,4,12298,2,1155,18,985,20,11097,20,12082,California
Glenn,2021-07-20,39,22131,33,8672,4,12302,2,1157,24,996,15,11112,26,12108,California
Glenn,2021-07-21,87,22218,72,8744,11,12313,4,1161,55,1024,31,11143,59,12167,California
Glenn,2021-07-22,38,22256,31,8775,4,12317,3,1164,19,1027,19,11162,22,12189,California
Glenn,2021-07-23,63,22319,46,8821,13,12330,4,1168,42,1052,21,11183,46,12235,California
Glenn,2021-07-24,36,22355,29,8850,6,12336,1,1169,10,1037,26,11209,11,12246,California
Glenn,2021-07-25,7,22362,5,8855,2,12338,0,1169,6,1042,1,11210,6,12252,California
Glenn,2021-07-26,35,22397,31,8886,3,12341,1,1170,24,1056,11,11221,25,12277,California
Glenn,2021-07-27,41,22438,34,8920,4,12345,3,1173,17,1052,24,11245,20,12297,California
Glenn,2021-07-28,79,22517,58,8978,16,12361,5,1178,34,1046,45,11290,39,12336,California
Glenn,2021-07-29,31,22548,16,8994,15,12376,0,1178,20,1055,11,11301,20,12356,California
Glenn,2021-07-30,61,22609,49,9043,7,12383,5,1183,42,1083,19,11320,47,12403,California
Glenn,2021-07-31,41,22650,34,9077,4,12387,3,1186,24,1093,16,11336,26,12429,California
Glenn,2021-08-01,23,22673,22,9099,0,12387,1,1187,20,1111,3,11339,21,12450,California
Glenn,2021-08-02,35,22708,29,9128,3,12390,3,1190,20,1119,15,11354,23,12473,California
Glenn,2021-08-03,51,22759,40,9168,9,12399,2,1192,33,1136,18,11372,35,12508,California
Glenn,2021-08-04,106,22865,85,9253,14,12413,7,1199,70,1177,36,11408,77,12585,California
Glenn,2021-08-05,51,22916,28,9281,20,12433,3,1202,31,1191,20,11428,34,12619,California
Glenn,2021-08-06,73,22989,61,9342,3,12436,9,1211,45,1217,28,11456,54,12673,California
Glenn,2021-08-07,18,23007,15,9357,2,12438,1,1212,12,1225,5,11461,13,12686,California
Glenn,2021-08-08,18,23025,15,9372,2,12440,1,1213,11,1230,7,11468,12,12698,California
Glenn,2021-08-09,36,23061,28,9400,5,12445,3,1216,18,1233,18,11486,21,12719,California
Glenn,2021-08-10,46,23107,35,9435,10,12455,1,1217,25,1238,21,11507,26,12745,California
Glenn,2021-08-11,102,23209,84,9519,14,12469,4,1221,54,1248,48,11555,58,12803,California
Glenn,2021-08-12,51,23260,34,9553,8,12477,9,1230,24,1254,27,11582,33,12836,California
Glenn,2021-08-13,100,23360,76,9629,10,12487,14,1244,52,1272,48,11630,66,12902,California
Glenn,2021-08-14,42,23402,24,9653,16,12503,2,1246,19,1270,22,11652,20,12922,California
Glenn,2021-08-15,9,23411,9,9662,0,12503,0,1246,6,1273,3,11655,6,12928,California
Glenn,2021-08-16,41,23452,29,9691,11,12514,1,1247,20,1276,18,11673,21,12949,California
Glenn,2021-08-17,56,23508,43,9734,10,12524,3,1250,32,1291,20,11693,35,12984,California
Glenn,2021-08-18,98,23606,81,9815,14,12538,3,1253,66,1330,30,11723,69,13053,California
Glenn,2021-08-19,59,23665,33,9848,18,12556,8,1261,39,1358,19,11742,47,13100,California
Glenn,2021-08-20,83,23748,64,9912,10,12566,9,1270,37,1363,41,11783,46,13146,California
Glenn,2021-08-21,33,23781,30,9942,3,12569,0,1270,11,1352,22,11805,11,13157,California
Glenn,2021-08-22,25,23806,21,9963,4,12573,0,1270,7,1343,16,11821,7,13164,California
Glenn,2021-08-23,56,23862,43,10006,8,12581,5,1275,28,1353,23,11844,33,13197,California
Glenn,2021-08-24,69,23931,50,10056,15,12596,4,1279,41,1372,26,11870,45,13242,California
Glenn,2021-08-25,107,24038,90,10146,16,12612,1,1280,52,1372,53,11923,53,13295,California
Glenn,2021-08-26,54,24092,39,10185,10,12622,5,1285,31,1387,21,11944,36,13331,California
Glenn,2021-08-27,121,24213,94,10279,18,12640,9,1294,65,1405,56,12000,74,13405,California
Glenn,2021-08-28,44,24257,42,10321,2,12642,0,1294,28,1418,15,12015,28,13433,California
Glenn,2021-08-29,35,24292,35,10356,0,12642,0,1294,25,1433,10,12025,25,13458,California
Glenn,2021-08-30,27,24319,25,10381,1,12643,1,1295,13,1434,13,12038,14,13472,California
Humboldt,2020-12-15,3,3,3,3,0,0,0,0,3,3,0,0,3,3,California
Humboldt,2020-12-16,15,18,15,18,0,0,0,0,15,18,0,0,15,18,California
Humboldt,2020-12-17,120,138,120,138,0,0,0,0,120,138,0,0,120,138,California
Humboldt,2020-12-18,176,314,176,314,0,0,0,0,176,314,0,0,176,314,California
Humboldt,2020-12-19,10,324,10,324,0,0,0,0,10,324,0,0,10,324,California
Humboldt,2020-12-20,27,351,27,351,0,0,0,0,27,351,0,0,27,351,California
Humboldt,2020-12-21,170,521,170,521,0,0,0,0,171,522,0,0,171,522,California
Humboldt,2020-12-22,394,915,394,915,0,0,0,0,394,916,0,0,394,916,California
Humboldt,2020-12-23,304,1219,245,1160,59,59,0,0,306,1222,0,0,306,1222,California
Humboldt,2020-12-24,27,1246,2,1162,25,84,0,0,27,1249,0,0,27,1249,California
Humboldt,2020-12-25,2,1248,2,1164,0,84,0,0,2,1251,0,0,2,1251,California
Humboldt,2020-12-26,6,1254,5,1169,1,85,0,0,6,1257,0,0,6,1257,California
Humboldt,2020-12-27,1,1255,1,1170,0,85,0,0,1,1258,0,0,1,1258,California
Humboldt,2020-12-28,200,1455,142,1312,58,143,0,0,200,1458,0,0,200,1458,California
Humboldt,2020-12-29,195,1650,132,1444,63,206,0,0,196,1654,0,0,196,1654,California
Humboldt,2020-12-30,218,1868,112,1556,106,312,0,0,218,1872,0,0,218,1872,California
Humboldt,2020-12-31,239,2107,75,1631,164,476,0,0,239,2111,0,0,239,2111,California
Humboldt,2021-01-01,2,2109,1,1632,1,477,0,0,2,2113,0,0,2,2113,California
Humboldt,2021-01-02,40,2149,2,1634,38,515,0,0,40,2153,0,0,40,2153,California
Humboldt,2021-01-04,217,2366,140,1774,77,592,0,0,218,2371,0,0,218,2371,California
Humboldt,2021-01-05,137,2503,25,1799,112,704,0,0,137,2506,2,2,137,2508,California
Humboldt,2021-01-06,313,2816,213,2012,100,804,0,0,238,2680,64,66,238,2746,California
Humboldt,2021-01-07,441,3257,328,2340,113,917,0,0,323,2900,103,169,323,3069,California
Humboldt,2021-01-08,439,3696,299,2639,140,1057,0,0,296,3059,137,306,296,3365,California
Humboldt,2021-01-09,66,3762,43,2682,23,1080,0,0,64,3122,2,308,65,3430,California
Humboldt,2021-01-10,80,3842,80,2762,0,1080,0,0,2,3047,78,386,3,3433,California
Humboldt,2021-01-11,294,4136,283,3045,11,1091,0,0,73,2903,217,603,73,3506,California
Humboldt,2021-01-12,524,4660,361,3406,163,1254,0,0,284,2947,240,843,284,3790,California
Humboldt,2021-01-13,515,5175,277,3683,238,1492,0,0,332,3097,183,1026,333,4123,California
Humboldt,2021-01-14,572,5747,180,3863,392,1884,0,0,514,3553,59,1085,515,4638,California
Humboldt,2021-01-15,357,6104,13,3876,344,2228,0,0,354,3904,3,1088,354,4992,California
Humboldt,2021-01-16,167,6271,5,3881,162,2390,0,0,166,4069,1,1089,166,5158,California
Humboldt,2021-01-17,8,6279,5,3886,3,2393,0,0,8,4077,0,1089,8,5166,California
Humboldt,2021-01-18,309,6588,274,4160,35,2428,0,0,149,4066,160,1249,149,5315,California
Humboldt,2021-01-19,663,7251,405,4565,258,2686,0,0,526,4461,131,1380,526,5841,California
Humboldt,2021-01-20,951,8202,423,4988,528,3214,0,0,784,5087,160,1540,786,6627,California
Humboldt,2021-01-21,967,9169,259,5247,708,3922,0,0,924,5968,43,1583,924,7551,California
Humboldt,2021-01-22,689,9858,379,5626,310,4232,0,0,678,6637,11,1594,680,8231,California
Humboldt,2021-01-23,932,10790,286,5912,646,4878,0,0,925,7555,7,1601,925,9156,California
Humboldt,2021-01-24,228,11018,0,5912,228,5106,0,0,227,7781,1,1602,227,9383,California
Humboldt,2021-01-25,355,11373,237,6149,118,5224,0,0,157,7740,198,1800,157,9540,California
Humboldt,2021-01-26,547,11920,155,6304,392,5616,0,0,480,8153,67,1867,480,10020,California
Humboldt,2021-01-27,1274,13194,586,6890,688,6304,0,0,1197,9280,72,1939,1199,11219,California
Humboldt,2021-01-28,1465,14659,634,7524,831,7135,0,0,1321,10461,141,2080,1322,12541,California
Humboldt,2021-01-29,1179,15838,554,8078,625,7760,0,0,695,10673,483,2563,695,13236,California
Humboldt,2021-01-30,1031,16869,471,8549,560,8320,0,0,985,11612,46,2609,985,14221,California
Humboldt,2021-01-31,327,17196,324,8873,3,8323,0,0,326,11937,1,2610,326,14547,California
Humboldt,2021-02-01,320,17516,173,9046,147,8470,0,0,182,11982,138,2748,183,14730,California
Humboldt,2021-02-02,453,17969,78,9124,375,8845,0,0,349,12232,101,2849,351,15081,California
Humboldt,2021-02-03,674,18643,264,9388,410,9255,0,0,520,12598,154,3003,520,15601,California
Humboldt,2021-02-04,657,19300,261,9649,396,9651,0,0,446,12836,208,3211,446,16047,California
Humboldt,2021-02-05,828,20128,109,9758,719,10370,0,0,622,13253,205,3416,622,16669,California
Humboldt,2021-02-06,1092,21220,475,10233,617,10987,0,0,1042,14247,49,3465,1043,17712,California
Humboldt,2021-02-07,377,21597,7,10240,370,11357,0,0,371,14614,5,3470,372,18084,California
Humboldt,2021-02-08,344,21941,146,10386,198,11555,0,0,185,14641,158,3628,185,18269,California
Humboldt,2021-02-09,506,22447,230,10616,276,11831,0,0,177,14490,328,3956,177,18446,California
Humboldt,2021-02-10,565,23012,369,10985,196,12027,0,0,208,14345,353,4309,208,18654,California
Humboldt,2021-02-11,1340,24352,401,11386,939,12966,0,0,488,13986,849,5158,490,19144,California
Humboldt,2021-02-12,1186,25538,760,12146,426,13392,0,0,730,14261,455,5613,730,19874,California
Humboldt,2021-02-13,1558,27096,609,12755,949,14341,0,0,926,14558,630,6243,927,20801,California
Humboldt,2021-02-14,115,27211,5,12760,110,14451,0,0,113,14669,2,6245,113,20914,California
Humboldt,2021-02-15,299,27510,82,12842,217,14668,0,0,197,14765,101,6346,197,21111,California
Humboldt,2021-02-16,554,28064,124,12966,430,15098,0,0,250,14714,303,6649,252,21363,California
Humboldt,2021-02-17,457,28521,281,13247,176,15274,0,0,130,14519,325,6974,130,21493,California
Humboldt,2021-02-18,1023,29544,604,13851,419,15693,0,0,272,14043,748,7722,272,21765,California
Humboldt,2021-02-19,491,30035,440,14291,51,15744,0,0,94,13743,394,8116,94,21859,California
Humboldt,2021-02-20,1760,31795,1035,15326,725,16469,0,0,482,12951,1277,9393,485,22344,California
Humboldt,2021-02-21,500,32295,492,15818,8,16477,0,0,183,12818,317,9710,184,22528,California
Humboldt,2021-02-22,143,32438,97,15915,46,16523,0,0,30,12738,110,9820,30,22558,California
Humboldt,2021-02-23,189,32627,72,15987,117,16640,0,0,47,12645,140,9960,47,22605,California
Humboldt,2021-02-24,1288,33915,783,16770,505,17145,0,0,619,12598,666,10626,619,23224,California
Humboldt,2021-02-25,871,34786,328,17098,543,17688,0,0,236,12202,632,11258,236,23460,California
Humboldt,2021-02-26,2263,37049,113,17211,2150,19838,0,0,452,10849,1806,13064,453,23913,California
Humboldt,2021-02-27,1827,38876,1167,18378,660,20498,0,0,932,10891,894,13958,936,24849,California
Humboldt,2021-02-28,136,39012,15,18393,121,20619,0,0,121,11000,12,13970,121,24970,California
Humboldt,2021-03-01,274,39286,47,18440,227,20846,0,0,195,11117,78,14048,195,25165,California
Humboldt,2021-03-02,317,39603,51,18491,266,21112,0,0,171,11142,146,14194,171,25336,California
Humboldt,2021-03-03,1725,41328,1136,19627,589,21701,0,0,1258,11940,460,14654,1258,26594,California
Humboldt,2021-03-04,946,42274,116,19743,830,22531,0,0,304,11604,642,15296,306,26900,California
Humboldt,2021-03-05,959,43233,192,19935,757,23288,10,10,397,11453,558,15854,407,27307,California
Humboldt,2021-03-06,1821,45054,960,20895,812,24100,49,59,798,11276,1022,16876,845,28152,California
Humboldt,2021-03-07,405,45459,306,21201,65,24165,34,93,161,11226,243,17119,193,28345,California
Humboldt,2021-03-08,289,45748,7,21208,197,24362,85,178,185,11391,103,17222,268,28613,California
Humboldt,2021-03-09,521,46269,213,21421,157,24519,151,329,260,11535,259,17481,403,29016,California
Humboldt,2021-03-10,705,46974,474,21895,73,24592,158,487,429,11845,274,17755,584,29600,California
Humboldt,2021-03-11,1498,48472,458,22353,940,25532,100,587,667,11782,827,18582,764,30364,California
Humboldt,2021-03-12,1767,50239,1101,23454,444,25976,222,809,1065,12378,693,19275,1289,31653,California
Humboldt,2021-03-13,1605,51844,1054,24508,498,26474,53,862,682,12196,916,20191,734,32387,California
Humboldt,2021-03-14,146,51990,21,24529,117,26591,8,870,28,12114,118,20309,36,32423,California
Humboldt,2021-03-15,282,52272,49,24578,211,26802,22,892,59,11970,223,20532,79,32502,California
Humboldt,2021-03-16,638,52910,203,24781,172,26974,263,1155,262,12118,375,20907,523,33025,California
Humboldt,2021-03-17,740,53650,397,25178,233,27207,110,1265,344,12177,395,21302,454,33479,California
Humboldt,2021-03-18,1752,55402,1176,26354,533,27740,43,1308,1019,12513,726,22028,1062,34541,California
Humboldt,2021-03-19,1086,56488,62,26416,702,28442,322,1630,442,12634,642,22670,763,35304,California
Humboldt,2021-03-20,1436,57924,803,27219,619,29061,14,1644,382,11982,1049,23719,397,35701,California
Humboldt,2021-03-21,252,58176,35,27254,190,29251,27,1671,207,12171,44,23763,233,35934,California
Humboldt,2021-03-22,124,58300,19,27273,54,29305,51,1722,65,12230,57,23820,116,36050,California
Humboldt,2021-03-23,423,58723,42,27315,338,29643,43,1765,327,12504,95,23915,369,36419,California
Humboldt,2021-03-24,1423,60146,393,27708,982,30625,48,1813,1040,13216,375,24290,1087,37506,California
Humboldt,2021-03-25,1851,61997,1220,28928,568,31193,63,1876,922,13274,925,25215,983,38489,California
Humboldt,2021-03-26,2050,64047,437,29365,1555,32748,58,1934,1595,14477,449,25664,1652,40141,California
Humboldt,2021-03-27,2312,66359,1576,30941,560,33308,176,2110,1313,14969,995,26659,1487,41628,California
Humboldt,2021-03-28,273,66632,84,31025,117,33425,72,2182,80,14929,192,26851,152,41780,California
Humboldt,2021-03-29,472,67104,126,31151,249,33674,97,2279,198,14951,271,27122,293,42073,California
Humboldt,2021-03-30,959,68063,308,31459,537,34211,114,2393,560,15229,394,27516,672,42745,California
Humboldt,2021-03-31,1891,69954,542,32001,1252,35463,97,2490,1409,16257,479,27995,1507,44252,California
Humboldt,2021-04-01,2117,72071,711,32712,1314,36777,92,2582,1480,17197,629,28624,1569,45821,California
Humboldt,2021-04-02,1728,73799,1112,33824,510,37287,106,2688,609,16798,1110,29734,711,46532,California
Humboldt,2021-04-03,1679,75478,1520,35344,145,37432,14,2702,667,16478,1001,30735,681,47213,California
Humboldt,2021-04-04,481,75959,370,35714,101,37533,10,2712,397,16802,82,30817,406,47619,California
Humboldt,2021-04-05,782,76741,465,36179,269,37802,48,2760,440,16950,340,31157,488,48107,California
Humboldt,2021-04-06,858,77599,325,36504,398,38200,135,2895,590,17411,262,31419,723,48830,California
Humboldt,2021-04-07,1526,79125,1079,37583,291,38491,156,3051,997,18036,528,31947,1153,49983,California
Humboldt,2021-04-08,1785,80910,1100,38683,514,39005,171,3222,738,17901,1044,32991,909,50892,California
Humboldt,2021-04-09,1452,82362,438,39121,855,39860,159,3381,1160,18919,291,33282,1309,52201,California
Humboldt,2021-04-10,952,83314,145,39266,634,40494,173,3554,751,19642,199,33481,922,53123,California
Humboldt,2021-04-11,651,83965,144,39410,37,40531,470,4024,132,19723,519,34000,600,53723,California
Humboldt,2021-04-12,450,84415,234,39644,89,40620,127,4151,283,19968,166,34166,411,54134,California
Humboldt,2021-04-13,597,85012,329,39973,262,40882,6,4157,559,20496,36,34202,564,54698,California
Humboldt,2021-04-14,1463,86475,1059,41032,404,41286,0,4157,1341,21716,121,34323,1341,56039,California
Humboldt,2021-04-15,1821,88296,1191,42223,626,41912,4,4161,1247,22410,555,34878,1249,57288,California
Humboldt,2021-04-16,1139,89435,521,42744,618,42530,0,4161,553,22380,583,35461,553,57841,California
Humboldt,2021-04-17,1906,91341,1581,44325,324,42854,1,4162,973,22426,928,36389,974,58815,California
Humboldt,2021-04-18,671,92012,353,44678,317,43171,1,4163,81,21923,584,36973,81,58896,California
Humboldt,2021-04-19,202,92214,82,44760,120,43291,0,4163,87,21897,113,37086,87,58983,California
Humboldt,2021-04-20,513,92727,138,44898,375,43666,0,4163,254,21893,258,37344,254,59237,California
Humboldt,2021-04-21,1122,93849,391,45289,731,44397,0,4163,452,21685,661,38005,453,59690,California
Humboldt,2021-04-22,908,94757,542,45831,365,44762,1,4164,461,21702,444,38449,461,60151,California
Humboldt,2021-04-23,2220,96977,314,46145,1906,46668,0,4164,343,20172,1873,40322,343,60494,California
Humboldt,2021-04-24,1271,98248,910,47055,356,47024,5,4169,342,19593,926,41248,347,60841,California
Humboldt,2021-04-25,389,98637,246,47301,143,47167,0,4169,201,19609,185,41433,201,61042,California
Humboldt,2021-04-26,391,99028,270,47571,117,47284,4,4173,112,19446,277,41710,114,61156,California
Humboldt,2021-04-27,813,99841,312,47883,470,47754,31,4204,180,19026,631,42341,211,61367,California
Humboldt,2021-04-28,1609,101450,844,48727,719,48473,46,4250,420,18306,1186,43527,466,61833,California
Humboldt,2021-04-29,1825,103275,642,49369,1144,49617,39,4289,310,17147,1508,45035,349,62182,California
Humboldt,2021-04-30,1317,104592,439,49808,843,50460,35,4324,207,16284,1103,46138,240,62422,California
Humboldt,2021-05-01,498,105090,397,50205,77,50537,24,4348,304,16419,193,46331,328,62750,California
Humboldt,2021-05-02,241,105331,191,50396,40,50577,10,4358,119,16427,121,46452,129,62879,California
Humboldt,2021-05-03,633,105964,387,50783,222,50799,24,4382,103,16027,528,46980,128,63007,California
Humboldt,2021-05-04,875,106839,528,51311,302,51101,45,4427,265,15729,607,47587,309,63316,California
Humboldt,2021-05-05,1767,108606,1136,52447,572,51673,59,4486,194,14415,1565,49152,251,63567,California
Humboldt,2021-05-06,1720,110326,1097,53544,369,52042,254,4740,143,13238,1574,50726,397,63964,California
Humboldt,2021-05-07,1446,111772,318,53862,1068,53110,60,4800,239,12330,1205,51931,297,64261,California
Humboldt,2021-05-08,753,112525,149,54011,580,53690,24,4824,90,11784,660,52591,114,64375,California
Humboldt,2021-05-09,910,113435,857,54868,43,53733,10,4834,47,10979,862,53453,57,64432,California
Humboldt,2021-05-10,223,113658,39,54907,142,53875,42,4876,81,10960,142,53595,123,64555,California
Humboldt,2021-05-11,543,114201,188,55095,281,54156,74,4950,206,10903,336,53931,279,64834,California
Humboldt,2021-05-12,627,114828,143,55238,437,54593,47,4997,230,10783,396,54327,276,65110,California
Humboldt,2021-05-13,637,115465,301,55539,310,54903,26,5023,287,10749,348,54675,314,65424,California
Humboldt,2021-05-14,714,116179,145,55684,464,55367,105,5128,233,10608,478,55153,337,65761,California
Humboldt,2021-05-15,796,116975,652,56336,134,55501,10,5138,215,10254,579,55732,225,65986,California
Humboldt,2021-05-16,121,117096,55,56391,62,55563,4,5142,70,10277,51,55783,74,66060,California
Humboldt,2021-05-17,410,117506,216,56607,173,55736,21,5163,223,10336,186,55969,245,66305,California
Humboldt,2021-05-18,665,118171,325,56932,311,56047,29,5192,362,10423,303,56272,390,66695,California
Humboldt,2021-05-19,991,119162,552,57484,396,56443,43,5235,321,10119,666,56938,362,67057,California
Humboldt,2021-05-20,850,120012,620,58104,217,56660,13,5248,612,10510,235,57173,626,67683,California
Humboldt,2021-05-21,894,120906,294,58398,533,57193,67,5315,352,10387,542,57715,419,68102,California
Humboldt,2021-05-22,418,121324,323,58721,87,57280,8,5323,149,10277,267,57982,157,68259,California
Humboldt,2021-05-23,399,121723,331,59052,65,57345,3,5326,75,10032,323,58305,78,68337,California
Humboldt,2021-05-24,343,122066,177,59229,137,57482,29,5355,187,10092,156,58461,216,68553,California
Humboldt,2021-05-25,535,122601,343,59572,167,57649,25,5380,289,10163,243,58704,314,68867,California
Humboldt,2021-05-26,650,123251,311,59883,315,57964,24,5404,305,10148,344,59048,329,69196,California
Humboldt,2021-05-27,469,123720,253,60136,180,58144,36,5440,279,10274,190,59238,316,69512,California
Humboldt,2021-05-28,420,124140,196,60332,175,58319,49,5489,172,10250,245,59483,221,69733,California
Humboldt,2021-05-29,175,124315,102,60434,67,58386,6,5495,91,10263,84,59567,97,69830,California
Humboldt,2021-05-30,106,124421,45,60479,56,58442,5,5500,50,10263,55,59622,55,69885,California
Humboldt,2021-05-31,73,124494,27,60506,40,58482,6,5506,49,10294,23,59645,54,69939,California
Humboldt,2021-06-01,469,124963,269,60775,185,58667,15,5521,188,10216,281,59926,203,70142,California
Humboldt,2021-06-02,538,125501,252,61027,231,58898,55,5576,238,10212,295,60221,291,70433,California
Humboldt,2021-06-03,393,125894,229,61256,142,59040,22,5598,85,10039,280,60501,107,70540,California
Humboldt,2021-06-04,516,126410,324,61580,168,59208,24,5622,142,9874,330,60831,165,70705,California
Humboldt,2021-06-05,411,126821,315,61895,51,59259,45,5667,208,9979,148,60979,253,70958,California
Humboldt,2021-06-06,174,126995,119,62014,45,59304,10,5677,68,9957,100,61079,78,71036,California
Humboldt,2021-06-07,368,127363,221,62235,123,59427,24,5701,120,9854,247,61326,144,71180,California
Humboldt,2021-06-08,520,127883,303,62538,188,59615,29,5730,146,9656,372,61698,174,71354,California
Humboldt,2021-06-09,404,128287,208,62746,148,59763,48,5778,128,9558,274,61972,176,71530,California
Humboldt,2021-06-10,566,128853,445,63191,94,59857,27,5805,94,9209,468,62440,119,71649,California
Humboldt,2021-06-11,441,129294,244,63435,168,60025,29,5834,101,9001,339,62779,131,71780,California
Humboldt,2021-06-12,185,129479,134,63569,50,60075,1,5835,51,8920,133,62912,52,71832,California
Humboldt,2021-06-13,214,129693,147,63716,41,60116,26,5861,92,8917,120,63032,117,71949,California
Humboldt,2021-06-14,426,130119,258,63974,140,60256,28,5889,111,8743,313,63345,139,72088,California
Humboldt,2021-06-15,561,130680,381,64355,152,60408,28,5917,163,8541,392,63737,190,72278,California
Humboldt,2021-06-16,496,131176,327,64682,113,60521,56,5973,146,8402,341,64078,202,72480,California
Humboldt,2021-06-17,412,131588,263,64945,103,60624,46,6019,102,8240,310,64388,148,72628,California
Humboldt,2021-06-18,416,132004,240,65185,147,60771,29,6048,146,8150,264,64652,174,72802,California
Humboldt,2021-06-19,205,132209,136,65321,48,60819,21,6069,87,8140,117,64769,107,72909,California
Humboldt,2021-06-20,80,132289,36,65357,30,60849,14,6083,33,8142,45,64814,47,72956,California
Humboldt,2021-06-21,158,132447,74,65431,55,60904,29,6112,56,8125,102,64916,85,73041,California
Humboldt,2021-06-22,352,132799,224,65655,109,61013,19,6131,148,8089,203,65119,167,73208,California
Humboldt,2021-06-23,358,133157,252,65907,75,61088,31,6162,108,7983,243,65362,137,73345,California
Humboldt,2021-06-24,218,133375,106,66013,53,61141,59,6221,87,8000,126,65488,143,73488,California
Humboldt,2021-06-25,262,133637,149,66162,99,61240,14,6235,106,7967,153,65641,120,73608,California
Humboldt,2021-06-26,254,133891,190,66352,40,61280,24,6259,61,7859,193,65834,85,73693,California
Humboldt,2021-06-27,76,133967,52,66404,22,61302,2,6261,27,7839,49,65883,29,73722,California
Humboldt,2021-06-28,158,134125,100,66504,30,61332,28,6289,70,7849,88,65971,98,73820,California
Humboldt,2021-06-29,269,134394,161,66665,75,61407,33,6322,91,7796,176,66147,123,73943,California
Humboldt,2021-06-30,229,134623,147,66812,62,61469,20,6342,96,7782,130,66277,116,74059,California
Humboldt,2021-07-01,198,134821,113,66925,67,61536,18,6360,89,7782,107,66384,107,74166,California
Humboldt,2021-07-02,270,135091,144,67069,85,61621,41,6401,108,7770,161,66545,149,74315,California
Humboldt,2021-07-03,92,135183,62,67131,20,61641,10,6411,41,7771,50,66595,51,74366,California
Humboldt,2021-07-04,9,135192,4,67135,5,61646,0,6411,5,7772,4,66599,5,74371,California
Humboldt,2021-07-05,147,135339,99,67234,36,61682,12,6423,66,7770,80,66679,78,74449,California
Humboldt,2021-07-06,254,135593,162,67396,71,61753,21,6444,68,7674,185,66864,89,74538,California
Humboldt,2021-07-07,261,135854,158,67554,66,61819,37,6481,79,7610,180,67044,116,74654,California
Humboldt,2021-07-08,192,136046,129,67683,46,61865,17,6498,74,7585,116,67160,91,74745,California
Humboldt,2021-07-09,231,136277,141,67824,68,61933,22,6520,81,7537,150,67310,102,74847,California
Humboldt,2021-07-10,131,136408,91,67915,30,61963,10,6530,58,7532,73,67383,68,74915,California
Humboldt,2021-07-11,80,136488,54,67969,14,61977,12,6542,35,7534,45,67428,47,74962,California
Humboldt,2021-07-12,119,136607,71,68040,42,62019,6,6548,57,7535,62,67490,63,75025,California
Humboldt,2021-07-13,190,136797,132,68172,38,62057,20,6568,56,7480,131,67621,76,75101,California
Humboldt,2021-07-14,249,137046,164,68336,72,62129,13,6581,99,7445,146,67767,111,75212,California
Humboldt,2021-07-15,159,137205,92,68428,55,62184,12,6593,53,7405,104,67871,64,75276,California
Humboldt,2021-07-16,252,137457,160,68588,71,62255,21,6614,109,7395,141,68012,131,75407,California
Humboldt,2021-07-17,96,137553,68,68656,27,62282,1,6615,45,7392,50,68062,47,75454,California
Humboldt,2021-07-18,50,137603,27,68683,15,62297,8,6623,22,7394,28,68090,30,75484,California
Humboldt,2021-07-19,159,137762,101,68784,45,62342,13,6636,80,7408,79,68169,93,75577,California
Humboldt,2021-07-20,264,138026,146,68930,75,62417,43,6679,111,7411,151,68320,154,75731,California
Humboldt,2021-07-21,238,138264,170,69100,47,62464,21,6700,122,7440,114,68434,143,75874,California
Humboldt,2021-07-22,203,138467,114,69214,68,62532,21,6721,92,7442,111,68545,113,75987,California
Humboldt,2021-07-23,287,138754,172,69386,89,62621,26,6747,154,7490,132,68677,180,76167,California
Humboldt,2021-07-24,167,138921,110,69496,25,62646,32,6779,79,7516,85,68762,111,76278,California
Humboldt,2021-07-25,59,138980,34,69530,15,62661,10,6789,34,7535,25,68787,44,76322,California
Humboldt,2021-07-26,180,139160,118,69648,49,62710,13,6802,101,7571,78,68865,114,76436,California
Humboldt,2021-07-27,227,139387,141,69789,67,62777,19,6821,129,7625,93,68958,147,76583,California
Humboldt,2021-07-28,247,139634,166,69955,64,62841,17,6838,148,7693,98,69056,166,76749,California
Humboldt,2021-07-29,197,139831,123,70078,53,62894,21,6859,109,7737,86,69142,130,76879,California
Humboldt,2021-07-30,310,140141,177,70255,107,63001,26,6885,163,7785,138,69280,186,77065,California
Humboldt,2021-07-31,141,140282,97,70352,26,63027,18,6903,67,7799,70,69350,84,77149,California
Humboldt,2021-08-01,79,140361,55,70407,20,63047,4,6907,59,7842,20,69370,63,77212,California
Humboldt,2021-08-02,171,140532,106,70513,40,63087,25,6932,99,7897,69,69439,124,77336,California
Humboldt,2021-08-03,229,140761,140,70653,55,63142,34,6966,138,7984,85,69524,172,77508,California
Humboldt,2021-08-04,250,141011,142,70795,76,63218,32,6998,136,8040,112,69636,168,77676,California
Humboldt,2021-08-05,249,141260,157,70952,69,63287,23,7021,154,8125,90,69726,175,77851,California
Humboldt,2021-08-06,438,141698,274,71226,89,63376,75,7096,273,8310,162,69888,347,78198,California
Humboldt,2021-08-07,220,141918,162,71388,32,63408,26,7122,138,8394,80,69968,164,78362,California
Humboldt,2021-08-08,121,142039,82,71470,21,63429,18,7140,82,8455,39,70007,100,78462,California
Humboldt,2021-08-09,283,142322,175,71645,83,63512,25,7165,175,8552,103,70110,200,78662,California
Humboldt,2021-08-10,362,142684,264,71909,65,63577,33,7198,215,8658,142,70252,248,78910,California
Humboldt,2021-08-11,334,143018,224,72133,59,63636,51,7249,204,8785,127,70379,254,79164,California
Humboldt,2021-08-12,231,143249,135,72268,74,63710,22,7271,142,8862,86,70465,163,79327,California
Humboldt,2021-08-13,430,143679,240,72508,148,63858,42,7313,255,8994,166,70631,298,79625,California
Humboldt,2021-08-14,160,143839,114,72622,41,63899,5,7318,82,9017,64,70695,87,79712,California
Humboldt,2021-08-15,133,143972,89,72711,19,63918,25,7343,66,9051,56,70751,90,79802,California
Humboldt,2021-08-16,267,144239,174,72885,79,63997,14,7357,132,9093,104,70855,146,79948,California
Humboldt,2021-08-17,376,144615,245,73130,110,64107,21,7378,196,9176,134,70989,217,80165,California
Humboldt,2021-08-18,365,144980,257,73387,83,64190,25,7403,164,9217,148,71137,189,80354,California
Humboldt,2021-08-19,277,145257,164,73551,84,64274,29,7432,112,9245,112,71249,140,80494,California
Humboldt,2021-08-20,434,145691,202,73753,200,64474,32,7464,191,9285,183,71432,223,80717,California
Humboldt,2021-08-21,197,145888,125,73878,55,64529,17,7481,97,9330,69,71501,114,80831,California
Humboldt,2021-08-22,131,146019,86,73964,30,64559,15,7496,71,9362,54,71555,86,80917,California
Humboldt,2021-08-23,279,146298,204,74168,66,64625,9,7505,146,9412,106,71661,156,81073,California
Humboldt,2021-08-24,294,146592,202,74370,83,64708,9,7514,126,9427,120,71781,135,81208,California
Humboldt,2021-08-25,360,146952,269,74639,66,64774,25,7539,175,9484,142,71923,199,81407,California
Humboldt,2021-08-26,281,147233,191,74830,73,64847,17,7556,114,9505,110,72033,131,81538,California
Humboldt,2021-08-27,470,147703,308,75138,142,64989,20,7576,174,9486,211,72244,192,81730,California
Humboldt,2021-08-28,252,147955,204,75342,39,65028,9,7585,108,9479,123,72367,116,81846,California
Humboldt,2021-08-29,160,148115,128,75470,27,65055,5,7590,79,9499,64,72431,84,81930,California
Humboldt,2021-08-30,175,148290,96,75566,70,65125,9,7599,61,9493,76,72507,70,82000,California
Imperial,2020-12-16,1,1,1,1,0,0,0,0,1,1,0,0,1,1,California
Imperial,2020-12-17,5,6,5,6,0,0,0,0,5,6,0,0,5,6,California
Imperial,2020-12-18,16,22,16,22,0,0,0,0,16,22,0,0,16,22,California
Imperial,2020-12-20,1,23,1,23,0,0,0,0,1,23,0,0,1,23,California
Imperial,2020-12-21,185,208,185,208,0,0,0,0,185,208,0,0,185,208,California
Imperial,2020-12-22,243,451,241,449,2,2,0,0,243,451,0,0,243,451,California
Imperial,2020-12-23,209,660,208,657,1,3,0,0,209,660,0,0,209,660,California
Imperial,2020-12-24,7,667,7,664,0,3,0,0,7,667,0,0,7,667,California
Imperial,2020-12-25,1,668,1,665,0,3,0,0,1,668,0,0,1,668,California
Imperial,2020-12-26,4,672,2,667,2,5,0,0,4,672,0,0,4,672,California
Imperial,2020-12-27,62,734,0,667,62,67,0,0,62,734,0,0,62,734,California
Imperial,2020-12-28,218,952,116,783,102,169,0,0,218,952,0,0,218,952,California
Imperial,2020-12-29,194,1146,39,822,155,324,0,0,194,1146,0,0,194,1146,California
Imperial,2020-12-30,372,1518,51,873,321,645,0,0,372,1518,0,0,372,1518,California
Imperial,2020-12-31,201,1719,29,902,172,817,0,0,201,1719,0,0,201,1719,California
Imperial,2021-01-01,8,1727,6,908,2,819,0,0,8,1727,0,0,8,1727,California
Imperial,2021-01-02,7,1734,2,910,5,824,0,0,7,1734,0,0,7,1734,California
Imperial,2021-01-03,91,1825,0,910,91,915,0,0,91,1825,0,0,91,1825,California
Imperial,2021-01-04,92,1917,11,921,81,996,0,0,92,1917,0,0,92,1917,California
Imperial,2021-01-05,174,2091,15,936,159,1155,0,0,174,2091,0,0,174,2091,California
Imperial,2021-01-06,199,2290,28,964,171,1326,0,0,197,2286,2,2,197,2288,California
Imperial,2021-01-07,333,2623,13,977,320,1646,0,0,329,2611,4,6,329,2617,California
Imperial,2021-01-08,200,2823,57,1034,143,1789,0,0,188,2787,12,18,188,2805,California
Imperial,2021-01-09,26,2849,21,1055,5,1794,0,0,26,2813,0,18,26,2831,California
Imperial,2021-01-10,6,2855,0,1055,6,1800,0,0,6,2819,0,18,6,2837,California
Imperial,2021-01-11,406,3261,246,1301,160,1960,0,0,177,2767,229,247,177,3014,California
Imperial,2021-01-12,586,3847,476,1777,110,2070,0,0,321,2824,264,511,321,3335,California
Imperial,2021-01-13,390,4237,136,1913,254,2324,0,0,288,3010,102,613,288,3623,California
Imperial,2021-01-14,307,4544,190,2103,117,2441,0,0,301,3306,5,618,301,3924,California
Imperial,2021-01-15,246,4790,182,2285,64,2505,0,0,238,3536,8,626,238,4162,California
Imperial,2021-01-16,96,4886,74,2359,22,2527,0,0,95,3630,1,627,95,4257,California
Imperial,2021-01-17,19,4905,6,2365,13,2540,0,0,18,3647,1,628,18,4275,California
Imperial,2021-01-18,1081,5986,403,2768,678,3218,0,0,982,4531,99,727,983,5258,California
Imperial,2021-01-19,183,6169,138,2906,45,3263,0,0,132,4612,51,778,132,5390,California
Imperial,2021-01-20,312,6481,202,3108,110,3373,0,0,273,4846,39,817,273,5663,California
Imperial,2021-01-21,472,6953,215,3323,257,3630,0,0,448,5270,24,841,448,6111,California
Imperial,2021-01-22,482,7435,192,3515,290,3920,0,0,472,5733,9,850,472,6583,California
Imperial,2021-01-23,1066,8501,292,3807,774,4694,0,0,1063,6793,3,853,1063,7646,California
Imperial,2021-01-24,27,8528,6,3813,21,4715,0,0,26,6818,1,854,26,7672,California
Imperial,2021-01-25,231,8759,11,3824,220,4935,0,0,45,6679,184,1038,45,7717,California
Imperial,2021-01-26,406,9165,196,4020,210,5145,0,0,258,6791,147,1185,259,7976,California
Imperial,2021-01-27,607,9772,175,4195,432,5577,0,0,265,6715,342,1527,266,8242,California
Imperial,2021-01-28,669,10441,175,4370,494,6071,0,0,557,7161,112,1639,558,8800,California
Imperial,2021-01-29,466,10907,310,4680,156,6227,0,0,412,7519,54,1693,412,9212,California
Imperial,2021-01-30,88,10995,42,4722,46,6273,0,0,71,7573,17,1710,71,9283,California
Imperial,2021-01-31,38,11033,13,4735,25,6298,0,0,37,7609,1,1711,37,9320,California
Imperial,2021-02-01,481,11514,77,4812,404,6702,0,0,266,7661,214,1925,266,9586,California
Imperial,2021-02-02,778,12292,93,4905,685,7387,0,0,590,8063,188,2113,590,10176,California
Imperial,2021-02-03,637,12929,188,5093,449,7836,0,0,373,8174,262,2375,373,10549,California
Imperial,2021-02-04,1957,14886,1399,6492,558,8394,0,0,1514,9247,442,2817,1515,12064,California
Imperial,2021-02-05,480,15366,261,6753,219,8613,0,0,242,9252,239,3056,244,12308,California
Imperial,2021-02-06,894,16260,850,7603,44,8657,0,0,856,10068,40,3096,856,13164,California
Imperial,2021-02-07,51,16311,17,7620,34,8691,0,0,47,10111,4,3100,47,13211,California
Imperial,2021-02-08,301,16612,68,7688,233,8924,0,0,231,10272,70,3170,231,13442,California
Imperial,2021-02-09,531,17143,183,7871,348,9272,0,0,357,10458,174,3344,360,13802,California
Imperial,2021-02-10,504,17647,77,7948,427,9699,0,0,133,10223,371,3715,136,13938,California
Imperial,2021-02-11,1111,18758,400,8348,711,10410,0,0,192,9506,914,4629,197,14135,California
Imperial,2021-02-12,2244,21002,1485,9833,759,11169,0,0,1879,11024,368,4997,1886,16021,California
Imperial,2021-02-13,127,21129,63,9896,64,11233,0,0,106,11108,24,5021,108,16129,California
Imperial,2021-02-14,62,21191,38,9934,24,11257,0,0,58,11162,4,5025,58,16187,California
Imperial,2021-02-15,178,21369,66,10000,112,11369,0,0,132,11251,46,5071,135,16322,California
Imperial,2021-02-16,567,21936,283,10283,284,11653,0,0,337,11362,230,5301,341,16663,California
Imperial,2021-02-17,476,22412,315,10598,161,11814,0,0,111,11113,365,5666,116,16779,California
Imperial,2021-02-18,709,23121,347,10945,362,12176,0,0,174,10763,534,6200,184,16963,California
Imperial,2021-02-19,813,23934,412,11357,401,12577,0,0,218,10389,594,6794,220,17183,California
Imperial,2021-02-20,1089,25023,219,11576,870,13447,0,0,353,10024,733,7527,368,17551,California
Imperial,2021-02-21,635,25658,600,12176,35,13482,0,0,621,10636,12,7539,624,18175,California
Imperial,2021-02-22,887,26545,622,12798,265,13747,0,0,806,11367,81,7620,812,18987,California
Imperial,2021-02-23,1191,27736,572,13370,619,14366,0,0,1009,12210,181,7801,1024,20011,California
Imperial,2021-02-24,888,28624,415,13785,473,14839,0,0,751,12840,135,7936,765,20776,California
Imperial,2021-02-25,1019,29643,434,14219,585,15424,0,0,589,13025,428,8364,613,21389,California
Imperial,2021-02-26,2459,32102,1452,15671,1007,16431,0,0,1913,14416,545,8909,1936,23325,California
Imperial,2021-02-27,1089,33191,984,16655,105,16536,0,0,281,13911,810,9719,305,23630,California
Imperial,2021-02-28,126,33317,98,16753,28,16564,0,0,102,14000,24,9743,113,23743,California
Imperial,2021-03-01,658,33975,398,17151,253,16817,7,7,551,14469,100,9843,569,24312,California
Imperial,2021-03-02,847,34822,328,17479,518,17335,1,8,480,14600,364,10207,495,24807,California
Imperial,2021-03-03,1051,35873,116,17595,935,18270,0,8,631,14844,415,10622,659,25466,California
Imperial,2021-03-04,892,36765,160,17755,730,19000,2,10,588,15184,300,10922,640,26106,California
Imperial,2021-03-05,3292,40057,2316,20071,976,19976,0,10,1856,15639,1439,12361,1894,28000,California
Imperial,2021-03-06,864,40921,355,20426,507,20483,2,12,762,16331,99,12460,791,28791,California
Imperial,2021-03-07,188,41109,121,20547,63,20546,4,16,129,16430,58,12518,157,28948,California
Imperial,2021-03-08,537,41646,415,20962,83,20629,39,55,422,16811,114,12632,495,29443,California
Imperial,2021-03-09,811,42457,397,21359,160,20789,254,309,484,17224,327,12959,740,30183,California
Imperial,2021-03-10,901,43358,399,21758,309,21098,193,502,405,17340,494,13453,610,30793,California
Imperial,2021-03-11,1991,45349,548,22306,1169,22267,274,776,1273,18196,715,14168,1571,32364,California
Imperial,2021-03-12,5048,50397,3545,25851,1239,23506,264,1040,3188,19823,1850,16018,3477,35841,California
Imperial,2021-03-13,1257,51654,126,25977,895,24401,236,1276,900,20632,354,16372,1163,37004,California
Imperial,2021-03-14,242,51896,66,26043,160,24561,16,1292,167,20757,74,16446,199,37203,California
Imperial,2021-03-15,846,52742,290,26333,245,24806,311,1603,452,21149,390,16836,782,37985,California
Imperial,2021-03-16,1373,54115,393,26726,445,25251,535,2138,665,21675,704,17540,1230,39215,California
Imperial,2021-03-17,1776,55891,765,27491,818,26069,193,2331,1081,22270,688,18228,1283,40498,California
Imperial,2021-03-18,1974,57865,1290,28781,599,26668,85,2416,1365,23122,603,18831,1455,41953,California
Imperial,2021-03-19,3976,61841,2887,31668,1064,27732,25,2441,1969,23122,1998,20829,1998,43951,California
Imperial,2021-03-20,1871,63712,602,32270,1251,28983,18,2459,1366,24018,495,21324,1391,45342,California
Imperial,2021-03-21,303,64015,113,32383,184,29167,6,2465,170,24069,133,21457,184,45526,California
Imperial,2021-03-22,1211,65226,434,32817,750,29917,27,2492,679,24259,529,21986,719,46245,California
Imperial,2021-03-23,1654,66880,579,33396,1053,30970,22,2514,1010,24657,639,22625,1037,47282,California
Imperial,2021-03-24,2343,69223,664,34060,1235,32205,444,2958,1247,25260,1091,23716,1694,48976,California
Imperial,2021-03-25,3380,72603,827,34887,915,33120,1638,4596,1279,26074,2093,25809,2907,51883,California
Imperial,2021-03-26,3400,76003,1285,36172,1095,34215,1020,5616,988,25688,2399,28208,2013,53896,California
Imperial,2021-03-27,725,76728,348,36520,308,34523,69,5685,468,25971,254,28462,537,54433,California
Imperial,2021-03-28,277,77005,96,36616,172,34695,9,5694,190,26087,85,28547,201,54634,California
Imperial,2021-03-29,1678,78683,429,37045,440,35135,809,6503,380,25985,1293,29840,1191,55825,California
Imperial,2021-03-30,2297,80980,758,37803,648,35783,891,7394,739,26057,1554,31394,1626,57451,California
Imperial,2021-03-31,1706,82686,798,38601,851,36634,57,7451,1072,26554,631,32025,1128,58579,California
Imperial,2021-04-01,2302,84988,494,39095,1479,38113,329,7780,944,26480,1348,33373,1274,59853,California
Imperial,2021-04-02,2319,87307,539,39634,1639,39752,141,7921,1474,27266,835,34208,1621,61474,California
Imperial,2021-04-03,1599,88906,480,40114,1029,40781,90,8011,715,27193,882,35090,809,62283,California
Imperial,2021-04-04,130,89036,80,40194,33,40814,17,8028,39,27160,90,35180,57,62340,California
Imperial,2021-04-05,3587,92623,2366,42560,994,41808,227,8255,842,25500,2732,37912,1072,63412,California
Imperial,2021-04-06,1526,94149,611,43171,649,42457,266,8521,754,25756,767,38679,1023,64435,California
Imperial,2021-04-07,2354,96503,632,43803,1285,43742,437,8958,1629,27088,728,39407,2060,66495,California
Imperial,2021-04-08,2368,98871,1149,44952,856,44598,363,9321,1100,27286,1263,40670,1461,67956,California
Imperial,2021-04-09,3628,102499,1737,46689,1097,45695,794,10115,1608,27674,2011,42681,2399,70355,California
Imperial,2021-04-10,1425,103924,251,46940,851,46546,323,10438,269,27111,1152,43833,589,70944,California
Imperial,2021-04-11,266,104190,69,47009,164,46710,33,10471,92,27065,172,44005,126,71070,California
Imperial,2021-04-12,1543,105733,832,47841,488,47198,223,10694,871,27498,663,44668,1096,72166,California
Imperial,2021-04-13,3038,108771,1957,49798,1079,48277,2,10696,2077,28624,956,45624,2082,74248,California
Imperial,2021-04-14,2236,111007,1021,50819,1213,49490,2,10698,1508,29418,719,46343,1513,75761,California
Imperial,2021-04-15,2073,113080,953,51772,1120,50610,0,10698,1364,30086,702,47045,1370,77131,California
Imperial,2021-04-16,3804,116884,1840,53612,1964,52574,0,10698,2431,31162,1360,48405,2436,79567,California
Imperial,2021-04-17,1897,118781,959,54571,936,53510,2,10700,1453,32180,438,48843,1456,81023,California
Imperial,2021-04-18,283,119064,92,54663,191,53701,0,10700,92,32090,188,49031,98,81121,California
Imperial,2021-04-19,910,119974,285,54948,624,54325,1,10701,448,32085,459,49490,454,81575,California
Imperial,2021-04-20,1438,121412,570,55518,867,55192,1,10702,803,32260,632,50122,807,82382,California
Imperial,2021-04-21,1537,122949,407,55925,1129,56321,1,10703,863,32461,666,50788,867,83249,California
Imperial,2021-04-22,2585,125534,855,56780,1730,58051,0,10703,1781,33456,788,51576,1783,85032,California
Imperial,2021-04-23,2935,128469,560,57340,2375,60426,0,10703,1132,32825,1767,53343,1136,86168,California
Imperial,2021-04-24,623,129092,348,57688,275,60701,0,10703,246,32696,375,53718,246,86414,California
Imperial,2021-04-25,284,129376,108,57796,176,60877,0,10703,132,32679,149,53867,132,86546,California
Imperial,2021-04-26,1297,130673,508,58304,784,61661,5,10708,725,32847,562,54429,730,87276,California
Imperial,2021-04-27,1231,131904,402,58706,817,62478,12,10720,618,32874,605,55034,632,87908,California
Imperial,2021-04-28,1581,133485,669,59375,877,63355,35,10755,725,32787,846,55880,759,88667,California
Imperial,2021-04-29,1947,135432,896,60271,1001,64356,50,10805,866,32639,1068,56948,920,89587,California
Imperial,2021-04-30,3393,138825,1716,61987,1638,65994,39,10844,1638,32570,1746,58694,1677,91264,California
Imperial,2021-05-01,414,139239,161,62148,250,66244,3,10847,212,32588,197,58891,215,91479,California
Imperial,2021-05-02,101,139340,35,62183,59,66303,7,10854,47,32589,54,58945,55,91534,California
Imperial,2021-05-03,1717,141057,582,62765,1087,67390,48,10902,400,31731,1304,60249,446,91980,California
Imperial,2021-05-04,1881,142938,1003,63768,851,68241,27,10929,606,31100,1264,61513,633,92613,California
Imperial,2021-05-05,1608,144546,928,64696,659,68900,21,10950,509,30545,1086,62599,531,93144,California
Imperial,2021-05-06,1819,146365,1177,65873,600,69500,42,10992,588,29955,1222,63821,632,93776,California
Imperial,2021-05-07,2732,149097,1496,67369,1179,70679,57,11049,919,29145,1789,65610,979,94755,California
Imperial,2021-05-08,844,149941,662,68031,173,70852,9,11058,224,28765,613,66223,233,94988,California
Imperial,2021-05-09,111,150052,75,68106,34,70886,2,11060,32,28725,75,66298,35,95023,California
Imperial,2021-05-10,1212,151264,313,68419,775,71661,124,11184,372,28390,831,67129,496,95519,California
Imperial,2021-05-11,1562,152826,491,68910,1049,72710,22,11206,545,27952,1010,68139,572,96091,California
Imperial,2021-05-12,937,153763,287,69197,609,73319,41,11247,356,27772,576,68715,396,96487,California
Imperial,2021-05-13,2018,155781,1303,70500,641,73960,74,11321,917,27676,1086,69801,990,97477,California
Imperial,2021-05-14,1872,157653,989,71489,818,74778,65,11386,1208,28298,651,70452,1273,98750,California
Imperial,2021-05-15,1319,158972,497,71986,798,75576,24,11410,499,28008,815,71267,525,99275,California
Imperial,2021-05-16,129,159101,88,72074,37,75613,4,11414,57,27998,71,71338,61,99336,California
Imperial,2021-05-17,2011,161112,742,72816,1214,76827,55,11469,698,27446,1306,72644,754,100090,California
Imperial,2021-05-18,1827,162939,911,73727,835,77662,81,11550,986,27681,833,73477,1068,101158,California
Imperial,2021-05-19,1404,164343,630,74357,702,78364,72,11622,652,27662,742,74219,723,101881,California
Imperial,2021-05-20,1963,166306,1073,75430,810,79174,80,11702,825,27447,1120,75339,905,102786,California
Imperial,2021-05-21,2030,168336,1269,76699,695,79869,66,11768,1021,27537,997,76336,1087,103873,California
Imperial,2021-05-22,382,168718,212,76911,146,80015,24,11792,184,27554,191,76527,208,104081,California
Imperial,2021-05-23,100,168818,37,76948,54,80069,9,11801,36,27536,63,76590,45,104126,California
Imperial,2021-05-24,1311,170129,644,77592,603,80672,64,11865,533,27360,772,77362,596,104722,California
Imperial,2021-05-25,1606,171735,504,78096,1052,81724,50,11915,573,26963,1021,78383,624,105346,California
Imperial,2021-05-26,1159,172894,589,78685,510,82234,60,11975,517,26902,638,79021,577,105923,California
Imperial,2021-05-27,1436,174330,768,79453,588,82822,80,12055,705,26963,726,79747,787,106710,California
Imperial,2021-05-28,1174,175504,633,80086,443,83265,98,12153,433,26766,729,80476,532,107242,California
Imperial,2021-05-29,367,175871,158,80244,162,83427,47,12200,173,26792,194,80670,220,107462,California
Imperial,2021-05-30,106,175977,33,80277,71,83498,2,12202,72,26832,34,80704,74,107536,California
Imperial,2021-05-31,91,176068,24,80301,59,83557,8,12210,44,26837,47,80751,52,107588,California
Imperial,2021-06-01,1378,177446,603,80904,654,84211,121,12331,527,26648,839,81590,650,108238,California
Imperial,2021-06-02,1240,178686,637,81541,473,84684,130,12461,618,26781,613,82203,746,108984,California
Imperial,2021-06-03,1421,180107,787,82328,488,85172,146,12607,643,26800,770,82973,789,109773,California
Imperial,2021-06-04,2571,182678,1778,84106,629,85801,164,12771,1076,26562,1477,84450,1239,111012,California
Imperial,2021-06-05,499,183177,277,84383,160,85961,62,12833,238,26606,256,84706,300,111312,California
Imperial,2021-06-06,87,183264,50,84433,25,85986,12,12845,45,26622,42,84748,58,111370,California
Imperial,2021-06-07,1043,184307,670,85103,295,86281,78,12923,492,26643,549,85297,570,111940,California
Imperial,2021-06-08,1498,185805,1071,86174,338,86619,89,13012,603,26447,889,86186,693,112633,California
Imperial,2021-06-09,1154,186959,790,86964,284,86903,80,13092,525,26430,621,86807,604,113237,California
Imperial,2021-06-10,1246,188205,807,87771,364,87267,75,13167,457,26179,783,87590,532,113769,California
Imperial,2021-06-11,1758,189963,1234,89005,455,87722,69,13236,753,26012,992,88582,825,114594,California
Imperial,2021-06-12,347,190310,169,89174,144,87866,34,13270,164,26029,181,88763,198,114792,California
Imperial,2021-06-13,89,190399,26,89200,61,87927,2,13272,57,26058,31,88794,60,114852,California
Imperial,2021-06-14,900,191299,638,89838,214,88141,48,13320,385,25981,510,89304,433,115285,California
Imperial,2021-06-15,1125,192424,783,90621,293,88434,49,13369,513,25939,606,89910,564,115849,California
Imperial,2021-06-16,1055,193479,675,91296,308,88742,72,13441,505,25974,544,90454,579,116428,California
Imperial,2021-06-17,1142,194621,806,92102,275,89017,61,13502,482,25861,653,91107,540,116968,California
Imperial,2021-06-18,1192,195813,835,92937,286,89303,71,13573,716,26184,463,91570,786,117754,California
Imperial,2021-06-19,357,196170,223,93160,118,89421,16,13589,178,26201,177,91747,194,117948,California
Imperial,2021-06-20,67,196237,32,93192,31,89452,4,13593,24,26186,43,91790,28,117976,California
Imperial,2021-06-21,698,196935,421,93613,239,89691,38,13631,431,26396,261,92051,471,118447,California
Imperial,2021-06-22,1201,198136,835,94448,315,90006,51,13682,649,26551,545,92596,700,119147,California
Imperial,2021-06-23,1165,199301,794,95242,307,90313,64,13746,625,26710,528,93124,687,119834,California
Imperial,2021-06-24,1077,200378,729,95971,296,90609,52,13798,555,26799,518,93642,607,120441,California
Imperial,2021-06-25,1474,201852,1090,97061,296,90905,88,13886,625,26675,836,94478,712,121153,California
Imperial,2021-06-26,272,202124,176,97237,88,90993,8,13894,91,26595,179,94657,99,121252,California
Imperial,2021-06-27,126,202250,62,97299,59,91052,5,13899,53,26579,73,94730,57,121309,California
Imperial,2021-06-28,662,202912,483,97782,158,91210,21,13920,344,26632,311,95041,364,121673,California
Imperial,2021-06-29,908,203820,661,98443,193,91403,54,13974,421,26627,482,95523,477,122150,California
Imperial,2021-06-30,904,204724,588,99031,291,91694,25,13999,388,26531,511,96034,415,122565,California
Imperial,2021-07-01,814,205538,583,99614,215,91909,16,14015,397,26534,410,96444,413,122978,California
Imperial,2021-07-02,965,206503,652,100266,287,92196,26,14041,413,26427,545,96989,438,123416,California
Imperial,2021-07-03,252,206755,131,100397,114,92310,7,14048,101,26389,145,97134,107,123523,California
Imperial,2021-07-04,41,206796,15,100412,24,92334,2,14050,19,26388,22,97156,21,123544,California
Imperial,2021-07-05,208,207004,93,100505,108,92442,7,14057,86,26359,121,97277,92,123636,California
Imperial,2021-07-06,999,208003,699,101204,271,92713,29,14086,393,26184,598,97875,423,124059,California
Imperial,2021-07-07,891,208894,561,101765,198,92911,132,14218,319,26070,564,98439,450,124509,California
Imperial,2021-07-08,751,209645,545,102310,179,93090,27,14245,322,25996,423,98862,349,124858,California
Imperial,2021-07-09,1034,210679,759,103069,246,93336,29,14274,455,25910,570,99432,484,125342,California
Imperial,2021-07-10,268,210947,140,103209,121,93457,7,14281,131,25913,135,99567,138,125480,California
Imperial,2021-07-11,96,211043,42,103251,54,93511,0,14281,50,25918,45,99612,50,125530,California
Imperial,2021-07-12,706,211749,525,103776,166,93677,15,14296,275,25781,426,100038,289,125819,California
Imperial,2021-07-13,752,212501,554,104330,178,93855,20,14316,356,25766,391,100429,376,126195,California
Imperial,2021-07-14,896,213397,655,104985,214,94069,27,14343,338,25584,546,100975,364,126559,California
Imperial,2021-07-15,731,214128,530,105515,183,94252,18,14361,328,25535,394,101369,345,126904,California
Imperial,2021-07-16,794,214922,570,106085,201,94453,23,14384,374,25519,414,101783,398,127302,California
Imperial,2021-07-17,206,215128,93,106178,110,94563,3,14387,107,25530,99,101882,110,127412,California
Imperial,2021-07-18,57,215185,30,106208,26,94589,1,14388,30,25534,27,101909,31,127443,California
Imperial,2021-07-19,585,215770,384,106592,185,94774,16,14404,261,25492,316,102225,274,127717,California
Imperial,2021-07-20,870,216640,626,107218,210,94984,34,14438,403,25472,457,102682,437,128154,California
Imperial,2021-07-21,726,217366,435,107653,274,95258,17,14455,358,25488,362,103044,378,128532,California
Imperial,2021-07-22,762,218128,529,108182,213,95471,20,14475,339,25433,414,103458,359,128891,California
Imperial,2021-07-23,784,218912,561,108743,206,95677,17,14492,388,25449,388,103846,404,129295,California
Imperial,2021-07-24,211,219123,107,108850,100,95777,4,14496,127,25498,81,103927,130,129425,California
Imperial,2021-07-25,42,219165,11,108861,31,95808,0,14496,27,25511,14,103941,27,129452,California
Imperial,2021-07-26,490,219655,302,109163,161,95969,27,14523,272,25598,213,104154,300,129752,California
Imperial,2021-07-27,765,220420,543,109706,192,96161,30,14553,392,25655,365,104519,422,130174,California
Imperial,2021-07-28,662,221082,450,110156,179,96340,33,14586,377,25784,280,104799,409,130583,California
Imperial,2021-07-29,639,221721,468,110624,145,96485,26,14612,307,25792,325,105124,333,130916,California
Imperial,2021-07-30,734,222455,538,111162,166,96651,30,14642,374,25840,355,105479,403,131319,California
Imperial,2021-07-31,234,222689,156,111318,73,96724,5,14647,132,25875,102,105581,137,131456,California
Imperial,2021-08-01,72,222761,45,111363,27,96751,0,14647,35,25873,37,105618,35,131491,California
Imperial,2021-08-02,508,223269,381,111744,109,96860,18,14665,258,25904,243,105861,274,131765,California
Imperial,2021-08-03,744,224013,537,112281,174,97034,33,14698,402,26002,338,106199,436,132201,California
Imperial,2021-08-04,681,224694,524,112805,143,97177,14,14712,343,26032,327,106526,357,132558,California
Imperial,2021-08-05,622,225316,456,113261,137,97314,29,14741,349,26143,266,106792,377,132935,California
Imperial,2021-08-06,695,226011,528,113789,149,97463,18,14759,379,26230,312,107104,399,133334,California
Imperial,2021-08-07,417,226428,293,114082,116,97579,8,14767,269,26361,146,107250,277,133611,California
Imperial,2021-08-08,94,226522,64,114146,30,97609,0,14767,60,26388,33,107283,60,133671,California
Imperial,2021-08-09,578,227100,385,114531,164,97773,29,14796,320,26485,253,107536,350,134021,California
Imperial,2021-08-10,803,227903,605,115136,174,97947,24,14820,442,26597,354,107890,466,134487,California
Imperial,2021-08-11,595,228498,439,115575,147,98094,9,14829,304,26627,283,108173,313,134800,California
Imperial,2021-08-12,626,229124,462,116037,136,98230,28,14857,346,26728,273,108446,374,135174,California
Imperial,2021-08-13,914,230038,672,116709,174,98404,68,14925,448,26787,460,108906,519,135693,California
Imperial,2021-08-14,410,230448,316,117025,84,98488,10,14935,275,26942,131,109037,286,135979,California
Imperial,2021-08-15,102,230550,87,117112,13,98501,2,14937,80,27003,22,109059,83,136062,California
Imperial,2021-08-16,623,231173,447,117559,152,98653,24,14961,355,27125,258,109317,380,136442,California
Imperial,2021-08-17,789,231962,630,118189,143,98796,16,14977,449,27266,323,109640,464,136906,California
Imperial,2021-08-18,812,232774,575,118764,188,98984,49,15026,414,27342,388,110028,464,137370,California
Imperial,2021-08-19,743,233517,596,119360,135,99119,12,15038,447,27520,282,110310,460,137830,California
Imperial,2021-08-20,852,234369,657,120017,181,99300,14,15052,489,27697,327,110637,504,138334,California
Imperial,2021-08-21,386,234755,300,120317,83,99383,3,15055,214,27749,165,110802,217,138551,California
Imperial,2021-08-22,128,234883,98,120415,28,99411,2,15057,89,27803,37,110839,91,138642,California
Imperial,2021-08-23,554,235437,407,120822,131,99542,16,15073,290,27848,261,111100,306,138948,California
Imperial,2021-08-24,710,236147,547,121369,149,99691,14,15087,340,27872,331,111431,355,139303,California
Imperial,2021-08-25,475,236622,332,121701,126,99817,17,15104,239,27907,222,111653,257,139560,California
Imperial,2021-08-26,607,237229,486,122187,113,99930,8,15112,335,27994,255,111908,342,139902,California
Imperial,2021-08-27,531,237760,421,122608,98,100028,12,15124,275,28034,247,112155,287,140189,California
Imperial,2021-08-28,251,238011,185,122793,64,100092,2,15126,134,28058,112,112267,136,140325,California
Imperial,2021-08-29,135,238146,103,122896,28,100120,4,15130,85,28101,47,112314,90,140415,California
Imperial,2021-08-30,294,238440,232,123128,54,100174,8,15138,145,28113,141,112455,153,140568,California
Inyo,2020-12-19,85,85,85,85,0,0,0,0,85,85,0,0,85,85,California
Inyo,2020-12-20,59,144,59,144,0,0,0,0,59,144,0,0,59,144,California
Inyo,2020-12-21,87,231,84,228,3,3,0,0,87,231,0,0,87,231,California
Inyo,2020-12-22,102,333,101,329,1,4,0,0,102,333,0,0,102,333,California
Inyo,2020-12-23,71,404,65,394,6,10,0,0,71,404,0,0,71,404,California
Inyo,2020-12-24,15,419,15,409,0,10,0,0,15,419,0,0,15,419,California
Inyo,2020-12-25,1,420,0,409,1,11,0,0,1,420,0,0,1,420,California
Inyo,2020-12-26,73,493,73,482,0,11,0,0,73,493,0,0,73,493,California
Inyo,2020-12-28,48,541,36,518,12,23,0,0,48,541,0,0,48,541,California
Inyo,2020-12-29,17,558,17,535,0,23,0,0,17,558,0,0,17,558,California
Inyo,2020-12-30,58,616,55,590,3,26,0,0,58,616,0,0,58,616,California
Inyo,2020-12-31,30,646,0,590,30,56,0,0,30,646,0,0,30,646,California
Inyo,2021-01-01,1,647,0,590,1,57,0,0,1,647,0,0,1,647,California
Inyo,2021-01-03,1,648,0,590,1,58,0,0,1,648,0,0,1,648,California
Inyo,2021-01-04,6,654,2,592,4,62,0,0,6,654,0,0,6,654,California
Inyo,2021-01-05,35,689,0,592,35,97,0,0,35,689,0,0,35,689,California
Inyo,2021-01-06,60,749,0,592,60,157,0,0,60,749,0,0,60,749,California
Inyo,2021-01-07,31,780,1,593,30,187,0,0,31,780,0,0,31,780,California
Inyo,2021-01-08,8,788,8,601,0,187,0,0,3,779,5,5,4,784,California
Inyo,2021-01-09,86,874,86,687,0,187,0,0,0,693,86,91,0,784,California
Inyo,2021-01-10,53,927,53,740,0,187,0,0,0,640,53,144,0,784,California
Inyo,2021-01-11,96,1023,81,821,15,202,0,0,16,576,80,224,16,800,California
Inyo,2021-01-12,133,1156,112,933,21,223,0,0,27,497,106,330,27,827,California
Inyo,2021-01-13,85,1241,67,1000,18,241,0,0,21,455,64,394,22,849,California
Inyo,2021-01-14,60,1301,13,1013,47,288,0,0,50,495,10,404,50,899,California
Inyo,2021-01-15,156,1457,28,1041,128,416,0,0,156,651,0,404,156,1055,California
Inyo,2021-01-16,72,1529,72,1113,0,416,0,0,0,579,72,476,0,1055,California
Inyo,2021-01-18,58,1587,36,1149,22,438,0,0,19,559,39,515,19,1074,California
Inyo,2021-01-19,112,1699,69,1218,43,481,0,0,96,639,16,531,96,1170,California
Inyo,2021-01-20,149,1848,70,1288,79,560,0,0,90,670,59,590,90,1260,California
Inyo,2021-01-21,117,1965,58,1346,59,619,0,0,116,785,1,591,116,1376,California
Inyo,2021-01-22,62,2027,0,1346,62,681,0,0,60,843,2,593,60,1436,California
Inyo,2021-01-23,47,2074,44,1390,3,684,0,0,46,889,0,593,46,1482,California
Inyo,2021-01-25,49,2123,6,1396,43,727,0,0,35,910,14,607,35,1517,California
Inyo,2021-01-26,131,2254,50,1446,81,808,0,0,125,1029,6,613,125,1642,California
Inyo,2021-01-27,22,2276,2,1448,20,828,0,0,21,1049,1,614,21,1663,California
Inyo,2021-01-28,90,2366,3,1451,87,915,0,0,61,1081,29,643,61,1724,California
Inyo,2021-01-29,24,2390,2,1453,22,937,0,0,22,1101,2,645,22,1746,California
Inyo,2021-01-30,12,2402,0,1453,12,949,0,0,10,1109,2,647,10,1756,California
Inyo,2021-01-31,24,2426,3,1456,21,970,0,0,4,1092,21,668,4,1760,California
Inyo,2021-02-01,11,2437,10,1466,1,971,0,0,1,1083,10,678,1,1761,California
Inyo,2021-02-02,130,2567,14,1480,116,1087,0,0,104,1161,26,704,104,1865,California
Inyo,2021-02-03,118,2685,0,1480,118,1205,0,0,72,1188,46,750,73,1938,California
Inyo,2021-02-04,150,2835,32,1512,118,1323,0,0,90,1219,60,810,91,2029,California
Inyo,2021-02-05,107,2942,51,1563,56,1379,0,0,105,1322,2,812,105,2134,California
Inyo,2021-02-06,3,2945,3,1566,0,1379,0,0,2,1324,0,812,2,2136,California
Inyo,2021-02-07,4,2949,2,1568,2,1381,0,0,4,1328,0,812,4,2140,California
Inyo,2021-02-08,113,3062,6,1574,107,1488,0,0,94,1403,19,831,94,2234,California
Inyo,2021-02-09,200,3262,50,1624,150,1638,0,0,130,1463,70,901,130,2364,California
Inyo,2021-02-10,142,3404,14,1638,128,1766,0,0,109,1539,33,934,109,2473,California
Inyo,2021-02-11,226,3630,57,1695,169,1935,0,0,130,1573,96,1030,130,2603,California
Inyo,2021-02-12,294,3924,49,1744,245,2180,0,0,166,1612,127,1157,166,2769,California
Inyo,2021-02-13,48,3972,44,1788,4,2184,0,0,5,1574,43,1200,5,2774,California
Inyo,2021-02-14,2,3974,0,1788,2,2186,0,0,2,1576,0,1200,2,2776,California
Inyo,2021-02-15,27,4001,8,1796,19,2205,0,0,5,1559,22,1222,5,2781,California
Inyo,2021-02-16,178,4179,49,1845,129,2334,0,0,89,1562,86,1308,89,2870,California
Inyo,2021-02-17,39,4218,4,1849,35,2369,0,0,9,1541,30,1338,9,2879,California
Inyo,2021-02-18,120,4338,6,1855,114,2483,0,0,80,1581,40,1378,80,2959,California
Inyo,2021-02-19,52,4390,4,1859,48,2531,0,0,9,1547,43,1421,9,2968,California
Inyo,2021-02-20,507,4897,501,2360,6,2537,0,0,504,2049,2,1423,504,3472,California
Inyo,2021-02-21,441,5338,441,2801,0,2537,0,0,439,2488,1,1424,440,3912,California
Inyo,2021-02-22,59,5397,17,2818,42,2579,0,0,25,2479,34,1458,25,3937,California
Inyo,2021-02-23,198,5595,17,2835,181,2760,0,0,90,2463,106,1564,90,4027,California
Inyo,2021-02-24,116,5711,0,2835,116,2876,0,0,57,2461,59,1623,57,4084,California
Inyo,2021-02-25,127,5838,2,2837,125,3001,0,0,62,2458,65,1688,62,4146,California
Inyo,2021-02-26,95,5933,50,2887,45,3046,0,0,21,2405,74,1762,21,4167,California
Inyo,2021-02-27,17,5950,4,2891,13,3059,0,0,4,2396,13,1775,4,4171,California
Inyo,2021-02-28,2,5952,1,2892,1,3060,0,0,1,2396,1,1776,1,4172,California
Inyo,2021-03-01,19,5971,2,2894,17,3077,0,0,17,2411,2,1778,17,4189,California
Inyo,2021-03-02,200,6171,0,2894,200,3277,0,0,113,2437,87,1865,113,4302,California
Inyo,2021-03-03,86,6257,3,2897,83,3360,0,0,41,2434,44,1909,41,4343,California
Inyo,2021-03-04,126,6383,2,2899,124,3484,0,0,45,2399,80,1989,45,4388,California
Inyo,2021-03-05,142,6525,53,2952,89,3573,0,0,42,2341,100,2089,42,4430,California
Inyo,2021-03-06,19,6544,1,2953,18,3591,0,0,19,2360,0,2089,19,4449,California
Inyo,2021-03-07,6,6550,3,2956,3,3594,0,0,4,2362,2,2091,4,4453,California
Inyo,2021-03-08,169,6719,5,2961,164,3758,0,0,77,2347,92,2183,77,4530,California
Inyo,2021-03-09,191,6910,2,2963,189,3947,0,0,74,2304,117,2300,74,4604,California
Inyo,2021-03-10,76,6986,7,2970,68,4015,1,1,30,2289,46,2346,31,4635,California
Inyo,2021-03-11,211,7197,1,2971,205,4220,5,6,75,2233,136,2482,80,4715,California
Inyo,2021-03-12,178,7375,3,2974,169,4389,6,12,78,2218,99,2581,84,4799,California
Inyo,2021-03-13,568,7943,536,3510,23,4412,9,21,61,1783,505,3086,70,4869,California
Inyo,2021-03-14,438,8381,436,3946,2,4414,0,21,2,1351,434,3520,2,4871,California
Inyo,2021-03-15,51,8432,14,3960,35,4449,2,23,31,1364,20,3540,33,4904,California
Inyo,2021-03-16,162,8594,3,3963,153,4602,6,29,62,1335,98,3638,69,4973,California
Inyo,2021-03-17,107,8701,1,3964,99,4701,7,36,92,1419,15,3653,99,5072,California
Inyo,2021-03-18,186,8887,16,3980,164,4865,6,42,104,1447,82,3735,110,5182,California
Inyo,2021-03-19,46,8933,5,3985,37,4902,4,46,35,1476,10,3745,39,5221,California
Inyo,2021-03-20,20,8953,2,3987,9,4911,9,55,0,1465,20,3765,9,5230,California
Inyo,2021-03-22,59,9012,3,3990,51,4962,5,60,39,1489,20,3785,44,5274,California
Inyo,2021-03-23,195,9207,3,3993,188,5150,4,64,106,1510,89,3874,110,5384,California
Inyo,2021-03-24,141,9348,2,3995,134,5284,5,69,86,1547,55,3929,92,5476,California
Inyo,2021-03-25,332,9680,112,4107,217,5501,3,72,266,1750,66,3995,269,5745,California
Inyo,2021-03-26,92,9772,3,4110,85,5586,4,76,70,1802,22,4017,74,5819,California
Inyo,2021-03-27,46,9818,38,4148,5,5591,3,79,40,1839,6,4023,43,5862,California
Inyo,2021-03-28,2,9820,0,4148,2,5593,0,79,2,1841,0,4023,2,5864,California
Inyo,2021-03-29,107,9927,2,4150,100,5693,5,84,81,1902,25,4048,86,5950,California
Inyo,2021-03-30,219,10146,1,4151,213,5906,5,89,110,1908,109,4157,115,6065,California
Inyo,2021-03-31,147,10293,3,4154,138,6044,6,95,103,1974,44,4201,110,6175,California
Inyo,2021-04-01,171,10464,2,4156,168,6212,1,96,116,2037,54,4255,117,6292,California
Inyo,2021-04-02,82,10546,1,4157,79,6291,2,98,49,2055,33,4288,51,6343,California
Inyo,2021-04-03,72,10618,38,4195,21,6312,13,111,3,2003,67,4355,15,6358,California
Inyo,2021-04-04,5,10623,4,4199,0,6312,1,112,2,2002,3,4358,2,6360,California
Inyo,2021-04-05,100,10723,0,4199,97,6409,3,115,28,1961,72,4430,31,6391,California
Inyo,2021-04-06,234,10957,3,4202,167,6576,64,179,102,1995,132,4562,166,6557,California
Inyo,2021-04-07,202,11159,0,4202,74,6650,128,307,45,2011,157,4719,173,6730,California
Inyo,2021-04-08,182,11341,16,4218,150,6800,16,323,83,2011,99,4818,99,6829,California
Inyo,2021-04-09,124,11465,4,4222,97,6897,23,346,35,1981,88,4906,58,6887,California
Inyo,2021-04-10,41,11506,1,4223,23,6920,17,363,5,1966,36,4942,21,6908,California
Inyo,2021-04-11,1,11507,0,4223,1,6921,0,363,1,1967,0,4942,1,6909,California
Inyo,2021-04-12,80,11587,0,4223,75,6996,5,368,42,1976,38,4980,47,6956,California
Inyo,2021-04-13,123,11710,5,4228,115,7111,3,371,63,1984,58,5038,66,7022,California
Inyo,2021-04-14,130,11840,2,4230,128,7239,0,371,45,1944,85,5123,45,7067,California
Inyo,2021-04-15,269,12109,116,4346,153,7392,0,371,72,1819,197,5320,72,7139,California
Inyo,2021-04-16,47,12156,5,4351,42,7434,0,371,17,1807,29,5349,17,7156,California
Inyo,2021-04-17,2,12158,1,4352,1,7435,0,371,1,1807,1,5350,1,7157,California
Inyo,2021-04-19,122,12280,37,4389,85,7520,0,371,41,1768,80,5430,41,7198,California
Inyo,2021-04-20,165,12445,2,4391,163,7683,0,371,80,1764,85,5515,81,7279,California
Inyo,2021-04-21,113,12558,5,4396,108,7791,0,371,32,1715,81,5596,32,7311,California
Inyo,2021-04-22,199,12757,1,4397,198,7989,0,371,53,1623,146,5742,54,7365,California
Inyo,2021-04-23,95,12852,4,4401,91,8080,0,371,22,1572,73,5815,22,7387,California
Inyo,2021-04-24,314,13166,313,4714,1,8081,0,371,309,1877,5,5820,310,7697,California
Inyo,2021-04-25,140,13306,138,4852,2,8083,0,371,138,2013,2,5822,138,7835,California
Inyo,2021-04-26,94,13400,2,4854,91,8174,1,372,12,1945,81,5903,13,7848,California
Inyo,2021-04-27,185,13585,5,4859,176,8350,4,376,49,1862,136,6039,53,7901,California
Inyo,2021-04-28,121,13706,4,4863,115,8465,2,378,22,1788,98,6137,24,7925,California
Inyo,2021-04-29,173,13879,56,4919,117,8582,0,378,80,1775,93,6230,80,8005,California
Inyo,2021-04-30,81,13960,4,4923,76,8658,1,379,23,1741,58,6288,24,8029,California
Inyo,2021-05-01,9,13969,3,4926,6,8664,0,379,6,1744,3,6291,6,8035,California
Inyo,2021-05-02,6,13975,2,4928,2,8666,2,381,4,1748,2,6293,6,8041,California
Inyo,2021-05-03,38,14013,1,4929,33,8699,4,385,5,1724,33,6326,9,8050,California
Inyo,2021-05-04,120,14133,2,4931,115,8814,3,388,20,1647,100,6426,23,8073,California
Inyo,2021-05-05,36,14169,0,4931,34,8848,2,390,11,1635,25,6451,13,8086,California
Inyo,2021-05-06,96,14265,3,4934,85,8933,8,398,13,1573,83,6534,21,8107,California
Inyo,2021-05-07,48,14313,3,4937,37,8970,8,406,24,1583,22,6556,32,8139,California
Inyo,2021-05-08,15,14328,3,4940,6,8976,6,412,4,1582,11,6567,10,8149,California
Inyo,2021-05-09,1,14329,0,4940,1,8977,0,412,0,1581,1,6568,0,8149,California
Inyo,2021-05-10,69,14398,1,4941,66,9043,2,414,31,1576,39,6607,34,8183,California
Inyo,2021-05-11,90,14488,1,4942,86,9129,3,417,20,1530,69,6676,23,8206,California
Inyo,2021-05-12,43,14531,2,4944,39,9168,2,419,11,1511,32,6708,13,8219,California
Inyo,2021-05-13,77,14608,0,4944,76,9244,1,420,10,1455,67,6775,11,8230,California
Inyo,2021-05-14,29,14637,5,4949,18,9262,6,426,14,1460,15,6790,20,8250,California
Inyo,2021-05-15,382,15019,369,5318,10,9272,3,429,84,1251,296,7086,87,8337,California
Inyo,2021-05-16,206,15225,206,5524,0,9272,0,429,75,1196,130,7216,75,8412,California
Inyo,2021-05-17,60,15285,2,5526,55,9327,3,432,18,1175,42,7258,21,8433,California
Inyo,2021-05-18,86,15371,2,5528,83,9410,1,433,17,1125,68,7326,18,8451,California
Inyo,2021-05-19,48,15419,4,5532,39,9449,5,438,12,1106,36,7362,17,8468,California
Inyo,2021-05-20,148,15567,81,5613,65,9514,2,440,37,1033,112,7474,39,8507,California
Inyo,2021-05-21,48,15615,18,5631,25,9539,5,445,19,1028,29,7503,24,8531,California
Inyo,2021-05-22,25,15640,14,5645,8,9547,3,448,18,1042,7,7510,21,8552,California
Inyo,2021-05-23,2,15642,1,5646,0,9547,1,449,0,1041,2,7512,1,8553,California
Inyo,2021-05-24,35,15677,6,5652,26,9573,3,452,13,1035,22,7534,16,8569,California
Inyo,2021-05-25,83,15760,40,5692,41,9614,2,454,48,1050,35,7569,50,8619,California
Inyo,2021-05-26,46,15806,17,5709,27,9641,2,456,23,1053,22,7591,25,8644,California
Inyo,2021-05-27,41,15847,11,5720,22,9663,8,464,13,1047,27,7618,21,8665,California
Inyo,2021-05-28,26,15873,6,5726,15,9678,5,469,8,1042,18,7636,13,8678,California
Inyo,2021-05-29,14,15887,5,5731,9,9687,0,469,7,1042,7,7643,7,8685,California
Inyo,2021-05-30,2,15889,0,5731,2,9689,0,469,0,1040,2,7645,0,8685,California
Inyo,2021-06-01,54,15943,16,5747,32,9721,6,475,23,1038,31,7676,29,8714,California
Inyo,2021-06-02,12,15955,10,5757,1,9722,1,476,10,1047,2,7678,11,8725,California
Inyo,2021-06-03,27,15982,1,5758,18,9740,8,484,1,1031,25,7703,9,8734,California
Inyo,2021-06-04,32,16014,6,5764,22,9762,4,488,12,1027,20,7723,16,8750,California
Inyo,2021-06-05,16,16030,7,5771,8,9770,1,489,4,1020,12,7735,5,8755,California
Inyo,2021-06-07,52,16082,15,5786,34,9804,3,492,5,982,46,7781,8,8763,California
Inyo,2021-06-08,51,16133,23,5809,25,9829,3,495,24,982,27,7808,27,8790,California
Inyo,2021-06-09,112,16245,96,5905,14,9843,2,497,13,898,99,7907,15,8805,California
Inyo,2021-06-10,56,16301,40,5945,11,9854,5,502,15,879,39,7946,20,8825,California
Inyo,2021-06-11,42,16343,23,5968,17,9871,2,504,17,873,25,7971,19,8844,California
Inyo,2021-06-12,14,16357,8,5976,5,9876,1,505,5,870,9,7980,6,8850,California
Inyo,2021-06-13,1,16358,0,5976,1,9877,0,505,0,869,1,7981,0,8850,California
Inyo,2021-06-14,57,16415,27,6003,27,9904,3,508,7,829,50,8031,10,8860,California
Inyo,2021-06-15,52,16467,39,6042,9,9913,4,512,8,797,44,8075,12,8872,California
Inyo,2021-06-16,31,16498,18,6060,13,9926,0,512,5,776,26,8101,5,8877,California
Inyo,2021-06-17,26,16524,13,6073,9,9935,4,516,7,769,18,8119,11,8888,California
Inyo,2021-06-18,14,16538,5,6078,6,9941,3,519,2,762,12,8131,5,8893,California
Inyo,2021-06-19,21,16559,7,6085,13,9954,1,520,7,757,13,8144,8,8901,California
Inyo,2021-06-21,29,16588,8,6093,18,9972,3,523,13,757,16,8160,16,8917,California
Inyo,2021-06-22,51,16639,42,6135,7,9979,2,525,24,756,27,8187,26,8943,California
Inyo,2021-06-23,14,16653,6,6141,7,9986,1,526,1,745,13,8200,2,8945,California
Inyo,2021-06-24,8,16661,2,6143,5,9991,1,527,4,746,4,8204,5,8950,California
Inyo,2021-06-25,29,16690,13,6156,13,10004,3,530,15,750,14,8218,18,8968,California
Inyo,2021-06-26,12,16702,6,6162,4,10008,2,532,4,748,8,8226,6,8974,California
Inyo,2021-06-27,1,16703,1,6163,0,10008,0,532,1,749,0,8226,1,8975,California
Inyo,2021-06-28,14,16717,12,6175,2,10010,0,532,8,751,6,8232,8,8983,California
Inyo,2021-06-29,34,16751,29,6204,5,10015,0,532,14,745,20,8252,14,8997,California
Inyo,2021-06-30,21,16772,17,6221,4,10019,0,532,7,738,14,8266,7,9004,California
Inyo,2021-07-01,14,16786,8,6229,6,10025,0,532,8,740,6,8272,8,9012,California
Inyo,2021-07-02,21,16807,9,6238,12,10037,0,532,13,745,8,8280,13,9025,California
Inyo,2021-07-03,6,16813,6,6244,0,10037,0,532,5,749,1,8281,5,9030,California
Inyo,2021-07-05,4,16817,2,6246,2,10039,0,532,0,745,4,8285,0,9030,California
Inyo,2021-07-06,23,16840,14,6260,9,10048,0,532,15,752,8,8293,15,9045,California
Inyo,2021-07-07,18,16858,8,6268,8,10056,2,534,4,744,14,8307,6,9051,California
Inyo,2021-07-08,8,16866,6,6274,2,10058,0,534,7,750,1,8308,7,9058,California
Inyo,2021-07-09,7,16873,5,6279,1,10059,1,535,4,752,3,8311,5,9063,California
Inyo,2021-07-10,10,16883,8,6287,2,10061,0,535,5,752,5,8316,5,9068,California
Inyo,2021-07-11,2,16885,2,6289,0,10061,0,535,1,752,1,8317,1,9069,California
Inyo,2021-07-12,19,16904,6,6295,13,10074,0,535,11,755,8,8325,11,9080,California
Inyo,2021-07-13,21,16925,19,6314,2,10076,0,535,7,748,14,8339,7,9087,California
Inyo,2021-07-14,18,16943,16,6330,2,10078,0,535,14,760,2,8341,14,9101,California
Inyo,2021-07-15,12,16955,7,6337,5,10083,0,535,9,766,3,8344,9,9110,California
Inyo,2021-07-16,26,16981,16,6353,9,10092,1,536,17,775,9,8353,18,9128,California
Inyo,2021-07-17,13,16994,8,6361,5,10097,0,536,3,768,10,8363,3,9131,California
Inyo,2021-07-19,24,17018,5,6366,18,10115,1,537,15,775,9,8372,16,9147,California
Inyo,2021-07-20,23,17041,17,6383,6,10121,0,537,15,782,8,8380,15,9162,California
Inyo,2021-07-21,10,17051,4,6387,5,10126,1,538,6,785,4,8384,7,9169,California
Inyo,2021-07-22,14,17065,10,6397,4,10130,0,538,6,783,8,8392,6,9175,California
Inyo,2021-07-23,33,17098,17,6414,15,10145,1,539,14,779,19,8411,15,9190,California
Inyo,2021-07-24,15,17113,9,6423,6,10151,0,539,8,780,7,8418,8,9198,California
Inyo,2021-07-25,1,17114,0,6423,1,10152,0,539,1,781,0,8418,1,9199,California
Inyo,2021-07-26,12,17126,10,6433,2,10154,0,539,8,785,4,8422,8,9207,California
Inyo,2021-07-27,32,17158,22,6455,9,10163,1,540,20,794,12,8434,21,9228,California
Inyo,2021-07-28,16,17174,10,6465,5,10168,1,541,8,795,8,8442,9,9237,California
Inyo,2021-07-29,22,17196,8,6473,14,10182,0,541,15,803,7,8449,15,9252,California
Inyo,2021-07-30,16,17212,10,6483,6,10188,0,541,12,811,4,8453,12,9264,California
Inyo,2021-07-31,6,17218,5,6488,1,10189,0,541,3,811,3,8456,3,9267,California
Inyo,2021-08-01,1,17219,1,6489,0,10189,0,541,0,810,1,8457,0,9267,California
Inyo,2021-08-02,31,17250,7,6496,24,10213,0,541,22,823,9,8466,22,9289,California
Inyo,2021-08-03,34,17284,25,6521,9,10222,0,541,25,839,9,8475,25,9314,California
Inyo,2021-08-04,25,17309,17,6538,8,10230,0,541,13,840,12,8487,13,9327,California
Inyo,2021-08-05,21,17330,11,6549,9,10239,1,542,9,838,11,8498,9,9336,California
Inyo,2021-08-06,34,17364,23,6572,11,10250,0,542,22,848,12,8510,22,9358,California
Inyo,2021-08-07,5,17369,3,6575,2,10252,0,542,2,847,3,8513,2,9360,California
Inyo,2021-08-08,2,17371,2,6577,0,10252,0,542,2,849,0,8513,2,9362,California
Inyo,2021-08-09,27,17398,11,6588,15,10267,1,543,18,859,9,8522,19,9381,California
Inyo,2021-08-10,34,17432,29,6617,3,10270,2,545,24,875,10,8532,26,9407,California
Inyo,2021-08-11,21,17453,5,6622,14,10284,2,547,18,892,3,8535,20,9427,California
Inyo,2021-08-12,66,17519,29,6651,37,10321,0,547,57,941,8,8543,57,9484,California
Inyo,2021-08-13,33,17552,10,6661,23,10344,0,547,20,948,13,8556,20,9504,California
Inyo,2021-08-14,14,17566,10,6671,4,10348,0,547,4,942,10,8566,4,9508,California
Inyo,2021-08-15,2,17568,1,6672,1,10349,0,547,2,944,0,8566,2,9510,California
Inyo,2021-08-16,40,17608,23,6695,17,10366,0,547,24,953,15,8581,24,9534,California
Inyo,2021-08-17,49,17657,37,6732,12,10378,0,547,32,970,15,8596,32,9566,California
Inyo,2021-08-18,25,17682,14,6746,11,10389,0,547,17,981,6,8602,17,9583,California
Inyo,2021-08-19,21,17703,9,6755,11,10400,1,548,13,990,5,8607,14,9597,California
Inyo,2021-08-20,29,17732,13,6768,16,10416,0,548,9,984,15,8622,9,9606,California
Inyo,2021-08-21,13,17745,6,6774,7,10423,0,548,2,978,8,8630,2,9608,California
Inyo,2021-08-23,18,17763,11,6785,7,10430,0,548,9,980,7,8637,9,9617,California
Inyo,2021-08-24,47,17810,39,6824,8,10438,0,548,25,986,19,8656,25,9642,California
Inyo,2021-08-25,17,17827,13,6837,4,10442,0,548,10,993,3,8659,10,9652,California
Inyo,2021-08-26,41,17868,15,6852,26,10468,0,548,25,1005,13,8672,25,9677,California
Inyo,2021-08-27,30,17898,22,6874,8,10476,0,548,11,999,17,8689,11,9688,California
Inyo,2021-08-28,15,17913,8,6882,7,10483,0,548,5,995,9,8698,5,9693,California
Inyo,2021-08-29,1,17914,1,6883,0,10483,0,548,0,994,1,8699,0,9693,California
Inyo,2021-08-30,20,17934,13,6896,7,10490,0,548,10,994,10,8709,10,9703,California
Kern,2020-12-15,1,1,1,1,0,0,0,0,1,1,0,0,1,1,California
Kern,2020-12-16,19,20,19,20,0,0,0,0,19,20,0,0,19,20,California
Kern,2020-12-17,162,182,162,182,0,0,0,0,164,184,0,0,164,184,California
Kern,2020-12-18,323,505,323,505,0,0,0,0,323,507,0,0,323,507,California
Kern,2020-12-19,102,607,102,607,0,0,0,0,102,609,0,0,102,609,California
Kern,2020-12-20,61,668,61,668,0,0,0,0,61,670,0,0,61,670,California
Kern,2020-12-21,670,1338,669,1337,1,1,0,0,670,1340,0,0,670,1340,California
Kern,2020-12-22,535,1873,533,1870,2,3,0,0,535,1875,0,0,535,1875,California
Kern,2020-12-23,556,2429,419,2289,137,140,0,0,556,2431,0,0,556,2431,California
Kern,2020-12-24,125,2554,46,2335,79,219,0,0,125,2556,0,0,125,2556,California
Kern,2020-12-25,1,2555,1,2336,0,219,0,0,1,2557,0,0,1,2557,California
Kern,2020-12-26,34,2589,2,2338,32,251,0,0,34,2591,0,0,34,2591,California
Kern,2020-12-27,35,2624,3,2341,32,283,0,0,35,2626,0,0,35,2626,California
Kern,2020-12-28,832,3456,668,3009,164,447,0,0,832,3458,0,0,832,3458,California
Kern,2020-12-29,752,4208,456,3465,296,743,0,0,750,4207,1,1,750,4208,California
Kern,2020-12-30,1209,5417,917,4382,292,1035,0,0,1209,5416,0,1,1209,5417,California
Kern,2020-12-31,278,5695,100,4482,178,1213,0,0,278,5694,0,1,278,5695,California
Kern,2021-01-01,25,5720,11,4493,14,1227,0,0,25,5719,0,1,25,5720,California
Kern,2021-01-02,78,5798,18,4511,60,1287,0,0,78,5797,0,1,78,5798,California
Kern,2021-01-03,23,5821,4,4515,19,1306,0,0,23,5820,0,1,23,5821,California
Kern,2021-01-04,560,6381,364,4879,196,1502,0,0,560,6380,0,1,560,6381,California
Kern,2021-01-05,1134,7515,738,5617,396,1898,0,0,1122,7491,12,13,1123,7504,California
Kern,2021-01-06,1172,8687,455,6072,717,2615,0,0,1140,8599,32,45,1140,8644,California
Kern,2021-01-07,1422,10109,491,6563,931,3546,0,0,1250,9678,171,216,1250,9894,California
Kern,2021-01-08,1635,11744,773,7336,862,4408,0,0,1337,10716,299,515,1337,11231,California
Kern,2021-01-09,231,11975,82,7418,149,4557,0,0,193,10871,38,553,193,11424,California
Kern,2021-01-10,194,12169,148,7566,46,4603,0,0,154,10985,40,593,154,11578,California
Kern,2021-01-11,1562,13731,988,8554,574,5177,0,0,1003,11430,559,1152,1004,12582,California
Kern,2021-01-12,1892,15623,824,9378,1068,6245,0,0,1367,12273,525,1677,1368,13950,California
Kern,2021-01-13,1871,17494,882,10260,989,7234,0,0,1446,13294,425,2102,1446,15396,California
Kern,2021-01-14,2212,19706,657,10917,1555,8789,0,0,2163,15409,49,2151,2164,17560,California
Kern,2021-01-15,2735,22441,858,11775,1877,10666,0,0,2641,17958,93,2244,2642,20202,California
Kern,2021-01-16,681,23122,215,11990,466,11132,0,0,647,18571,34,2278,647,20849,California
Kern,2021-01-17,82,23204,8,11998,74,11206,0,0,80,18649,2,2280,80,20929,California
Kern,2021-01-18,1646,24850,660,12658,986,12192,0,0,1475,19953,171,2451,1475,22404,California
Kern,2021-01-19,1884,26734,1041,13699,843,13035,0,0,1415,20901,469,2920,1417,23821,California
Kern,2021-01-20,2745,29479,1797,15496,948,13983,0,0,1961,22085,779,3699,1963,25784,California
Kern,2021-01-21,2140,31619,875,16371,1265,15248,0,0,1943,23832,196,3895,1943,27727,California
Kern,2021-01-22,2746,34365,1327,17698,1419,16667,0,0,2460,26007,285,4180,2460,30187,California
Kern,2021-01-23,1259,35624,544,18242,715,17382,0,0,1210,27168,49,4229,1210,31397,California
Kern,2021-01-24,152,35776,11,18253,141,17523,0,0,146,27308,6,4235,146,31543,California
Kern,2021-01-25,2380,38156,1086,19339,1294,18817,0,0,1891,28713,487,4722,1892,33435,California
Kern,2021-01-26,2793,40949,1135,20474,1658,20475,0,0,1928,29778,863,5585,1928,35363,California
Kern,2021-01-27,3568,44517,1895,22369,1673,22148,0,0,2863,31939,702,6287,2863,38226,California
Kern,2021-01-28,2897,47414,1365,23734,1532,23680,0,0,2466,33981,426,6713,2468,40694,California
Kern,2021-01-29,3811,51225,1811,25545,2000,25680,0,0,3247,36666,562,7275,3247,43941,California
Kern,2021-01-30,1335,52560,505,26050,830,26510,0,0,1279,37891,54,7329,1279,45220,California
Kern,2021-01-31,395,52955,272,26322,123,26633,0,0,260,38016,135,7464,260,45480,California
Kern,2021-02-01,2599,55554,975,27297,1624,28257,0,0,1881,39185,714,8178,1883,47363,California
Kern,2021-02-02,2771,58325,803,28100,1968,30225,0,0,2064,40543,707,8885,2065,49428,California
Kern,2021-02-03,3712,62037,1557,29657,2155,32380,0,0,2719,42276,986,9871,2719,52147,California
Kern,2021-02-04,3827,65864,1452,31109,2375,34755,0,0,2578,43619,1235,11106,2578,54725,California
Kern,2021-02-05,4884,70748,1993,33102,2891,37646,0,0,3107,44965,1761,12867,3107,57832,California
Kern,2021-02-06,1748,72496,763,33865,985,38631,0,0,1510,46241,234,13101,1510,59342,California
Kern,2021-02-07,278,72774,145,34010,133,38764,0,0,259,46483,17,13118,259,59601,California
Kern,2021-02-08,2567,75341,780,34790,1787,40551,0,0,1252,46439,1297,14415,1253,60854,California
Kern,2021-02-09,3057,78398,981,35771,2076,42627,0,0,1464,46319,1584,15999,1464,62318,California
Kern,2021-02-10,3844,82242,1677,37448,2167,44794,0,0,1877,46248,1948,17947,1877,64195,California
Kern,2021-02-11,4304,86546,1547,38995,2757,47551,0,0,2230,46420,2060,20007,2232,66427,California
Kern,2021-02-12,5027,91573,1913,40908,3114,50665,0,0,2485,46379,2526,22533,2485,68912,California
Kern,2021-02-13,2022,93595,735,41643,1287,51952,0,0,1155,46669,865,23398,1155,70067,California
Kern,2021-02-14,357,93952,14,41657,343,52295,0,0,273,46859,83,23481,273,70340,California
Kern,2021-02-15,2775,96727,909,42566,1866,54161,0,0,1225,46543,1541,25022,1225,71565,California
Kern,2021-02-16,2980,99707,722,43288,2258,56419,0,0,1662,46897,1309,26331,1663,73228,California
Kern,2021-02-17,4127,103834,2099,45387,2028,58447,0,0,1946,46672,2173,28504,1948,75176,California
Kern,2021-02-18,3812,107646,1521,46908,2291,60738,0,0,1625,46124,2173,30677,1625,76801,California
Kern,2021-02-19,4278,111924,1951,48859,2327,63065,0,0,1774,45403,2495,33172,1774,78575,California
Kern,2021-02-20,2639,114563,985,49844,1654,64719,0,0,1371,45514,1260,34432,1371,79946,California
Kern,2021-02-21,269,114832,157,50001,112,64831,0,0,89,45426,178,34610,90,80036,California
Kern,2021-02-22,2815,117647,1236,51237,1579,66410,0,0,1512,45642,1296,35906,1512,81548,California
Kern,2021-02-23,3709,121356,1194,52431,2515,68925,0,0,2043,46024,1662,37568,2044,83592,California
Kern,2021-02-24,5441,126797,2386,54817,3055,71980,0,0,3211,47016,2219,39787,3211,86803,California
Kern,2021-02-25,5608,132405,2582,57399,3026,75006,0,0,3327,48088,2256,42043,3328,90131,California
Kern,2021-02-26,7205,139610,3671,61070,3534,78540,0,0,4536,49967,2658,44701,4537,94668,California
Kern,2021-02-27,4141,143751,2055,63125,2086,80626,0,0,2729,51294,1402,46103,2729,97397,California
Kern,2021-02-28,962,144713,529,63654,432,81058,1,1,717,51770,242,46345,718,98115,California
Kern,2021-03-01,4096,148809,1863,65517,2229,83287,4,5,2758,53206,1326,47671,2762,100877,California
Kern,2021-03-02,4610,153419,1417,66934,3189,86476,4,9,3011,54635,1585,49256,3014,103891,California
Kern,2021-03-03,6132,159551,2882,69816,3248,89724,2,11,3962,56444,2154,51410,3963,107854,California
Kern,2021-03-04,5811,165362,2298,72114,3508,93232,5,16,3766,58188,2025,53435,3769,111623,California
Kern,2021-03-05,6841,172203,2891,75005,3930,97162,20,36,4233,59848,2594,56029,4254,115877,California
Kern,2021-03-06,4807,177010,1927,76932,2770,99932,110,146,3507,62172,1293,57322,3617,119494,California
Kern,2021-03-07,2110,179120,1604,78536,432,100364,74,220,1889,63916,219,57541,1963,121457,California
Kern,2021-03-08,2954,182074,935,79471,1786,102150,233,453,1552,64296,1399,58940,1779,123236,California
Kern,2021-03-09,3773,185847,810,80281,2573,104723,390,843,2355,65626,1409,60349,2739,125975,California
Kern,2021-03-10,6220,192067,2595,82876,2538,107261,1087,1930,3623,67752,2580,62929,4706,130681,California
Kern,2021-03-11,6353,198420,2451,85327,2871,110132,1031,2961,3769,69974,2570,65499,4792,135473,California
Kern,2021-03-12,7911,206331,3113,88440,3441,113573,1357,4318,4352,72118,3545,69044,5689,141162,California
Kern,2021-03-13,4696,211027,2545,90985,1813,115386,338,4656,3266,74292,1422,70466,3596,144758,California
Kern,2021-03-14,2329,213356,1545,92530,537,115923,247,4903,1802,75808,525,70991,2041,146799,California
Kern,2021-03-15,4285,217641,1111,93641,2465,118388,709,5612,2182,76601,2090,73081,2883,149682,California
Kern,2021-03-16,4469,222110,1017,94658,2905,121293,547,6159,2413,77513,2041,75122,2953,152635,California
Kern,2021-03-17,7512,229622,4111,98769,2848,124141,553,6712,4462,79491,3033,78155,5011,157646,California
Kern,2021-03-18,7362,236984,3751,102520,3023,127164,588,7300,4416,81567,2921,81076,4997,162643,California
Kern,2021-03-19,9187,246171,5036,107556,3378,130542,773,8073,4660,82488,4503,85579,5424,168067,California
Kern,2021-03-20,6296,252467,3860,111416,2252,132794,184,8257,3954,84297,2330,87909,4139,172206,California
Kern,2021-03-21,3107,255574,1971,113387,249,133043,887,9144,1898,85875,1200,89109,2778,174984,California
Kern,2021-03-22,3998,259572,1568,114955,2081,135124,349,9493,1897,86043,2076,91185,2244,177228,California
Kern,2021-03-23,4778,264350,1686,116641,2890,138014,202,9695,2471,86439,2274,93459,2670,179898,California
Kern,2021-03-24,7245,271595,3715,120356,3051,141065,479,10174,3643,86979,3577,97036,4117,184015,California
Kern,2021-03-25,6841,278436,3035,123391,3472,144537,334,10508,3197,86885,3621,100657,3527,187542,California
Kern,2021-03-26,9926,288362,4447,127838,4220,148757,1259,11767,4650,87541,5251,105908,5907,193449,California
Kern,2021-03-27,5772,294134,4035,131873,1605,150362,132,11899,3452,88810,2312,108220,3581,197030,California
Kern,2021-03-28,4750,298884,4240,136113,496,150858,14,11913,2978,90035,1767,109987,2992,200022,California
Kern,2021-03-29,4283,303167,1693,137806,2314,153172,276,12189,2597,91234,1671,111658,2870,202892,California
Kern,2021-03-30,5640,308807,1893,139699,3356,156528,391,12580,3027,92046,2602,114260,3414,206306,California
Kern,2021-03-31,8510,317317,4601,144300,3249,159777,660,13240,4298,92812,4189,118449,4955,211261,California
Kern,2021-04-01,7968,325285,3906,148206,3746,163523,316,13556,4216,93627,3712,122161,4527,215788,California
Kern,2021-04-02,8496,333781,4479,152685,3404,166927,613,14169,4193,94141,4280,126441,4794,220582,California
Kern,2021-04-03,6034,339815,3694,156379,2159,169086,181,14350,2661,93618,3361,129802,2838,223420,California
Kern,2021-04-04,1343,341158,874,157253,383,169469,86,14436,462,93286,878,130680,546,223966,California
Kern,2021-04-05,5425,346583,2239,159492,2403,171872,783,15219,2909,94448,2498,133178,3660,227626,California
Kern,2021-04-06,7155,353738,2470,161962,3303,175175,1382,16601,3556,95803,3570,136748,4925,232551,California
Kern,2021-04-07,9423,363161,5497,167459,2956,178131,970,17571,4570,96511,4828,141576,5536,238087,California
Kern,2021-04-08,8708,371869,4824,172283,2967,181098,917,18488,3732,96205,4939,146515,4633,242720,California
Kern,2021-04-09,10387,382256,5170,177453,4220,185318,997,19485,4359,95560,5993,152508,5348,248068,California
Kern,2021-04-10,6651,388907,3503,180956,1896,187214,1252,20737,2158,94487,4475,156983,3402,251470,California
Kern,2021-04-11,4286,393193,2970,183926,374,187588,942,21679,1283,93713,2987,159970,2213,253683,California
Kern,2021-04-12,4457,397650,1008,184934,2474,190062,975,22654,1605,93462,2827,162797,2576,256259,California
Kern,2021-04-13,4342,401992,1431,186365,2885,192947,26,22680,2123,93412,2198,164995,2148,258407,California
Kern,2021-04-14,6160,408152,3039,189404,3099,196046,22,22702,3019,93330,3122,168117,3040,261447,California
Kern,2021-04-15,5316,413468,2488,191892,2825,198871,3,22705,2490,93014,2809,170926,2493,263940,California
Kern,2021-04-16,7377,420845,3479,195371,3897,202768,1,22706,2987,91649,4356,175282,2991,266931,California
Kern,2021-04-17,6015,426860,3945,199316,2070,204838,0,22706,2089,89837,3902,179184,2090,269021,California
Kern,2021-04-18,3918,430778,3665,202981,253,205091,0,22706,929,87789,2978,182162,930,269951,California
Kern,2021-04-19,3872,434650,1752,204733,2118,207209,2,22708,1433,86810,2412,184574,1433,271384,California
Kern,2021-04-20,4505,439155,1678,206411,2825,210034,2,22710,1705,85744,2773,187347,1707,273091,California
Kern,2021-04-21,6046,445201,3281,209692,2760,212794,5,22715,2207,84152,3802,191149,2210,275301,California
Kern,2021-04-22,4921,450122,2420,212112,2501,215295,0,22715,1744,82747,3150,194299,1745,277046,California
Kern,2021-04-23,6323,456445,3144,215256,3178,218473,1,22716,1967,80408,4310,198609,1971,279017,California
Kern,2021-04-24,4078,460523,2854,218110,1213,219686,11,22727,1463,79291,2592,201201,1475,280492,California
Kern,2021-04-25,1427,461950,1135,219245,292,219978,0,22727,841,79553,579,201780,841,281333,California
Kern,2021-04-26,3928,465878,1879,221124,1998,221976,51,22778,1083,77855,2835,204615,1137,282470,California
Kern,2021-04-27,4867,470745,2386,223510,2373,224349,108,22886,1504,76122,3342,207957,1609,284079,California
Kern,2021-04-28,6483,477228,3865,227375,2493,226842,125,23011,1883,73553,4576,212533,2007,286086,California
Kern,2021-04-29,5695,482923,3211,230586,2385,229227,99,23110,1718,71422,3949,216482,1818,287904,California
Kern,2021-04-30,5803,488726,3288,233874,2355,231582,160,23270,1715,69227,4069,220551,1874,289778,California
Kern,2021-05-01,2801,491527,1984,235858,758,232340,59,23329,1123,68750,1658,222209,1181,290959,California
Kern,2021-05-02,1896,493423,1607,237465,267,232607,22,23351,690,68263,1199,223408,712,291671,California
Kern,2021-05-03,2592,496015,1056,238521,1401,234008,135,23486,802,67429,1773,225181,939,292610,California
Kern,2021-05-04,3782,499797,1366,239887,2307,236315,109,23595,1328,66429,2435,227616,1435,294045,California
Kern,2021-05-05,4297,504094,2247,242134,1894,238209,156,23751,1430,65170,2843,230459,1584,295629,California
Kern,2021-05-06,3745,507839,1741,243875,1855,240064,149,23900,1173,63946,2542,233001,1318,296947,California
Kern,2021-05-07,4705,512544,2374,246249,2156,242220,175,24075,1327,62107,3341,236342,1502,298449,California
Kern,2021-05-08,2987,515531,1883,248132,987,243207,117,24192,937,61124,2035,238377,1052,299501,California
Kern,2021-05-09,1359,516890,1183,249315,146,243353,30,24222,441,60689,906,239283,471,299972,California
Kern,2021-05-10,2347,519237,923,250238,1319,244672,105,24327,682,59833,1641,240924,785,300757,California
Kern,2021-05-11,2787,522024,1013,251251,1648,246320,126,24453,1008,59203,1764,242688,1134,301891,California
Kern,2021-05-12,3690,525714,1491,252742,2046,248366,153,24606,1155,57992,2515,245203,1304,303195,California
Kern,2021-05-13,3658,529372,1950,254692,1555,249921,153,24759,1720,57939,1923,247126,1870,305065,California
Kern,2021-05-14,4388,533760,2596,257288,1567,251488,225,24984,2013,57823,2355,249481,2239,307304,California
Kern,2021-05-15,2972,536732,1937,259225,946,252434,89,25073,1581,58119,1373,250854,1669,308973,California
Kern,2021-05-16,1631,538363,1399,260624,192,252626,40,25113,937,58413,683,251537,977,309950,California
Kern,2021-05-17,2359,540722,1016,261640,1198,253824,145,25258,1191,58594,1154,252691,1335,311285,California
Kern,2021-05-18,3251,543973,1504,263144,1614,255438,133,25391,1637,58762,1600,254291,1768,313053,California
Kern,2021-05-19,3872,547845,2419,265563,1322,256760,131,25522,1797,58630,2058,256349,1926,314979,California
Kern,2021-05-20,3193,551038,1761,267324,1288,258048,144,25666,1443,58488,1727,258076,1585,316564,California
Kern,2021-05-21,3755,554793,2272,269596,1342,259390,141,25807,1855,58612,1874,259950,1998,318562,California
Kern,2021-05-22,2993,557786,2331,271927,613,260003,49,25856,1406,58493,1571,261521,1452,320014,California
Kern,2021-05-23,1316,559102,1117,273044,172,260175,27,25883,687,58586,620,262141,713,320727,California
Kern,2021-05-24,1938,561040,837,273881,986,261161,115,25998,908,58588,1020,263161,1022,321749,California
Kern,2021-05-25,2434,563474,1132,275013,1211,262372,91,26089,1118,58496,1299,264460,1207,322956,California
Kern,2021-05-26,2850,566324,1652,276665,1095,263467,103,26192,1227,58220,1604,266064,1328,324284,California
Kern,2021-05-27,2480,568804,1291,277956,1082,264549,107,26299,1304,58479,1150,267214,1409,325693,California
Kern,2021-05-28,2791,571595,1432,279388,1248,265797,111,26410,1293,58400,1481,268695,1402,327095,California
Kern,2021-05-29,1942,573537,1279,280667,614,266411,49,26459,942,58407,984,269679,991,328086,California
Kern,2021-05-30,873,574410,711,281378,141,266552,21,26480,437,58439,426,270105,458,328544,California
Kern,2021-05-31,151,574561,50,281428,90,266642,11,26491,55,58412,92,270197,65,328609,California
Kern,2021-06-01,2334,576895,973,282401,1287,267929,74,26565,981,58137,1327,271524,1052,329661,California
Kern,2021-06-02,2286,579181,1326,283727,856,268785,104,26669,965,57899,1307,272831,1069,330730,California
Kern,2021-06-03,2444,581625,1380,285107,905,269690,159,26828,876,57378,1555,274386,1034,331764,California
Kern,2021-06-04,3008,584633,1955,287062,940,270630,113,26941,894,56300,2084,276470,1006,332770,California
Kern,2021-06-05,2552,587185,2056,289118,462,271092,34,26975,798,55388,1744,278214,832,333602,California
Kern,2021-06-06,1237,588422,1131,290249,83,271175,23,26998,405,54989,827,279041,428,334030,California
Kern,2021-06-07,1862,590284,1164,291413,598,271773,100,27098,709,54661,1136,280177,808,334838,California
Kern,2021-06-08,2131,592415,1243,292656,818,272591,70,27168,646,53912,1464,281641,715,335553,California
Kern,2021-06-09,2633,595048,1848,294504,696,273287,89,27257,823,53025,1797,283438,910,336463,California
Kern,2021-06-10,2271,597319,1403,295907,765,274052,103,27360,778,52425,1479,284917,879,337342,California
Kern,2021-06-11,2903,600222,1945,297852,867,274919,91,27451,1091,51813,1795,286712,1183,338525,California
Kern,2021-06-12,1817,602039,1350,299202,417,275336,50,27501,545,51140,1268,287980,595,339120,California
Kern,2021-06-13,953,602992,834,300036,112,275448,7,27508,283,50764,667,288647,291,339411,California
Kern,2021-06-14,1891,604883,1159,301195,634,276082,98,27606,660,50299,1222,289869,757,340168,California
Kern,2021-06-15,2169,607052,1220,302415,870,276952,79,27685,855,49928,1306,291175,935,341103,California
Kern,2021-06-16,2116,609168,1396,303811,642,277594,78,27763,830,49568,1267,292442,907,342010,California
Kern,2021-06-17,1999,611167,1280,305091,602,278196,117,27880,931,49562,1055,293497,1049,343059,California
Kern,2021-06-18,2257,613424,1421,306512,718,278914,118,27998,967,49375,1271,294768,1084,344143,California
Kern,2021-06-19,1243,614667,891,307403,315,279229,37,28035,528,49235,704,295472,564,344707,California
Kern,2021-06-20,743,615410,618,308021,105,279334,20,28055,295,49102,448,295920,315,345022,California
Kern,2021-06-21,1267,616677,674,308695,515,279849,78,28133,683,49288,573,296493,759,345781,California
Kern,2021-06-22,1668,618345,889,309584,702,280551,77,28210,679,49065,979,297472,756,346537,California
Kern,2021-06-23,1742,620087,1110,310694,549,281100,83,28293,764,48954,956,298428,845,347382,California
Kern,2021-06-24,1614,621701,998,311692,527,281627,89,28382,690,48817,916,299344,779,348161,California
Kern,2021-06-25,1829,623530,1145,312837,591,282218,93,28475,852,48794,965,300309,942,349103,California
Kern,2021-06-26,1341,624871,995,313832,314,282532,32,28507,578,48647,756,301065,609,349712,California
Kern,2021-06-27,621,625492,527,314359,78,282610,16,28523,268,48582,349,301414,284,349996,California
Kern,2021-06-28,1162,626654,771,315130,301,282911,90,28613,507,48536,640,302054,594,350590,California
Kern,2021-06-29,1414,628068,725,315855,598,283509,91,28704,606,48438,793,302847,695,351285,California
Kern,2021-06-30,1632,629700,1094,316949,452,283961,86,28790,841,48581,784,303631,927,352212,California
Kern,2021-07-01,1413,631113,903,317852,444,284405,66,28856,646,48532,761,304392,712,352924,California
Kern,2021-07-02,1801,632914,1208,319060,520,284925,73,28929,834,48487,950,305342,905,353829,California
Kern,2021-07-03,1036,633950,723,319783,271,285196,42,28971,513,48525,517,305859,555,354384,California
Kern,2021-07-04,134,634084,98,319881,36,285232,0,28971,64,48521,68,305927,64,354448,California
Kern,2021-07-05,668,634752,407,320288,236,285468,25,28996,294,48471,369,306296,319,354767,California
Kern,2021-07-06,1589,636341,938,321226,565,286033,86,29082,684,48348,893,307189,770,355537,California
Kern,2021-07-07,1523,637864,1033,322259,426,286459,64,29146,650,48197,863,308052,712,356249,California
Kern,2021-07-08,1474,639338,968,323227,438,286897,68,29214,571,47937,899,308951,639,356888,California
Kern,2021-07-09,1678,641016,1050,324277,552,287449,76,29290,767,47876,903,309854,842,357730,California
Kern,2021-07-10,918,641934,634,324911,257,287706,27,29317,458,47906,456,310310,486,358216,California
Kern,2021-07-11,550,642484,469,325380,76,287782,5,29322,241,47846,306,310616,246,358462,California
Kern,2021-07-12,1367,643851,935,326315,353,288135,79,29401,573,47711,787,311403,652,359114,California
Kern,2021-07-13,1320,645171,742,327057,527,288662,51,29452,626,47701,686,312089,676,359790,California
Kern,2021-07-14,1243,646414,776,327833,400,289062,67,29519,562,47658,669,312758,626,360416,California
Kern,2021-07-15,1378,647792,845,328678,491,289553,42,29561,713,47758,656,313414,756,361172,California
Kern,2021-07-16,1697,649489,1096,329774,541,290094,60,29621,899,47925,791,314205,958,362130,California
Kern,2021-07-17,1167,650656,830,330604,311,290405,26,29647,580,47952,578,314783,605,362735,California
Kern,2021-07-18,523,651179,395,330999,126,290531,2,29649,290,48015,229,315012,292,363027,California
Kern,2021-07-19,1373,652552,869,331868,446,290977,58,29707,718,48142,649,315661,776,363803,California
Kern,2021-07-20,1617,654169,910,332778,651,291628,56,29763,951,48493,655,316316,1006,364809,California
Kern,2021-07-21,1609,655778,1061,333839,497,292125,51,29814,845,48637,750,317066,894,365703,California
Kern,2021-07-22,1551,657329,1019,334858,475,292600,57,29871,895,48937,650,317716,950,366653,California
Kern,2021-07-23,1805,659134,1091,335949,653,293253,61,29932,1024,49253,766,318482,1082,367735,California
Kern,2021-07-24,1018,660152,632,336581,364,293617,22,29954,607,49477,405,318887,629,368364,California
Kern,2021-07-25,569,660721,431,337012,132,293749,6,29960,399,49716,166,319053,405,368769,California
Kern,2021-07-26,1500,662221,932,337944,503,294252,65,30025,1003,50295,488,319541,1067,369836,California
Kern,2021-07-27,1733,663954,1090,339034,586,294838,57,30082,1049,50728,674,320215,1107,370943,California
Kern,2021-07-28,1703,665657,1086,340120,569,295407,48,30130,1100,51285,590,320805,1147,372090,California
Kern,2021-07-29,1651,667308,1048,341168,537,295944,66,30196,1028,51764,613,321418,1092,373182,California
Kern,2021-07-30,2051,669359,1284,342452,693,296637,74,30270,1247,52288,797,322215,1321,374503,California
Kern,2021-07-31,1299,670658,875,343327,396,297033,28,30298,798,52628,487,322702,827,375330,California
Kern,2021-08-01,635,671293,471,343798,157,297190,7,30305,463,52927,171,322873,470,375800,California
Kern,2021-08-02,1708,673001,1096,344894,524,297714,88,30393,1121,53559,577,323450,1209,377009,California
Kern,2021-08-03,1982,674983,1204,346098,692,298406,86,30479,1284,54248,682,324132,1371,378380,California
Kern,2021-08-04,1693,676676,1073,347171,554,298960,66,30545,1104,54839,578,324710,1169,379549,California
Kern,2021-08-05,1669,678345,1113,348284,478,299438,78,30623,1041,55339,616,325326,1116,380665,California
Kern,2021-08-06,2318,680663,1475,349759,744,300182,99,30722,1484,56103,817,326143,1581,382246,California
Kern,2021-08-07,1389,682052,976,350735,383,300565,30,30752,880,56514,499,326642,910,383156,California
Kern,2021-08-08,683,682735,451,351186,224,300789,8,30760,439,56728,233,326875,447,383603,California
Kern,2021-08-09,2101,684836,1418,352604,597,301386,86,30846,1313,57350,777,327652,1399,385002,California
Kern,2021-08-10,2065,686901,1386,353990,606,301992,73,30919,1310,57993,739,328391,1382,386384,California
Kern,2021-08-11,1980,688881,1318,355308,591,302583,71,30990,1223,58546,740,329131,1293,387677,California
Kern,2021-08-12,2221,691102,1490,356798,612,303195,119,31109,1351,59161,851,329982,1466,389143,California
Kern,2021-08-13,2793,693895,1764,358562,876,304071,153,31262,1771,60087,997,330979,1923,391066,California
Kern,2021-08-14,1475,695370,971,359533,454,304525,50,31312,900,60493,544,331523,950,392016,California
Kern,2021-08-15,710,696080,452,359985,247,304772,11,31323,449,60714,238,331761,459,392475,California
Kern,2021-08-16,2590,698670,1738,361723,782,305554,70,31393,1571,61417,938,332699,1641,394116,California
Kern,2021-08-17,2615,701285,1703,363426,851,306405,61,31454,1494,61960,1011,333710,1554,395670,California
Kern,2021-08-18,2344,703629,1443,364869,826,307231,75,31529,1299,62432,902,334612,1374,397044,California
Kern,2021-08-19,2235,705864,1413,366282,687,307918,135,31664,1184,62808,940,335552,1316,398360,California
Kern,2021-08-20,3258,709122,2166,368448,979,308897,113,31777,1871,63571,1220,336772,1983,400343,California
Kern,2021-08-21,1567,710689,1035,369483,492,309389,40,31817,875,63845,640,337412,914,401257,California
Kern,2021-08-22,948,711637,721,370204,223,309612,4,31821,501,63931,419,337831,505,401762,California
Kern,2021-08-23,2596,714233,1898,372102,625,310237,73,31894,1343,64243,1102,338933,1414,403176,California
Kern,2021-08-24,2551,716784,1876,373978,614,310851,61,31955,1372,64582,1093,340026,1432,404608,California
Kern,2021-08-25,2484,719268,1777,375755,623,311474,84,32039,1354,64981,1036,341062,1435,406043,California
Kern,2021-08-26,2472,721740,1782,377537,580,312054,110,32149,1418,65555,952,342014,1526,407569,California
Kern,2021-08-27,3322,725062,2376,379913,832,312886,114,32263,1680,65874,1473,343487,1792,409361,California
Kern,2021-08-28,1771,726833,1349,381262,390,313276,32,32295,898,65964,840,344327,930,410291,California
Kern,2021-08-29,924,727757,681,381943,234,313510,9,32304,476,66030,419,344746,485,410776,California
Kern,2021-08-30,1495,729252,980,382923,445,313955,70,32374,709,66104,705,345451,779,411555,California
Kings,2020-12-16,1,1,1,1,0,0,0,0,1,1,0,0,1,1,California
Kings,2020-12-17,9,10,9,10,0,0,0,0,9,10,0,0,9,10,California
Kings,2020-12-18,12,22,12,22,0,0,0,0,12,22,0,0,12,22,California
Kings,2020-12-19,12,34,12,34,0,0,0,0,12,34,0,0,12,34,California
Kings,2020-12-20,13,47,13,47,0,0,0,0,13,47,0,0,13,47,California
Kings,2020-12-21,161,208,161,208,0,0,0,0,268,315,0,0,268,315,California
Kings,2020-12-22,140,348,139,347,1,1,0,0,137,452,0,0,137,452,California
Kings,2020-12-23,137,485,122,469,15,16,0,0,138,590,0,0,138,590,California
Kings,2020-12-24,11,496,9,478,2,18,0,0,11,601,0,0,11,601,California
Kings,2020-12-26,7,503,4,482,3,21,0,0,7,608,0,0,7,608,California
Kings,2020-12-27,5,508,4,486,1,22,0,0,5,613,0,0,5,613,California
Kings,2020-12-28,130,638,102,588,28,50,0,0,131,744,0,0,131,744,California
Kings,2020-12-29,86,724,58,646,28,78,0,0,87,831,0,0,87,831,California
Kings,2020-12-30,150,874,109,755,41,119,0,0,150,981,0,0,150,981,California
Kings,2020-12-31,46,920,5,760,41,160,0,0,46,1027,0,0,46,1027,California
Kings,2021-01-01,2,922,0,760,2,162,0,0,2,1029,0,0,2,1029,California
Kings,2021-01-02,11,933,9,769,2,164,0,0,11,1040,0,0,11,1040,California
Kings,2021-01-03,1,934,1,770,0,164,0,0,1,1041,0,0,1,1041,California
Kings,2021-01-04,113,1047,41,811,72,236,0,0,113,1154,0,0,113,1154,California
Kings,2021-01-05,195,1242,40,851,155,391,0,0,195,1349,0,0,195,1349,California
Kings,2021-01-06,277,1519,180,1031,97,488,0,0,274,1620,3,3,274,1623,California
Kings,2021-01-07,181,1700,83,1114,98,586,0,0,173,1785,8,11,173,1796,California
Kings,2021-01-08,251,1951,56,1170,195,781,0,0,230,1995,20,31,230,2026,California
Kings,2021-01-09,61,2012,8,1178,53,834,0,0,53,2040,8,39,53,2079,California
Kings,2021-01-10,15,2027,3,1181,12,846,0,0,12,2049,3,42,12,2091,California
Kings,2021-01-11,515,2542,351,1532,164,1010,0,0,275,2085,240,282,276,2367,California
Kings,2021-01-12,347,2889,252,1784,95,1105,0,0,216,2173,128,410,216,2583,California
Kings,2021-01-13,420,3309,274,2058,146,1251,0,0,329,2411,91,501,329,2912,California
Kings,2021-01-14,213,3522,33,2091,180,1431,0,0,203,2594,21,522,204,3116,California
Kings,2021-01-15,424,3946,34,2125,390,1821,0,0,413,2995,12,534,413,3529,California
Kings,2021-01-16,28,3974,10,2135,18,1839,0,0,27,3021,1,535,27,3556,California
Kings,2021-01-17,14,3988,11,2146,3,1842,0,0,12,3031,2,537,12,3568,California
Kings,2021-01-18,174,4162,41,2187,133,1975,0,0,148,3153,26,563,148,3716,California
Kings,2021-01-19,384,4546,161,2348,223,2198,0,0,255,3279,129,692,255,3971,California
Kings,2021-01-20,255,4801,163,2511,92,2290,0,0,135,3297,117,809,135,4106,California
Kings,2021-01-21,211,5012,57,2568,154,2444,0,0,193,3471,19,828,193,4299,California
Kings,2021-01-22,111,5123,19,2587,92,2536,0,0,109,3574,6,834,109,4408,California
Kings,2021-01-23,26,5149,13,2600,13,2549,0,0,20,3588,6,840,20,4428,California
Kings,2021-01-24,4,5153,4,2604,0,2549,0,0,2,3588,2,842,2,4430,California
Kings,2021-01-25,160,5313,55,2659,105,2654,0,0,97,3622,63,905,97,4527,California
Kings,2021-01-26,174,5487,53,2712,121,2775,0,0,114,3676,60,965,114,4641,California
Kings,2021-01-27,363,5850,64,2776,299,3074,0,0,256,3826,106,1071,256,4897,California
Kings,2021-01-28,365,6215,75,2851,290,3364,0,0,278,4017,87,1158,278,5175,California
Kings,2021-01-29,115,6330,27,2878,88,3452,0,0,96,4094,19,1177,96,5271,California
Kings,2021-01-30,1577,7907,19,2897,1558,5010,0,0,1573,5665,4,1181,1575,6846,California
Kings,2021-01-31,1,7908,1,2898,0,5010,0,0,1,5666,0,1181,1,6847,California
Kings,2021-02-01,243,8151,86,2984,157,5167,0,0,93,5611,148,1329,93,6940,California
Kings,2021-02-02,343,8494,112,3096,231,5398,0,0,99,5467,243,1572,99,7039,California
Kings,2021-02-03,482,8976,268,3364,214,5612,0,0,240,5466,241,1813,240,7279,California
Kings,2021-02-04,497,9473,159,3523,338,5950,0,0,232,5434,264,2077,232,7511,California
Kings,2021-02-05,423,9896,61,3584,362,6312,0,0,256,5528,162,2239,256,7767,California
Kings,2021-02-06,61,9957,11,3595,50,6362,0,0,27,5521,34,2273,27,7794,California
Kings,2021-02-07,6,9963,4,3599,2,6364,0,0,3,5521,3,2276,3,7797,California
Kings,2021-02-08,173,10136,29,3628,144,6508,0,0,66,5480,107,2383,66,7863,California
Kings,2021-02-09,260,10396,61,3689,199,6707,0,0,112,5446,146,2529,112,7975,California
Kings,2021-02-10,393,10789,113,3802,280,6987,0,0,264,5581,129,2658,264,8239,California
Kings,2021-02-11,561,11350,65,3867,496,7483,0,0,370,5762,189,2847,370,8609,California
Kings,2021-02-12,736,12086,36,3903,700,8183,0,0,355,5737,380,3227,355,8964,California
Kings,2021-02-13,248,12334,6,3909,242,8425,0,0,223,5935,25,3252,223,9187,California
Kings,2021-02-14,105,12439,4,3913,101,8526,0,0,97,6024,8,3260,97,9284,California
Kings,2021-02-15,254,12693,5,3918,249,8775,0,0,139,6049,114,3374,139,9423,California
Kings,2021-02-16,641,13334,36,3954,605,9380,0,0,362,6135,277,3651,363,9786,California
Kings,2021-02-17,448,13782,27,3981,421,9801,0,0,308,6304,140,3791,309,10095,California
Kings,2021-02-18,362,14144,22,4003,340,10141,0,0,222,6387,139,3930,222,10317,California
Kings,2021-02-19,231,14375,26,4029,205,10346,0,0,137,6433,91,4021,137,10454,California
Kings,2021-02-20,168,14543,32,4061,136,10482,0,0,139,6543,29,4050,139,10593,California
Kings,2021-02-21,4,14547,3,4064,1,10483,0,0,3,6545,1,4051,3,10596,California
Kings,2021-02-22,133,14680,20,4084,113,10596,0,0,58,6529,74,4125,58,10654,California
Kings,2021-02-23,447,15127,75,4159,372,10968,0,0,326,6734,121,4246,326,10980,California
Kings,2021-02-24,787,15914,169,4328,618,11586,0,0,546,7039,241,4487,546,11526,California
Kings,2021-02-25,873,16787,139,4467,734,12320,0,0,631,7430,240,4727,631,12157,California
Kings,2021-02-26,1023,17810,140,4607,883,13203,0,0,931,8269,92,4819,931,13088,California
Kings,2021-02-27,1579,19389,69,4676,1510,14713,0,0,615,7922,963,5782,616,13704,California
Kings,2021-02-28,1235,20624,617,5293,618,15331,0,0,695,8081,538,6320,697,14401,California
Kings,2021-03-01,305,20929,91,5384,214,15545,0,0,231,8238,74,6394,231,14632,California
Kings,2021-03-02,610,21539,264,5648,346,15891,0,0,532,8693,78,6472,533,15165,California
Kings,2021-03-03,782,22321,329,5977,452,16343,1,1,547,9009,233,6705,549,15714,California
Kings,2021-03-04,855,23176,358,6335,497,16840,0,1,710,9575,145,6850,711,16425,California
Kings,2021-03-05,1223,24399,371,6706,842,17682,10,11,992,10351,231,7081,1007,17432,California
Kings,2021-03-06,522,24921,190,6896,319,18001,13,24,491,10824,31,7112,504,17936,California
Kings,2021-03-07,468,25389,321,7217,139,18140,8,32,458,11279,10,7122,465,18401,California
Kings,2021-03-08,386,25775,97,7314,235,18375,54,86,269,11485,117,7239,323,18724,California
Kings,2021-03-09,711,26486,408,7722,249,18624,54,140,598,12026,112,7351,653,19377,California
Kings,2021-03-10,865,27351,268,7990,487,19111,110,250,579,12431,283,7634,688,20065,California
Kings,2021-03-11,1251,28602,456,8446,678,19789,117,367,780,12860,469,8103,898,20963,California
Kings,2021-03-12,1556,30158,463,8909,1001,20790,92,459,1008,13418,544,8647,1102,22065,California
Kings,2021-03-13,678,30836,328,9237,309,21099,41,500,549,13882,129,8776,593,22658,California
Kings,2021-03-14,681,31517,105,9342,187,21286,389,889,206,14002,475,9251,595,23253,California
Kings,2021-03-15,714,32231,271,9613,325,21611,118,1007,473,14355,240,9491,593,23846,California
Kings,2021-03-16,1215,33446,488,10101,667,22278,60,1067,762,14727,452,9943,824,24670,California
Kings,2021-03-17,1188,34634,435,10536,692,22970,61,1128,790,15188,398,10341,859,25529,California
Kings,2021-03-18,1258,35892,486,11022,551,23521,221,1349,760,15676,496,10837,984,26513,California
Kings,2021-03-19,1012,36904,465,11487,456,23977,91,1440,724,16219,287,11124,830,27343,California
Kings,2021-03-20,648,37552,258,11745,359,24336,31,1471,466,16544,180,11304,505,27848,California
Kings,2021-03-21,1424,38976,1088,12833,323,24659,13,1484,848,16829,576,11880,861,28709,California
Kings,2021-03-22,450,39426,198,13031,165,24824,87,1571,261,16993,188,12068,352,29061,California
Kings,2021-03-23,1066,40492,513,13544,489,25313,64,1635,558,17112,506,12574,625,29686,California
Kings,2021-03-24,1122,41614,489,14033,610,25923,23,1658,506,17031,613,13187,532,30218,California
Kings,2021-03-25,1087,42701,478,14511,580,26503,29,1687,442,16858,643,13830,470,30688,California
Kings,2021-03-26,1438,44139,384,14895,965,27468,89,1776,397,16308,1036,14866,486,31174,California
Kings,2021-03-27,656,44795,266,15161,378,27846,12,1788,147,15960,507,15373,159,31333,California
Kings,2021-03-28,679,45474,607,15768,65,27911,7,1795,314,15929,365,15738,334,31667,California
Kings,2021-03-29,484,45958,219,15987,204,28115,61,1856,265,16037,217,15955,325,31992,California
Kings,2021-03-30,985,46943,553,16540,390,28505,42,1898,431,15956,553,16508,472,32464,California
Kings,2021-03-31,941,47884,487,17027,379,28884,75,1973,413,15923,520,17028,487,32951,California
Kings,2021-04-01,942,48826,510,17537,340,29224,92,2065,356,15792,579,17607,448,33399,California
Kings,2021-04-02,1147,49973,463,18000,554,29778,130,2195,395,15570,746,18353,524,33923,California
Kings,2021-04-03,491,50464,344,18344,138,29916,9,2204,171,15437,314,18667,181,34104,California
Kings,2021-04-04,160,50624,86,18430,68,29984,6,2210,39,15362,120,18787,45,34149,California
Kings,2021-04-05,1074,51698,334,18764,490,30474,250,2460,245,15025,829,19616,492,34641,California
Kings,2021-04-06,1272,52970,503,19267,459,30933,310,2770,281,14626,988,20604,589,35230,California
Kings,2021-04-07,1408,54378,663,19930,553,31486,192,2962,345,14102,1060,21664,536,35766,California
Kings,2021-04-08,1657,56035,644,20574,761,32247,252,3214,387,13480,1261,22925,639,36405,California
Kings,2021-04-09,1261,57296,592,21166,483,32730,186,3400,234,12873,1024,23949,417,36822,California
Kings,2021-04-10,603,57899,333,21499,164,32894,106,3506,174,12726,426,24375,279,37101,California
Kings,2021-04-11,354,58253,73,21572,274,33168,7,3513,193,12768,158,24533,200,37301,California
Kings,2021-04-12,710,58963,314,21886,191,33359,205,3718,194,12652,514,25047,398,37699,California
Kings,2021-04-13,924,59887,522,22408,402,33761,0,3718,285,12304,637,25684,289,37988,California
Kings,2021-04-14,1062,60949,584,22992,478,34239,0,3718,379,12002,682,26366,380,38368,California
Kings,2021-04-15,1060,62009,515,23507,544,34783,1,3719,437,11821,619,26985,438,38806,California
Kings,2021-04-16,803,62812,367,23874,436,35219,0,3719,260,11541,541,27526,261,39067,California
Kings,2021-04-17,472,63284,257,24131,215,35434,0,3719,192,11454,279,27805,192,39259,California
Kings,2021-04-18,576,63860,251,24382,325,35759,0,3719,40,10958,536,28341,40,39299,California
Kings,2021-04-19,629,64489,390,24772,239,35998,0,3719,291,10914,335,28676,291,39590,California
Kings,2021-04-20,771,65260,464,25236,307,36305,0,3719,241,10626,529,29205,241,39831,California
Kings,2021-04-21,703,65963,351,25587,352,36657,0,3719,242,10416,453,29658,243,40074,California
Kings,2021-04-22,578,66541,292,25879,286,36943,0,3719,213,10269,361,30019,214,40288,California
Kings,2021-04-23,703,67244,306,26185,397,37340,0,3719,338,10246,361,30380,338,40626,California
Kings,2021-04-24,248,67492,180,26365,67,37407,1,3720,119,10238,128,30508,120,40746,California
Kings,2021-04-25,206,67698,188,26553,18,37425,0,3720,169,10370,37,30545,169,40915,California
Kings,2021-04-26,322,68020,177,26730,142,37567,3,3723,197,10445,125,30670,200,41115,California
Kings,2021-04-27,440,68460,200,26930,221,37788,19,3742,189,10405,248,30918,208,41323,California
Kings,2021-04-28,533,68993,270,27200,243,38031,20,3762,278,10448,255,31173,298,41621,California
Kings,2021-04-29,315,69308,130,27330,172,38203,13,3775,145,10439,167,31340,158,41779,California
Kings,2021-04-30,385,69693,170,27500,198,38401,17,3792,159,10393,222,31562,176,41955,California
Kings,2021-05-01,233,69926,169,27669,54,38455,10,3802,75,10321,157,31719,85,42040,California
Kings,2021-05-02,170,70096,148,27817,22,38477,0,3802,127,10405,43,31762,127,42167,California
Kings,2021-05-03,481,70577,254,28071,213,38690,14,3816,124,10187,356,32118,138,42305,California
Kings,2021-05-04,537,71114,281,28352,236,38926,20,3836,166,10003,370,32488,186,42491,California
Kings,2021-05-05,569,71683,301,28653,248,39174,20,3856,147,9750,420,32908,167,42658,California
Kings,2021-05-06,586,72269,301,28954,261,39435,24,3880,136,9462,448,33356,160,42818,California
Kings,2021-05-07,372,72641,216,29170,140,39575,16,3896,149,9406,221,33577,165,42983,California
Kings,2021-05-08,247,72888,181,29351,54,39629,12,3908,84,9339,162,33739,95,43078,California
Kings,2021-05-09,190,73078,61,29412,129,39758,0,3908,40,9229,150,33889,40,43118,California
Kings,2021-05-10,345,73423,266,29678,68,39826,11,3919,114,9126,228,34117,125,43243,California
Kings,2021-05-11,392,73815,242,29920,120,39946,30,3949,119,9004,272,34389,150,43393,California
Kings,2021-05-12,408,74223,170,30090,224,40170,14,3963,167,8946,239,34628,181,43574,California
Kings,2021-05-13,425,74648,170,30260,247,40417,8,3971,173,8876,251,34879,181,43755,California
Kings,2021-05-14,469,75117,316,30576,120,40537,33,4004,242,8925,225,35104,274,44029,California
Kings,2021-05-15,357,75474,253,30829,85,40622,19,4023,197,8981,160,35264,216,44245,California
Kings,2021-05-16,253,75727,226,31055,26,40648,1,4024,75,8879,178,35442,76,44321,California
Kings,2021-05-17,407,76134,324,31379,66,40714,17,4041,213,8915,194,35636,230,44551,California
Kings,2021-05-18,408,76542,287,31666,108,40822,13,4054,231,8983,177,35813,245,44796,California
Kings,2021-05-19,590,77132,287,31953,278,41100,25,4079,230,8881,357,36170,255,45051,California
Kings,2021-05-20,459,77591,244,32197,188,41288,27,4106,266,8982,193,36363,294,45345,California
Kings,2021-05-21,526,78117,264,32461,250,41538,12,4118,263,8998,259,36622,275,45620,California
Kings,2021-05-22,306,78423,247,32708,47,41585,12,4130,218,9142,86,36708,230,45850,California
Kings,2021-05-23,234,78657,227,32935,7,41592,0,4130,108,9124,126,36834,108,45958,California
Kings,2021-05-24,272,78929,185,33120,72,41664,15,4145,132,9131,140,36974,147,46105,California
Kings,2021-05-25,420,79349,278,33398,108,41772,34,4179,243,9232,175,37149,276,46381,California
Kings,2021-05-26,308,79657,127,33525,164,41936,17,4196,121,9184,186,37335,138,46519,California
Kings,2021-05-27,337,79994,189,33714,130,42066,18,4214,185,9238,149,37484,203,46722,California
Kings,2021-05-28,298,80292,149,33863,130,42196,19,4233,138,9240,155,37639,157,46879,California
Kings,2021-05-29,174,80466,100,33963,63,42259,11,4244,86,9250,87,37726,97,46976,California
Kings,2021-05-30,131,80597,114,34077,15,42274,2,4246,70,9261,61,37787,72,47048,California
Kings,2021-05-31,41,80638,21,34098,17,42291,3,4249,15,9253,26,37813,18,47066,California
Kings,2021-06-01,321,80959,190,34288,115,42406,16,4265,123,9197,194,38007,138,47204,California
Kings,2021-06-02,276,81235,124,34412,145,42551,7,4272,82,9094,192,38199,89,47293,California
Kings,2021-06-03,226,81461,127,34539,88,42639,11,4283,71,9029,147,38346,82,47375,California
Kings,2021-06-04,434,81895,291,34830,129,42768,14,4297,153,8919,277,38623,167,47542,California
Kings,2021-06-05,256,82151,223,35053,26,42794,7,4304,61,8805,182,38805,68,47610,California
Kings,2021-06-06,162,82313,154,35207,3,42797,5,4309,81,8814,77,38882,86,47696,California
Kings,2021-06-07,295,82608,226,35433,55,42852,14,4323,97,8727,197,39079,110,47806,California
Kings,2021-06-08,316,82924,241,35674,55,42907,20,4343,77,8587,237,39316,97,47903,California
Kings,2021-06-09,409,83333,277,35951,123,43030,9,4352,120,8430,286,39602,129,48032,California
Kings,2021-06-10,345,83678,226,36177,106,43136,13,4365,81,8260,264,39866,94,48126,California
Kings,2021-06-11,378,84056,286,36463,89,43225,3,4368,147,8184,226,40092,150,48276,California
Kings,2021-06-12,269,84325,221,36684,44,43269,4,4372,69,8073,184,40276,73,48349,California
Kings,2021-06-13,129,84454,120,36804,8,43277,1,4373,34,8014,94,40370,35,48384,California
Kings,2021-06-14,245,84699,176,36980,47,43324,22,4395,98,7987,147,40517,120,48504,California
Kings,2021-06-15,261,84960,187,37167,64,43388,10,4405,90,7917,170,40687,100,48604,California
Kings,2021-06-16,259,85219,134,37301,117,43505,8,4413,94,7861,159,40846,103,48707,California
Kings,2021-06-17,210,85429,113,37414,87,43592,10,4423,79,7819,131,40977,89,48796,California
Kings,2021-06-18,258,85687,179,37593,70,43662,9,4432,113,7796,145,41122,122,48918,California
Kings,2021-06-19,102,85789,69,37662,28,43690,5,4437,41,7781,61,41183,46,48964,California
Kings,2021-06-20,84,85873,69,37731,9,43699,6,4443,28,7759,56,41239,34,48998,California
Kings,2021-06-21,182,86055,98,37829,53,43752,31,4474,97,7803,84,41323,128,49126,California
Kings,2021-06-22,202,86257,129,37958,63,43815,10,4484,81,7773,121,41444,91,49217,California
Kings,2021-06-23,196,86453,93,38051,88,43903,15,4499,87,7767,108,41552,102,49319,California
Kings,2021-06-24,148,86601,71,38122,72,43975,5,4504,58,7741,89,41641,63,49382,California
Kings,2021-06-25,320,86921,227,38349,84,44059,9,4513,159,7749,160,41801,168,49550,California
Kings,2021-06-26,123,87044,81,38430,38,44097,4,4517,52,7734,71,41872,56,49606,California
Kings,2021-06-27,120,87164,113,38543,6,44103,1,4518,40,7698,77,41949,41,49647,California
Kings,2021-06-28,200,87364,146,38689,37,44140,17,4535,87,7690,112,42061,104,49751,California
Kings,2021-06-29,179,87543,133,38822,36,44176,10,4545,88,7699,89,42150,98,49849,California
Kings,2021-06-30,201,87744,122,38944,71,44247,8,4553,92,7690,109,42259,100,49949,California
Kings,2021-07-01,138,87882,91,39035,40,44287,7,4560,68,7697,68,42327,75,50024,California
Kings,2021-07-02,190,88072,122,39157,59,44346,9,4569,97,7710,93,42420,106,50130,California
Kings,2021-07-03,105,88177,84,39241,20,44366,1,4570,54,7714,51,42471,55,50185,California
Kings,2021-07-04,4,88181,0,39241,4,44370,0,4570,3,7716,1,42472,3,50188,California
Kings,2021-07-05,96,88277,57,39298,27,44397,12,4582,48,7728,48,42520,60,50248,California
Kings,2021-07-06,221,88498,161,39459,48,44445,12,4594,85,7689,136,42656,97,50345,California
Kings,2021-07-07,241,88739,139,39598,91,44536,11,4605,125,7709,116,42772,136,50481,California
Kings,2021-07-08,207,88946,128,39726,71,44607,8,4613,86,7683,120,42892,94,50575,California
Kings,2021-07-09,223,89169,133,39859,87,44694,3,4616,115,7696,105,42997,118,50693,California
Kings,2021-07-10,101,89270,62,39921,34,44728,5,4621,57,7714,44,43041,62,50755,California
Kings,2021-07-11,88,89358,76,39997,8,44736,4,4625,45,7720,43,43084,49,50804,California
Kings,2021-07-12,218,89576,147,40144,61,44797,10,4635,89,7691,128,43212,99,50903,California
Kings,2021-07-13,136,89712,100,40244,35,44832,1,4636,70,7696,66,43278,71,50974,California
Kings,2021-07-14,173,89885,98,40342,68,44900,7,4643,92,7714,81,43359,99,51073,California
Kings,2021-07-15,143,90028,82,40424,58,44958,3,4646,80,7734,63,43422,83,51156,California
Kings,2021-07-16,199,90227,136,40560,57,45015,6,4652,77,7697,120,43542,83,51239,California
Kings,2021-07-17,89,90316,66,40626,19,45034,4,4656,45,7702,44,43586,49,51288,California
Kings,2021-07-18,93,90409,86,40712,5,45039,2,4658,48,7708,44,43630,50,51338,California
Kings,2021-07-19,173,90582,116,40828,38,45077,19,4677,72,7699,100,43730,91,51429,California
Kings,2021-07-20,216,90798,149,40977,64,45141,3,4680,128,7742,88,43818,131,51560,California
Kings,2021-07-21,285,91083,186,41163,82,45223,17,4697,182,7838,103,43921,199,51759,California
Kings,2021-07-22,300,91383,197,41360,86,45309,17,4714,174,7905,123,44044,190,51949,California
Kings,2021-07-23,239,91622,140,41500,96,45405,3,4717,156,7984,80,44124,159,52108,California
Kings,2021-07-24,108,91730,81,41581,21,45426,6,4723,61,8006,45,44169,67,52175,California
Kings,2021-07-25,95,91825,77,41658,18,45444,0,4723,77,8065,18,44187,77,52252,California
Kings,2021-07-26,189,92014,115,41773,72,45516,2,4725,142,8163,46,44233,144,52396,California
Kings,2021-07-27,206,92220,138,41911,58,45574,10,4735,125,8217,81,44314,135,52531,California
Kings,2021-07-28,302,92522,178,42089,112,45686,12,4747,190,8308,111,44425,202,52733,California
Kings,2021-07-29,263,92785,154,42243,88,45774,21,4768,168,8403,94,44519,189,52922,California
Kings,2021-07-30,288,93073,169,42412,114,45888,5,4773,208,8540,76,44595,213,53135,California
Kings,2021-07-31,168,93241,124,42536,41,45929,3,4776,126,8627,42,44637,129,53264,California
Kings,2021-08-01,156,93397,134,42670,22,45951,0,4776,107,8687,47,44684,107,53371,California
Kings,2021-08-02,292,93689,193,42863,89,46040,10,4786,210,8826,81,44765,220,53591,California
Kings,2021-08-03,296,93985,221,43084,65,46105,10,4796,212,8964,83,44848,221,53812,California
Kings,2021-08-04,319,94304,196,43280,109,46214,14,4810,204,9066,116,44964,218,54030,California
Kings,2021-08-05,309,94613,205,43485,93,46307,11,4821,209,9184,103,45067,221,54251,California
Kings,2021-08-06,307,94920,194,43679,103,46410,10,4831,216,9318,92,45159,226,54477,California
Kings,2021-08-07,190,95110,141,43820,43,46453,6,4837,130,9394,60,45219,136,54613,California
Kings,2021-08-08,148,95258,115,43935,30,46483,3,4840,85,9421,61,45280,88,54701,California
Kings,2021-08-09,347,95605,257,44192,77,46560,13,4853,230,9549,115,45395,243,54944,California
Kings,2021-08-10,256,95861,162,44354,84,46644,10,4863,150,9606,103,45498,160,55104,California
Kings,2021-08-11,376,96237,248,44602,97,46741,31,4894,222,9706,153,45651,253,55357,California
Kings,2021-08-12,248,96485,128,44730,105,46846,15,4909,157,9789,88,45739,171,55528,California
Kings,2021-08-13,300,96785,181,44911,108,46954,11,4920,199,9903,96,45835,210,55738,California
Kings,2021-08-14,192,96977,145,45056,40,46994,7,4927,99,9918,90,45925,105,55843,California
Kings,2021-08-15,190,97167,148,45204,32,47026,10,4937,113,9966,75,46000,123,55966,California
Kings,2021-08-16,299,97466,168,45372,114,47140,17,4954,180,10048,115,46115,197,56163,California
Kings,2021-08-17,271,97737,173,45545,87,47227,11,4965,165,10128,96,46211,176,56339,California
Kings,2021-08-18,326,98063,199,45744,115,47342,12,4977,170,10162,147,46358,181,56520,California
Kings,2021-08-19,365,98428,216,45960,140,47482,9,4986,197,10206,162,46520,206,56726,California
Kings,2021-08-20,419,98847,235,46195,174,47656,10,4996,236,10283,170,46690,247,56973,California
Kings,2021-08-21,192,99039,125,46320,59,47715,8,5004,99,10305,85,46775,107,57080,California
Kings,2021-08-22,211,99250,187,46507,24,47739,0,5004,120,10338,87,46862,120,57200,California
Kings,2021-08-23,417,99667,306,46813,100,47839,11,5015,223,10387,185,47047,234,57434,California
Kings,2021-08-24,332,99999,249,47062,77,47916,6,5021,165,10402,156,47203,171,57605,California
Kings,2021-08-25,548,100547,395,47457,136,48052,17,5038,282,10461,240,47443,299,57904,California
Kings,2021-08-26,389,100936,262,47719,121,48173,6,5044,208,10522,153,47596,214,58118,California
Kings,2021-08-27,468,101404,343,48062,117,48290,8,5052,235,10546,219,47815,243,58361,California
Kings,2021-08-28,239,101643,188,48250,48,48338,3,5055,99,10513,135,47950,102,58463,California
Kings,2021-08-29,188,101831,139,48389,41,48379,8,5063,100,10541,80,48030,108,58571,California
Kings,2021-08-30,259,102090,181,48570,74,48453,4,5067,103,10516,132,48162,107,58678,California
Lake,2020-12-17,4,4,4,4,0,0,0,0,4,4,0,0,4,4,California
Lake,2020-12-18,50,54,50,54,0,0,0,0,50,54,0,0,50,54,California
Lake,2020-12-19,3,57,3,57,0,0,0,0,3,57,0,0,3,57,California
Lake,2020-12-20,6,63,6,63,0,0,0,0,6,63,0,0,6,63,California
Lake,2020-12-21,89,152,89,152,0,0,0,0,89,152,0,0,89,152,California
Lake,2020-12-22,64,216,61,213,3,3,0,0,64,216,0,0,64,216,California
Lake,2020-12-23,127,343,118,331,9,12,0,0,127,343,0,0,127,343,California
Lake,2020-12-24,2,345,0,331,2,14,0,0,2,345,0,0,2,345,California
Lake,2020-12-26,2,347,2,333,0,14,0,0,2,347,0,0,2,347,California
Lake,2020-12-27,2,349,2,335,0,14,0,0,2,349,0,0,2,349,California
Lake,2020-12-28,52,401,43,378,9,23,0,0,52,401,0,0,52,401,California
Lake,2020-12-29,53,454,48,426,5,28,0,0,53,454,0,0,53,454,California
Lake,2020-12-30,135,589,127,553,8,36,0,0,135,589,0,0,135,589,California
Lake,2020-12-31,66,655,64,617,2,38,0,0,66,655,0,0,66,655,California
Lake,2021-01-01,12,667,5,622,7,45,0,0,12,667,0,0,12,667,California
Lake,2021-01-02,2,669,1,623,1,46,0,0,2,669,0,0,2,669,California
Lake,2021-01-04,93,762,22,645,71,117,0,0,93,762,0,0,93,762,California
Lake,2021-01-05,121,883,59,704,62,179,0,0,119,879,2,2,119,881,California
Lake,2021-01-06,103,986,64,768,39,218,0,0,101,978,2,4,101,982,California
Lake,2021-01-07,110,1096,85,853,25,243,0,0,101,1070,9,13,101,1083,California
Lake,2021-01-08,164,1260,135,988,29,272,0,0,113,1132,51,64,113,1196,California
Lake,2021-01-09,63,1323,61,1049,2,274,0,0,59,1187,4,68,59,1255,California
Lake,2021-01-10,3,1326,3,1052,0,274,0,0,0,1184,3,71,0,1255,California
Lake,2021-01-11,189,1515,149,1201,40,314,0,0,111,1217,78,149,111,1366,California
Lake,2021-01-12,85,1600,52,1253,33,347,0,0,59,1250,26,175,59,1425,California
Lake,2021-01-13,179,1779,121,1374,58,405,0,0,114,1299,65,240,114,1539,California
Lake,2021-01-14,152,1931,50,1424,102,507,0,0,129,1405,23,263,129,1668,California
Lake,2021-01-15,220,2151,95,1519,125,632,0,0,191,1567,29,292,191,1859,California
Lake,2021-01-16,136,2287,84,1603,52,684,0,0,134,1699,2,294,134,1993,California
Lake,2021-01-17,13,2300,7,1610,6,690,0,0,7,1700,6,300,7,2000,California
Lake,2021-01-18,245,2545,229,1839,16,706,0,0,122,1699,123,423,122,2122,California
Lake,2021-01-19,319,2864,124,1963,195,901,0,0,270,1921,49,472,271,2393,California
Lake,2021-01-20,426,3290,83,2046,343,1244,0,0,361,2218,64,536,361,2754,California
Lake,2021-01-21,439,3729,46,2092,393,1637,0,0,403,2585,36,572,403,3157,California
Lake,2021-01-22,321,4050,49,2141,272,1909,0,0,283,2830,38,610,283,3440,California
Lake,2021-01-23,124,4174,6,2147,118,2027,0,0,123,2952,1,611,123,3563,California
Lake,2021-01-24,5,4179,2,2149,3,2030,0,0,5,2957,0,611,5,3568,California
Lake,2021-01-25,256,4435,94,2243,162,2192,0,0,173,3047,83,694,173,3741,California
Lake,2021-01-26,424,4859,32,2275,392,2584,0,0,400,3423,24,718,400,4141,California
Lake,2021-01-27,368,5227,40,2315,328,2912,0,0,340,3736,28,746,341,4482,California
Lake,2021-01-28,498,5725,163,2478,335,3247,0,0,363,3966,133,879,363,4845,California
Lake,2021-01-29,658,6383,108,2586,550,3797,0,0,575,4458,83,962,575,5420,California
Lake,2021-01-30,555,6938,39,2625,516,4313,0,0,549,5001,6,968,549,5969,California
Lake,2021-01-31,13,6951,8,2633,5,4318,0,0,11,5010,2,970,11,5980,California
Lake,2021-02-01,175,7126,16,2649,159,4477,0,0,160,5155,15,985,160,6140,California
Lake,2021-02-02,565,7691,154,2803,411,4888,0,0,397,5384,168,1153,397,6537,California
Lake,2021-02-03,449,8140,33,2836,416,5304,0,0,339,5613,110,1263,339,6876,California
Lake,2021-02-04,124,8264,72,2908,52,5356,0,0,71,5631,53,1316,71,6947,California
Lake,2021-02-05,384,8648,72,2980,312,5668,0,0,289,5827,93,1409,289,7236,California
Lake,2021-02-06,276,8924,39,3019,237,5905,0,0,263,6077,13,1422,263,7499,California
Lake,2021-02-07,3,8927,2,3021,1,5906,0,0,3,6080,0,1422,3,7502,California
Lake,2021-02-08,274,9201,204,3225,70,5976,0,0,154,6114,120,1542,154,7656,California
Lake,2021-02-09,347,9548,26,3251,321,6297,0,0,299,6366,47,1589,299,7955,California
Lake,2021-02-10,354,9902,51,3302,303,6600,0,0,271,6554,83,1672,271,8226,California
Lake,2021-02-11,180,10082,17,3319,163,6763,0,0,58,6490,122,1794,58,8284,California
Lake,2021-02-12,372,10454,28,3347,344,7107,0,0,285,6689,86,1880,285,8569,California
Lake,2021-02-13,254,10708,9,3356,245,7352,0,0,244,6923,10,1890,244,8813,California
Lake,2021-02-14,16,10724,4,3360,12,7364,0,0,7,6921,9,1899,7,8820,California
Lake,2021-02-15,165,10889,8,3368,157,7521,0,0,8,6773,156,2055,8,8828,California
Lake,2021-02-16,423,11312,20,3388,403,7924,0,0,175,6700,248,2303,175,9003,California
Lake,2021-02-17,356,11668,54,3442,302,8226,0,0,74,6493,281,2584,74,9077,California
Lake,2021-02-18,469,12137,74,3516,395,8621,0,0,118,6261,350,2934,118,9195,California
Lake,2021-02-19,432,12569,25,3541,407,9028,0,0,92,6014,339,3273,92,9287,California
Lake,2021-02-20,292,12861,56,3597,236,9264,0,0,250,6223,41,3314,250,9537,California
Lake,2021-02-21,7,12868,7,3604,0,9264,0,0,1,6218,6,3320,1,9538,California
Lake,2021-02-22,137,13005,16,3620,121,9385,0,0,39,6160,97,3417,39,9577,California
Lake,2021-02-23,227,13232,18,3638,209,9594,0,0,30,5994,196,3613,30,9607,California
Lake,2021-02-24,1027,14259,434,4072,593,10187,0,0,469,5905,558,4171,469,10076,California
Lake,2021-02-25,784,15043,502,4574,282,10469,0,0,506,6137,274,4445,506,10582,California
Lake,2021-02-26,1064,16107,320,4894,744,11213,0,0,362,5800,699,5144,362,10944,California
Lake,2021-02-27,412,16519,100,4994,312,11525,0,0,327,6043,84,5228,327,11271,California
Lake,2021-02-28,16,16535,8,5002,8,11533,0,0,11,6049,5,5233,11,11282,California
Lake,2021-03-01,620,17155,57,5059,563,12096,0,0,457,6343,163,5396,457,11739,California
Lake,2021-03-02,780,17935,18,5077,762,12858,0,0,291,6147,487,5883,291,12030,California
Lake,2021-03-03,378,18313,200,5277,178,13036,0,0,148,6066,229,6112,148,12178,California
Lake,2021-03-04,582,18895,508,5785,74,13110,0,0,565,6614,17,6129,565,12743,California
Lake,2021-03-05,1058,19953,53,5838,1005,14115,0,0,182,5924,872,7001,182,12925,California
Lake,2021-03-06,33,19986,9,5847,23,14138,1,1,20,5932,13,7014,21,12946,California
Lake,2021-03-07,9,19995,5,5852,3,14141,1,2,6,5936,3,7017,7,12953,California
Lake,2021-03-08,341,20336,268,6120,64,14205,9,11,301,6207,39,7056,310,13263,California
Lake,2021-03-09,932,21268,41,6161,873,15078,18,29,403,6104,525,7581,422,13685,California
Lake,2021-03-10,198,21466,54,6215,131,15209,13,42,131,6182,67,7648,145,13830,California
Lake,2021-03-11,592,22058,48,6263,68,15277,476,518,52,6167,540,8188,525,14355,California
Lake,2021-03-12,856,22914,202,6465,628,15905,26,544,362,6063,492,8680,388,14743,California
Lake,2021-03-13,276,23190,20,6485,20,15925,236,780,17,6056,257,8937,250,14993,California
Lake,2021-03-14,11,23201,2,6487,9,15934,0,780,6,6057,5,8942,6,14999,California
Lake,2021-03-15,633,23834,10,6497,606,16540,17,797,474,6389,159,9101,491,15490,California
Lake,2021-03-16,1121,24955,839,7336,265,16805,17,814,378,6044,739,9840,394,15884,California
Lake,2021-03-17,251,25206,125,7461,103,16908,23,837,87,5990,164,10004,110,15994,California
Lake,2021-03-18,750,25956,374,7835,340,17248,36,873,353,5989,389,10393,388,16382,California
Lake,2021-03-19,583,26539,311,8146,251,17499,21,894,480,6388,102,10495,501,16883,California
Lake,2021-03-20,249,26788,8,8154,239,17738,2,896,32,6207,215,10710,34,16917,California
Lake,2021-03-21,15,26803,9,8163,5,17743,1,897,11,6215,4,10714,12,16929,California
Lake,2021-03-22,335,27138,257,8420,64,17807,14,911,248,6390,87,10801,262,17191,California
Lake,2021-03-23,433,27571,19,8439,400,18207,14,925,366,6704,66,10867,380,17571,California
Lake,2021-03-24,421,27992,58,8497,355,18562,8,933,325,6944,94,10961,334,17905,California
Lake,2021-03-25,684,28676,494,8991,184,18746,6,939,169,6604,514,11475,174,18079,California
Lake,2021-03-26,69,28745,33,9024,33,18779,3,942,31,6601,37,11512,34,18113,California
Lake,2021-03-27,308,29053,6,9030,299,19078,3,945,15,6328,291,11803,18,18131,California
Lake,2021-03-28,13,29066,6,9036,7,19085,0,945,5,6325,8,11811,5,18136,California
Lake,2021-03-29,1013,30079,299,9335,712,19797,2,947,192,5700,819,12630,194,18330,California
Lake,2021-03-30,468,30547,316,9651,149,19946,3,950,369,5974,98,12728,372,18702,California
Lake,2021-03-31,625,31172,60,9711,565,20511,0,950,439,6237,176,12904,439,19141,California
Lake,2021-04-01,457,31629,241,9952,204,20715,12,962,184,6165,268,13172,196,19337,California
Lake,2021-04-02,224,31853,39,9991,157,20872,28,990,95,6159,129,13301,123,19460,California
Lake,2021-04-03,31,31884,4,9995,24,20896,3,993,12,6155,19,13320,15,19475,California
Lake,2021-04-04,20,31904,12,10007,7,20903,1,994,14,6164,6,13326,15,19490,California
Lake,2021-04-05,650,32554,72,10079,558,21461,20,1014,408,6352,239,13565,427,19917,California
Lake,2021-04-06,481,33035,20,10099,436,21897,25,1039,305,6508,174,13739,330,20247,California
Lake,2021-04-07,531,33566,58,10157,420,22317,53,1092,357,6746,172,13911,410,20657,California
Lake,2021-04-08,613,34179,498,10655,49,22366,66,1158,108,6418,502,14413,174,20831,California
Lake,2021-04-09,285,34464,47,10702,171,22537,67,1225,53,6309,228,14641,119,20950,California
Lake,2021-04-10,250,34714,12,10714,13,22550,225,1450,9,6302,241,14882,234,21184,California
Lake,2021-04-11,21,34735,16,10730,3,22553,2,1452,7,6297,14,14896,9,21193,California
Lake,2021-04-12,1079,35814,234,10964,811,23364,34,1486,243,5738,836,15732,277,21470,California
Lake,2021-04-13,179,35993,106,11070,73,23437,0,1486,52,5663,127,15859,52,21522,California
Lake,2021-04-14,617,36610,33,11103,584,24021,0,1486,554,6154,63,15922,554,22076,California
Lake,2021-04-15,645,37255,191,11294,454,24475,0,1486,328,6166,316,16238,328,22404,California
Lake,2021-04-16,269,37524,27,11321,242,24717,0,1486,72,6042,196,16434,72,22476,California
Lake,2021-04-17,41,37565,9,11330,32,24749,0,1486,29,6059,12,16446,29,22505,California
Lake,2021-04-18,7,37572,4,11334,3,24752,0,1486,0,6052,7,16453,0,22505,California
Lake,2021-04-19,301,37873,40,11374,261,25013,0,1486,251,6253,50,16503,251,22756,California
Lake,2021-04-20,698,38571,282,11656,416,25429,0,1486,91,5739,606,17109,92,22848,California
Lake,2021-04-21,534,39105,63,11719,471,25900,0,1486,197,5599,337,17446,197,23045,California
Lake,2021-04-22,465,39570,48,11767,417,26317,0,1486,319,5772,146,17592,319,23364,California
Lake,2021-04-23,124,39694,62,11829,62,26379,0,1486,73,5796,49,17641,73,23437,California
Lake,2021-04-24,52,39746,8,11837,44,26423,0,1486,38,5820,14,17655,38,23475,California
Lake,2021-04-25,37,39783,19,11856,18,26441,0,1486,25,5833,12,17667,25,23500,California
Lake,2021-04-26,296,40079,83,11939,212,26653,1,1487,92,5722,204,17871,93,23593,California
Lake,2021-04-27,250,40329,25,11964,207,26860,18,1505,86,5662,164,18035,104,23697,California
Lake,2021-04-28,523,40852,51,12015,457,27317,15,1520,96,5347,425,18460,110,23807,California
Lake,2021-04-29,218,41070,86,12101,116,27433,16,1536,115,5376,101,18561,130,23937,California
Lake,2021-04-30,292,41362,48,12149,213,27646,31,1567,144,5404,147,18708,175,24112,California
Lake,2021-05-01,53,41415,29,12178,22,27668,2,1569,34,5422,18,18726,36,24148,California
Lake,2021-05-02,18,41433,9,12187,8,27676,1,1570,10,5425,8,18734,11,24159,California
Lake,2021-05-03,420,41853,29,12216,355,28031,36,1606,66,5174,353,19087,102,24261,California
Lake,2021-05-04,409,42262,219,12435,140,28171,50,1656,126,5069,281,19368,176,24437,California
Lake,2021-05-05,631,42893,40,12475,580,28751,11,1667,82,4615,546,19914,92,24529,California
Lake,2021-05-06,142,43035,19,12494,94,28845,29,1696,72,4645,70,19984,100,24629,California
Lake,2021-05-07,162,43197,25,12519,116,28961,21,1717,104,4714,56,20040,125,24754,California
Lake,2021-05-08,41,43238,4,12523,37,28998,0,1717,36,4745,5,20045,36,24790,California
Lake,2021-05-09,17,43255,2,12525,10,29008,5,1722,10,4753,7,20052,15,24805,California
Lake,2021-05-10,247,43502,11,12536,209,29217,27,1749,60,4654,186,20238,87,24892,California
Lake,2021-05-11,199,43701,25,12561,157,29374,17,1766,120,4713,79,20317,138,25030,California
Lake,2021-05-12,544,44245,29,12590,495,29869,20,1786,52,4292,492,20809,71,25101,California
Lake,2021-05-13,319,44564,71,12661,234,30103,14,1800,74,4138,243,21052,89,25190,California
Lake,2021-05-14,271,44835,83,12744,170,30273,18,1818,164,4215,104,21156,181,25371,California
Lake,2021-05-15,45,44880,19,12763,23,30296,3,1821,29,4231,16,21172,32,25403,California
Lake,2021-05-16,31,44911,19,12782,11,30307,1,1822,18,4237,13,21185,19,25422,California
Lake,2021-05-17,318,45229,42,12824,261,30568,15,1837,83,4103,232,21417,98,25520,California
Lake,2021-05-18,297,45526,65,12889,213,30781,19,1856,170,4166,126,21543,189,25709,California
Lake,2021-05-19,315,45841,58,12947,242,31023,15,1871,90,4047,224,21767,105,25814,California
Lake,2021-05-20,242,46083,60,13007,171,31194,11,1882,96,4008,146,21913,107,25921,California
Lake,2021-05-21,277,46360,52,13059,202,31396,23,1905,114,3984,161,22074,137,26058,California
Lake,2021-05-22,95,46455,53,13112,39,31435,3,1908,46,3984,49,22123,49,26107,California
Lake,2021-05-23,58,46513,28,13140,29,31464,1,1909,29,3985,29,22152,30,26137,California
Lake,2021-05-24,160,46673,37,13177,108,31572,15,1924,72,3984,88,22240,87,26224,California
Lake,2021-05-25,205,46878,58,13235,135,31707,12,1936,74,3940,130,22370,86,26310,California
Lake,2021-05-26,152,47030,45,13280,96,31803,11,1947,56,3913,94,22464,67,26377,California
Lake,2021-05-27,179,47209,49,13329,116,31919,14,1961,62,3873,116,22580,76,26453,California
Lake,2021-05-28,224,47433,22,13351,164,32083,38,1999,49,3786,173,22753,86,26539,California
Lake,2021-05-29,37,47470,10,13361,21,32104,6,2005,14,3783,23,22776,20,26559,California
Lake,2021-05-30,21,47491,6,13367,13,32117,2,2007,11,3786,10,22786,13,26572,California
Lake,2021-05-31,64,47555,23,13390,39,32156,2,2009,54,3832,10,22796,56,26628,California
Lake,2021-06-01,197,47752,37,13427,151,32307,9,2018,68,3781,128,22924,77,26705,California
Lake,2021-06-02,132,47884,47,13474,73,32380,12,2030,54,3769,78,23002,66,26771,California
Lake,2021-06-03,184,48068,55,13529,110,32490,19,2049,80,3764,104,23106,99,26870,California
Lake,2021-06-04,183,48251,54,13583,113,32603,16,2065,46,3691,135,23241,62,26932,California
Lake,2021-06-05,94,48345,56,13639,30,32633,8,2073,55,3715,39,23280,63,26995,California
Lake,2021-06-06,69,48414,39,13678,30,32663,0,2073,24,3694,45,23325,24,27019,California
Lake,2021-06-07,90,48504,29,13707,53,32716,8,2081,32,3677,57,23382,40,27059,California
Lake,2021-06-08,182,48686,69,13776,101,32817,12,2093,68,3644,113,23495,80,27139,California
Lake,2021-06-09,173,48859,42,13818,127,32944,4,2097,38,3553,133,23628,42,27181,California
Lake,2021-06-10,127,48986,62,13880,52,32996,13,2110,50,3539,77,23705,63,27244,California
Lake,2021-06-11,210,49196,67,13947,119,33115,24,2134,48,3451,160,23865,72,27316,California
Lake,2021-06-12,67,49263,40,13987,21,33136,6,2140,34,3458,33,23898,40,27356,California
Lake,2021-06-13,28,49291,14,14001,14,33150,0,2140,12,3454,16,23914,12,27368,California
Lake,2021-06-14,181,49472,88,14089,80,33230,13,2153,51,3389,129,24043,64,27432,California
Lake,2021-06-15,246,49718,65,14154,164,33394,17,2170,79,3318,167,24210,96,27528,California
Lake,2021-06-16,164,49882,58,14212,91,33485,15,2185,53,3276,110,24320,68,27596,California
Lake,2021-06-17,181,50063,86,14298,85,33570,10,2195,79,3264,101,24421,89,27685,California
Lake,2021-06-18,143,50206,39,14337,94,33664,10,2205,58,3247,85,24506,68,27753,California
Lake,2021-06-19,68,50274,26,14363,42,33706,0,2205,35,3249,33,24539,35,27788,California
Lake,2021-06-20,21,50295,7,14370,12,33718,2,2207,10,3250,11,24550,12,27800,California
Lake,2021-06-21,68,50363,17,14387,43,33761,8,2215,30,3250,38,24588,38,27838,California
Lake,2021-06-22,133,50496,50,14437,73,33834,10,2225,61,3250,71,24659,71,27909,California
Lake,2021-06-23,150,50646,69,14506,57,33891,24,2249,82,3288,68,24727,106,28015,California
Lake,2021-06-24,143,50789,95,14601,34,33925,14,2263,49,3258,93,24820,63,28078,California
Lake,2021-06-25,130,50919,56,14657,64,33989,10,2273,65,3269,64,24884,75,28153,California
Lake,2021-06-26,49,50968,37,14694,12,34001,0,2273,6,3232,43,24927,6,28159,California
Lake,2021-06-27,42,51010,30,14724,12,34013,0,2273,23,3236,19,24946,23,28182,California
Lake,2021-06-28,67,51077,22,14746,23,34036,22,2295,28,3248,38,24984,50,28232,California
Lake,2021-06-29,123,51200,48,14794,71,34107,4,2299,66,3261,57,25041,70,28302,California
Lake,2021-06-30,125,51325,62,14856,54,34161,9,2308,63,3272,61,25102,72,28374,California
Lake,2021-07-01,118,51443,53,14909,58,34219,7,2315,40,3245,74,25176,47,28421,California
Lake,2021-07-02,112,51555,35,14944,64,34283,13,2328,55,3257,55,25231,67,28488,California
Lake,2021-07-03,74,51629,44,14988,30,34313,0,2328,34,3253,38,25269,34,28522,California
Lake,2021-07-04,14,51643,5,14993,9,34322,0,2328,9,3257,5,25274,9,28531,California
Lake,2021-07-05,47,51690,19,15012,28,34350,0,2328,32,3274,15,25289,32,28563,California
Lake,2021-07-06,163,51853,53,15065,103,34453,7,2335,64,3250,95,25384,71,28634,California
Lake,2021-07-07,92,51945,51,15116,38,34491,3,2338,55,3271,37,25421,58,28692,California
Lake,2021-07-08,91,52036,33,15149,49,34540,9,2347,41,3271,50,25471,50,28742,California
Lake,2021-07-09,156,52192,85,15234,64,34604,7,2354,66,3255,89,25560,73,28815,California
Lake,2021-07-10,42,52234,16,15250,26,34630,0,2354,25,3263,17,25577,25,28840,California
Lake,2021-07-11,16,52250,3,15253,12,34642,1,2355,6,3260,10,25587,7,28847,California
Lake,2021-07-12,90,52340,45,15298,36,34678,9,2364,42,3264,47,25634,51,28898,California
Lake,2021-07-13,122,52462,52,15350,68,34746,2,2366,52,3248,70,25704,54,28952,California
Lake,2021-07-14,139,52601,82,15432,32,34778,25,2391,53,3241,85,25789,78,29030,California
Lake,2021-07-15,107,52708,60,15492,39,34817,8,2399,49,3242,56,25845,57,29087,California
Lake,2021-07-16,151,52859,63,15555,79,34896,9,2408,80,3260,71,25916,89,29176,California
Lake,2021-07-17,75,52934,27,15582,41,34937,7,2415,40,3271,35,25951,46,29222,California
Lake,2021-07-18,20,52954,9,15591,11,34948,0,2415,9,3269,11,25962,9,29231,California
Lake,2021-07-19,88,53042,36,15627,38,34986,14,2429,42,3279,46,26008,56,29287,California
Lake,2021-07-20,108,53150,49,15676,50,35036,9,2438,51,3282,57,26065,60,29347,California
Lake,2021-07-21,176,53326,114,15790,53,35089,9,2447,111,3338,64,26129,120,29467,California
Lake,2021-07-22,149,53475,70,15860,64,35153,15,2462,93,3391,55,26184,108,29575,California
Lake,2021-07-23,176,53651,85,15945,75,35228,16,2478,102,3435,74,26258,118,29693,California
Lake,2021-07-24,91,53742,47,15992,40,35268,4,2482,65,3479,25,26283,69,29762,California
Lake,2021-07-25,41,53783,22,16014,19,35287,0,2482,29,3497,11,26294,29,29791,California
Lake,2021-07-26,103,53886,33,16047,53,35340,17,2499,53,3518,49,26343,70,29861,California
Lake,2021-07-27,184,54070,65,16112,103,35443,16,2515,106,3562,78,26421,122,29983,California
Lake,2021-07-28,149,54219,87,16199,57,35500,5,2520,103,3624,46,26467,108,30091,California
Lake,2021-07-29,164,54383,78,16277,73,35573,13,2533,110,3693,54,26521,123,30214,California
Lake,2021-07-30,214,54597,74,16351,113,35686,27,2560,132,3770,82,26603,159,30373,California
Lake,2021-07-31,51,54648,27,16378,18,35704,6,2566,31,3787,20,26623,37,30410,California
Lake,2021-08-01,36,54684,19,16397,15,35719,2,2568,22,3798,13,26636,24,30434,California
Lake,2021-08-02,170,54854,92,16489,69,35788,9,2577,117,3871,53,26689,126,30560,California
Lake,2021-08-03,257,55111,137,16626,100,35888,20,2597,162,3958,95,26784,182,30742,California
Lake,2021-08-04,157,55268,81,16707,65,35953,11,2608,110,4033,46,26830,121,30863,California
Lake,2021-08-05,147,55415,76,16783,68,36021,3,2611,90,4070,56,26886,93,30956,California
Lake,2021-08-06,171,55586,83,16866,70,36091,18,2629,96,4110,74,26960,114,31070,California
Lake,2021-08-07,66,55652,32,16898,32,36123,2,2631,43,4132,23,26983,45,31115,California
Lake,2021-08-08,26,55678,8,16906,18,36141,0,2631,17,4140,9,26992,17,31132,California
Lake,2021-08-09,88,55766,44,16950,32,36173,12,2643,49,4162,39,27031,61,31193,California
Lake,2021-08-10,190,55956,90,17040,93,36266,7,2650,121,4221,69,27100,128,31321,California
Lake,2021-08-11,129,56085,71,17111,54,36320,4,2654,84,4264,45,27145,88,31409,California
Lake,2021-08-12,126,56211,64,17175,56,36376,6,2660,79,4303,46,27191,85,31494,California
Lake,2021-08-13,179,56390,96,17271,72,36448,11,2671,96,4328,82,27273,107,31601,California
Lake,2021-08-14,64,56454,33,17304,31,36479,0,2671,35,4335,28,27301,35,31636,California
Lake,2021-08-15,41,56495,19,17323,22,36501,0,2671,28,4350,13,27314,28,31664,California
Lake,2021-08-16,143,56638,73,17396,62,36563,8,2679,97,4413,42,27356,105,31769,California
Lake,2021-08-17,267,56905,135,17531,123,36686,9,2688,145,4452,115,27471,154,31923,California
Lake,2021-08-18,101,57006,52,17583,44,36730,5,2693,50,4464,43,27514,55,31978,California
Lake,2021-08-19,141,57147,84,17667,53,36783,4,2697,69,4474,63,27577,73,32051,California
Lake,2021-08-20,257,57404,118,17785,118,36901,21,2718,141,4537,99,27676,162,32213,California
Lake,2021-08-21,54,57458,21,17806,32,36933,1,2719,17,4521,34,27710,18,32231,California
Lake,2021-08-22,45,57503,18,17824,27,36960,0,2719,25,4528,18,27728,25,32256,California
Lake,2021-08-23,125,57628,58,17882,58,37018,9,2728,58,4537,58,27786,67,32323,California
Lake,2021-08-24,233,57861,126,18008,99,37117,8,2736,85,4496,134,27920,93,32416,California
Lake,2021-08-25,139,58000,87,18095,48,37165,4,2740,74,4520,53,27973,77,32493,California
Lake,2021-08-26,179,58179,79,18174,79,37244,21,2761,77,4525,93,28066,98,32591,California
Lake,2021-08-27,189,58368,90,18264,87,37331,12,2773,59,4486,110,28176,71,32662,California
Lake,2021-08-28,87,58455,61,18325,26,37357,0,2773,45,4494,37,28213,45,32707,California
Lake,2021-08-29,28,58483,18,18343,10,37367,0,2773,17,4501,10,28223,17,32724,California
Lake,2021-08-30,102,58585,45,18388,47,37414,10,2783,39,4493,57,28280,49,32773,California
Lassen,2020-12-16,3,3,3,3,0,0,0,0,3,3,0,0,3,3,California
Lassen,2020-12-17,1,4,1,4,0,0,0,0,1,4,0,0,1,4,California
Lassen,2020-12-18,1,5,1,5,0,0,0,0,1,5,0,0,1,5,California
Lassen,2020-12-19,7,12,7,12,0,0,0,0,7,12,0,0,7,12,California
Lassen,2020-12-20,2,14,2,14,0,0,0,0,2,14,0,0,2,14,California
Lassen,2020-12-21,10,24,10,24,0,0,0,0,10,24,0,0,10,24,California
Lassen,2020-12-22,18,42,18,42,0,0,0,0,18,42,0,0,18,42,California
Lassen,2020-12-23,5,47,5,47,0,0,0,0,5,47,0,0,5,47,California
Lassen,2020-12-24,3,50,3,50,0,0,0,0,3,50,0,0,3,50,California
Lassen,2020-12-28,2,52,1,51,1,1,0,0,2,52,0,0,2,52,California
Lassen,2020-12-29,34,86,34,85,0,1,0,0,34,86,0,0,34,86,California
Lassen,2020-12-30,26,112,25,110,1,2,0,0,26,112,0,0,26,112,California
Lassen,2020-12-31,49,161,41,151,8,10,0,0,49,161,0,0,49,161,California
Lassen,2021-01-02,1,162,0,151,1,11,0,0,1,162,0,0,1,162,California
Lassen,2021-01-04,14,176,2,153,12,23,0,0,14,176,0,0,14,176,California
Lassen,2021-01-05,188,364,50,203,138,161,0,0,188,364,0,0,188,364,California
Lassen,2021-01-06,88,452,35,238,53,214,0,0,84,445,4,4,85,449,California
Lassen,2021-01-07,37,489,1,239,36,250,0,0,36,480,1,5,36,485,California
Lassen,2021-01-08,50,539,2,241,48,298,0,0,50,530,0,5,50,535,California
Lassen,2021-01-09,12,551,6,247,6,304,0,0,12,542,0,5,12,547,California
Lassen,2021-01-11,25,576,5,252,20,324,0,0,25,567,0,5,25,572,California
Lassen,2021-01-12,45,621,25,277,20,344,0,0,29,580,16,21,29,601,California
Lassen,2021-01-13,155,776,14,291,141,485,0,0,143,711,12,33,143,744,California
Lassen,2021-01-14,151,927,10,301,141,626,0,0,146,852,5,38,146,890,California
Lassen,2021-01-15,18,945,1,302,17,643,0,0,18,870,0,38,18,908,California
Lassen,2021-01-16,34,979,33,335,1,644,0,0,34,904,0,38,34,942,California
Lassen,2021-01-17,1,980,0,335,1,645,0,0,1,905,0,38,1,943,California
Lassen,2021-01-18,4,984,2,337,2,647,0,0,3,907,1,39,3,946,California
Lassen,2021-01-19,181,1165,33,370,148,795,0,0,154,1034,27,66,154,1100,California
Lassen,2021-01-20,148,1313,86,456,62,857,0,0,77,1054,57,123,77,1177,California
Lassen,2021-01-21,130,1443,87,543,43,900,0,0,106,1142,18,141,106,1283,California
Lassen,2021-01-22,28,1471,15,558,13,913,0,0,18,1150,10,151,18,1301,California
Lassen,2021-01-24,1,1472,0,558,1,914,0,0,1,1151,0,151,1,1302,California
Lassen,2021-01-25,10,1482,1,559,9,923,0,0,9,1159,1,152,9,1311,California
Lassen,2021-01-26,105,1587,1,560,104,1027,0,0,104,1262,1,153,104,1415,California
Lassen,2021-01-27,53,1640,13,573,40,1067,0,0,38,1285,15,168,38,1453,California
Lassen,2021-01-28,72,1712,6,579,66,1133,0,0,71,1355,1,169,71,1524,California
Lassen,2021-01-29,12,1724,2,581,10,1143,0,0,10,1363,2,171,10,1534,California
Lassen,2021-02-01,47,1771,3,584,44,1187,0,0,23,1362,24,195,23,1557,California
Lassen,2021-02-02,167,1938,8,592,159,1346,0,0,36,1267,131,326,36,1593,California
Lassen,2021-02-03,91,2029,16,608,75,1421,0,0,45,1266,46,372,45,1638,California
Lassen,2021-02-04,101,2130,8,616,93,1514,0,0,53,1271,48,420,53,1691,California
Lassen,2021-02-05,48,2178,3,619,45,1559,0,0,12,1247,36,456,12,1703,California
Lassen,2021-02-06,68,2246,33,652,35,1594,0,0,35,1250,32,488,35,1738,California
Lassen,2021-02-07,1,2247,1,653,0,1594,0,0,1,1251,0,488,1,1739,California
Lassen,2021-02-08,36,2283,3,656,33,1627,0,0,11,1237,25,513,11,1750,California
Lassen,2021-02-09,117,2400,2,658,115,1742,0,0,43,1206,74,587,43,1793,California
Lassen,2021-02-10,147,2547,13,671,134,1876,0,0,43,1145,104,691,43,1836,California
Lassen,2021-02-11,151,2698,8,679,143,2019,0,0,56,1107,94,785,56,1892,California
Lassen,2021-02-12,27,2725,7,686,20,2039,0,0,11,1102,16,801,11,1903,California
Lassen,2021-02-13,8,2733,1,687,7,2046,0,0,6,1106,2,803,6,1909,California
Lassen,2021-02-14,13,2746,0,687,13,2059,0,0,12,1117,1,804,12,1921,California
Lassen,2021-02-15,19,2765,2,689,17,2076,0,0,16,1131,2,806,16,1937,California
Lassen,2021-02-16,182,2947,4,693,178,2254,0,0,20,991,160,966,20,1957,California
Lassen,2021-02-17,134,3081,70,763,64,2318,0,0,5,867,129,1095,5,1962,California
Lassen,2021-02-18,59,3140,9,772,50,2368,0,0,15,838,44,1139,15,1977,California
Lassen,2021-02-19,65,3205,49,821,16,2384,0,0,12,797,53,1192,12,1989,California
Lassen,2021-02-20,8,3213,1,822,7,2391,0,0,7,803,1,1193,7,1996,California
Lassen,2021-02-21,21,3234,0,822,21,2412,0,0,18,818,3,1196,18,2014,California
Lassen,2021-02-22,24,3258,13,835,11,2423,0,0,8,810,16,1212,8,2022,California
Lassen,2021-02-23,145,3403,8,843,137,2560,0,0,43,751,102,1314,43,2065,California
Lassen,2021-02-24,130,3533,10,853,120,2680,0,0,85,792,44,1358,85,2150,California
Lassen,2021-02-25,136,3669,13,866,123,2803,0,0,85,826,51,1409,85,2235,California
Lassen,2021-02-26,62,3731,11,877,51,2854,0,0,33,830,29,1438,33,2268,California
Lassen,2021-02-27,7,3738,7,884,0,2854,0,0,3,829,4,1442,3,2271,California
Lassen,2021-02-28,3,3741,1,885,2,2856,0,0,0,826,3,1445,0,2271,California
Lassen,2021-03-01,27,3768,1,886,26,2882,0,0,9,818,17,1462,9,2280,California
Lassen,2021-03-02,103,3871,5,891,98,2980,0,0,79,874,23,1485,79,2359,California
Lassen,2021-03-03,128,3999,6,897,122,3102,0,0,80,906,48,1533,80,2439,California
Lassen,2021-03-04,146,4145,16,913,130,3232,0,0,95,951,50,1583,95,2534,California
Lassen,2021-03-05,38,4183,1,914,13,3245,24,24,6,949,32,1615,30,2564,California
Lassen,2021-03-06,54,4237,2,916,30,3275,22,46,5,927,49,1664,27,2591,California
Lassen,2021-03-07,56,4293,0,916,1,3276,55,101,1,928,55,1719,56,2647,California
Lassen,2021-03-08,84,4377,2,918,4,3280,78,179,1,924,83,1802,79,2726,California
Lassen,2021-03-09,130,4507,4,922,108,3388,18,197,82,976,48,1850,100,2826,California
Lassen,2021-03-10,118,4625,4,926,113,3501,1,198,72,1004,45,1895,73,2899,California
Lassen,2021-03-11,162,4787,8,934,148,3649,6,204,95,1041,64,1959,101,3000,California
Lassen,2021-03-12,17,4804,8,942,6,3655,3,207,3,1033,14,1973,6,3006,California
Lassen,2021-03-13,48,4852,0,942,2,3657,46,253,1,1032,47,2020,46,3052,California
Lassen,2021-03-14,11,4863,0,942,10,3667,1,254,0,1022,11,2031,1,3053,California
Lassen,2021-03-15,29,4892,4,946,24,3691,1,255,11,1016,18,2049,12,3065,California
Lassen,2021-03-16,87,4979,2,948,81,3772,4,259,71,1075,16,2065,75,3140,California
Lassen,2021-03-17,1077,6056,8,956,1065,4837,4,263,1057,2116,20,2085,1061,4201,California
Lassen,2021-03-18,80,6136,5,961,74,4911,1,264,74,2185,6,2091,75,4276,California
Lassen,2021-03-19,11,6147,4,965,5,4916,2,266,3,2182,8,2099,5,4281,California
Lassen,2021-03-20,15,6162,3,968,10,4926,2,268,9,2187,6,2105,11,4292,California
Lassen,2021-03-21,34,6196,1,969,33,4959,0,268,14,2182,19,2124,14,4306,California
Lassen,2021-03-22,37,6233,1,970,36,4995,0,268,34,2213,3,2127,34,4340,California
Lassen,2021-03-23,109,6342,6,976,102,5097,1,269,56,2217,53,2180,57,4397,California
Lassen,2021-03-24,164,6506,5,981,158,5255,1,270,83,2222,79,2259,84,4481,California
Lassen,2021-03-25,140,6646,14,995,126,5381,0,270,61,2204,79,2338,61,4542,California
Lassen,2021-03-26,67,6713,5,1000,26,5407,36,306,14,2201,52,2390,49,4591,California
Lassen,2021-03-27,18,6731,2,1002,1,5408,15,321,2,2202,16,2406,17,4608,California
Lassen,2021-03-28,12,6743,1,1003,0,5408,11,332,1,2203,11,2417,12,4620,California
Lassen,2021-03-29,54,6797,0,1003,29,5437,25,357,21,2217,32,2449,46,4666,California
Lassen,2021-03-30,160,6957,3,1006,133,5570,24,381,49,2180,110,2559,73,4739,California
Lassen,2021-03-31,132,7089,6,1012,106,5676,20,401,52,2173,79,2638,72,4811,California
Lassen,2021-04-01,148,7237,6,1018,123,5799,19,420,40,2125,107,2745,59,4870,California
Lassen,2021-04-02,25,7262,3,1021,2,5801,20,440,1,2122,24,2769,21,4891,California
Lassen,2021-04-03,12,7274,0,1021,2,5803,10,450,0,2120,12,2781,10,4901,California
Lassen,2021-04-04,5,7279,1,1022,0,5803,4,454,1,2121,4,2785,5,4906,California
Lassen,2021-04-05,15,7294,0,1022,9,5812,6,460,8,2128,7,2792,14,4920,California
Lassen,2021-04-06,160,7454,4,1026,127,5939,29,489,47,2091,113,2905,76,4996,California
Lassen,2021-04-07,120,7574,5,1031,87,6026,28,517,33,2067,87,2992,63,5059,California
Lassen,2021-04-08,159,7733,10,1041,99,6125,50,567,27,2017,127,3119,77,5136,California
Lassen,2021-04-09,41,7774,5,1046,3,6128,33,600,6,2021,34,3153,38,5174,California
Lassen,2021-04-10,8,7782,0,1046,2,6130,6,606,0,2020,7,3160,6,5180,California
Lassen,2021-04-11,4,7786,0,1046,1,6131,3,609,1,2021,3,3163,4,5184,California
Lassen,2021-04-12,29,7815,4,1050,12,6143,13,622,4,2013,25,3188,17,5201,California
Lassen,2021-04-13,113,7928,3,1053,110,6253,0,622,23,1947,89,3277,23,5224,California
Lassen,2021-04-14,971,8899,4,1057,967,7220,0,622,47,1073,921,4198,47,5271,California
Lassen,2021-04-15,134,9033,10,1067,124,7344,0,622,13,965,121,4319,13,5284,California
Lassen,2021-04-16,10,9043,2,1069,8,7352,0,622,5,965,5,4324,5,5289,California
Lassen,2021-04-17,10,9053,3,1072,7,7359,0,622,3,961,7,4331,3,5292,California
Lassen,2021-04-18,5,9058,2,1074,3,7362,0,622,2,960,3,4334,2,5294,California
Lassen,2021-04-19,31,9089,0,1074,31,7393,0,622,16,961,15,4349,16,5310,California
Lassen,2021-04-20,122,9211,5,1079,117,7510,0,622,42,923,80,4429,42,5352,California
Lassen,2021-04-21,127,9338,3,1082,123,7633,1,623,31,861,94,4523,32,5384,California
Lassen,2021-04-22,93,9431,12,1094,81,7714,0,623,25,818,68,4591,25,5409,California
Lassen,2021-04-23,23,9454,0,1094,23,7737,0,623,20,835,3,4594,20,5429,California
Lassen,2021-04-24,9,9463,5,1099,4,7741,0,623,3,832,6,4600,3,5432,California
Lassen,2021-04-25,5,9468,0,1099,4,7745,1,624,3,834,2,4602,4,5436,California
Lassen,2021-04-26,45,9513,1,1100,38,7783,6,630,9,814,34,4636,14,5450,California
Lassen,2021-04-27,103,9616,4,1104,96,7879,3,633,52,818,51,4687,55,5505,California
Lassen,2021-04-28,77,9693,6,1110,69,7948,2,635,26,795,51,4738,28,5533,California
Lassen,2021-04-29,59,9752,6,1116,50,7998,3,638,21,782,37,4775,24,5557,California
Lassen,2021-04-30,14,9766,7,1123,4,8002,3,641,5,781,9,4784,8,5565,California
Lassen,2021-05-01,7,9773,0,1123,6,8008,1,642,5,786,1,4785,6,5571,California
Lassen,2021-05-02,6,9779,2,1125,4,8012,0,642,4,788,2,4787,4,5575,California
Lassen,2021-05-03,17,9796,3,1128,9,8021,5,647,3,783,13,4800,8,5583,California
Lassen,2021-05-04,68,9864,2,1130,60,8081,6,653,20,761,48,4848,26,5609,California
Lassen,2021-05-05,76,9940,3,1133,61,8142,12,665,23,744,52,4900,35,5644,California
Lassen,2021-05-06,67,10007,17,1150,27,8169,23,688,18,736,49,4949,41,5685,California
Lassen,2021-05-07,49,10056,32,1182,11,8180,6,694,41,775,8,4957,47,5732,California
Lassen,2021-05-08,10,10066,0,1182,5,8185,5,699,4,778,6,4963,9,5741,California
Lassen,2021-05-09,2,10068,1,1183,0,8185,1,700,0,777,2,4965,1,5742,California
Lassen,2021-05-10,11,10079,1,1184,6,8191,4,704,4,778,7,4972,8,5750,California
Lassen,2021-05-11,56,10135,0,1184,46,8237,10,714,19,770,37,5009,29,5779,California
Lassen,2021-05-12,40,10175,2,1186,33,8270,5,719,14,763,26,5035,19,5798,California
Lassen,2021-05-13,27,10202,6,1192,16,8286,5,724,10,761,17,5052,15,5813,California
Lassen,2021-05-14,19,10221,2,1194,9,8295,8,732,10,770,9,5061,18,5831,California
Lassen,2021-05-15,15,10236,2,1196,4,8299,9,741,4,772,11,5072,13,5844,California
Lassen,2021-05-16,7,10243,2,1198,3,8302,2,743,2,772,4,5076,4,5848,California
Lassen,2021-05-17,34,10277,3,1201,19,8321,12,755,9,768,25,5101,21,5869,California
Lassen,2021-05-18,79,10356,5,1206,62,8383,12,767,23,747,56,5157,35,5904,California
Lassen,2021-05-19,50,10406,1,1207,41,8424,8,775,6,717,43,5200,13,5917,California
Lassen,2021-05-20,31,10437,6,1213,16,8440,9,784,8,711,23,5223,17,5934,California
Lassen,2021-05-21,64,10501,31,1244,19,8459,14,798,33,727,31,5254,47,5981,California
Lassen,2021-05-22,16,10517,1,1245,7,8466,8,806,6,731,10,5264,14,5995,California
Lassen,2021-05-23,4,10521,1,1246,1,8467,2,808,0,729,4,5268,2,5997,California
Lassen,2021-05-24,13,10534,1,1247,10,8477,2,810,5,729,7,5275,7,6004,California
Lassen,2021-05-25,86,10620,6,1253,71,8548,9,819,31,714,55,5330,40,6044,California
Lassen,2021-05-26,54,10674,0,1253,39,8587,15,834,11,697,43,5373,26,6070,California
Lassen,2021-05-27,41,10715,16,1269,19,8606,6,840,11,685,29,5402,17,6087,California
Lassen,2021-05-28,72,10787,46,1315,18,8624,8,848,29,679,43,5445,37,6124,California
Lassen,2021-05-29,15,10802,1,1316,12,8636,2,850,8,682,7,5452,10,6134,California
Lassen,2021-05-30,2,10804,0,1316,1,8637,1,851,1,683,1,5453,2,6136,California
Lassen,2021-05-31,7,10811,0,1316,6,8643,1,852,1,679,6,5459,2,6138,California
Lassen,2021-06-01,44,10855,1,1317,37,8680,6,858,15,672,28,5487,21,6159,California
Lassen,2021-06-02,48,10903,2,1319,33,8713,13,871,10,658,37,5524,23,6182,California
Lassen,2021-06-03,19,10922,1,1320,9,8722,9,880,5,658,14,5538,14,6196,California
Lassen,2021-06-04,36,10958,1,1321,22,8744,13,893,11,657,25,5563,24,6220,California
Lassen,2021-06-05,14,10972,4,1325,7,8751,3,896,5,656,9,5572,8,6228,California
Lassen,2021-06-06,4,10976,0,1325,1,8752,3,899,1,657,3,5575,4,6232,California
Lassen,2021-06-07,17,10993,0,1325,9,8761,8,907,3,654,14,5589,11,6243,California
Lassen,2021-06-08,33,11026,3,1328,26,8787,4,911,12,649,21,5610,16,6259,California
Lassen,2021-06-09,18,11044,1,1329,15,8802,2,913,7,648,10,5620,9,6268,California
Lassen,2021-06-10,16,11060,8,1337,5,8807,3,916,8,651,8,5628,11,6279,California
Lassen,2021-06-11,44,11104,30,1367,14,8821,0,916,11,630,33,5661,12,6291,California
Lassen,2021-06-12,5,11109,1,1368,4,8825,0,916,1,627,4,5665,1,6292,California
Lassen,2021-06-13,3,11112,2,1370,1,8826,0,916,1,626,2,5667,1,6293,California
Lassen,2021-06-14,10,11122,2,1372,6,8832,2,918,4,627,5,5672,6,6299,California
Lassen,2021-06-15,48,11170,6,1378,37,8869,5,923,15,614,33,5705,20,6319,California
Lassen,2021-06-16,10,11180,0,1378,6,8875,4,927,6,620,4,5709,10,6329,California
Lassen,2021-06-17,21,11201,9,1387,8,8883,4,931,10,623,11,5720,14,6343,California
Lassen,2021-06-18,44,11245,18,1405,18,8901,8,939,9,605,35,5755,17,6360,California
Lassen,2021-06-19,12,11257,1,1406,10,8911,1,940,5,604,7,5762,6,6366,California
Lassen,2021-06-20,5,11262,2,1408,3,8914,0,940,5,609,0,5762,5,6371,California
Lassen,2021-06-21,15,11277,0,1408,13,8927,2,942,4,604,11,5773,6,6377,California
Lassen,2021-06-22,34,11311,1,1409,32,8959,1,943,17,605,17,5790,18,6395,California
Lassen,2021-06-23,14,11325,2,1411,10,8969,2,945,3,599,11,5801,5,6400,California
Lassen,2021-06-24,26,11351,2,1413,16,8985,8,953,13,607,13,5814,21,6421,California
Lassen,2021-06-25,20,11371,2,1415,18,9003,0,953,11,609,9,5823,11,6432,California
Lassen,2021-06-26,7,11378,1,1416,6,9009,0,953,1,604,6,5829,1,6433,California
Lassen,2021-06-27,1,11379,0,1416,0,9009,1,954,0,604,1,5830,1,6434,California
Lassen,2021-06-28,13,11392,2,1418,9,9018,2,956,9,611,4,5834,11,6445,California
Lassen,2021-06-29,30,11422,1,1419,28,9046,1,957,8,598,22,5856,9,6454,California
Lassen,2021-06-30,28,11450,8,1427,14,9060,6,963,13,602,15,5871,19,6473,California
Lassen,2021-07-01,26,11476,14,1441,10,9070,2,965,17,612,8,5879,18,6491,California
Lassen,2021-07-02,25,11501,4,1445,17,9087,4,969,9,611,14,5893,13,6504,California
Lassen,2021-07-03,5,11506,0,1445,5,9092,0,969,3,612,2,5895,3,6507,California
Lassen,2021-07-04,1,11507,0,1445,1,9093,0,969,1,613,0,5895,1,6508,California
Lassen,2021-07-05,9,11516,0,1445,6,9099,3,972,2,611,7,5902,5,6513,California
Lassen,2021-07-06,26,11542,0,1445,26,9125,0,972,13,613,11,5913,13,6526,California
Lassen,2021-07-07,16,11558,2,1447,13,9138,1,973,6,610,10,5923,7,6533,California
Lassen,2021-07-08,30,11588,23,1470,7,9145,0,973,22,624,8,5931,22,6555,California
Lassen,2021-07-09,24,11612,3,1473,18,9163,3,976,14,631,10,5941,17,6572,California
Lassen,2021-07-10,1,11613,0,1473,1,9164,0,976,0,630,1,5942,0,6572,California
Lassen,2021-07-11,1,11614,1,1474,0,9164,0,976,0,629,1,5943,0,6572,California
Lassen,2021-07-12,7,11621,0,1474,6,9170,1,977,1,625,6,5949,2,6574,California
Lassen,2021-07-13,24,11645,0,1474,21,9191,3,980,12,628,12,5961,15,6589,California
Lassen,2021-07-14,14,11659,2,1476,9,9200,3,983,7,632,7,5968,11,6600,California
Lassen,2021-07-15,17,11676,3,1479,13,9213,1,984,8,632,9,5977,9,6609,California
Lassen,2021-07-16,22,11698,3,1482,16,9229,3,987,9,631,13,5990,12,6621,California
Lassen,2021-07-17,8,11706,1,1483,7,9236,0,987,3,629,5,5995,3,6624,California
Lassen,2021-07-18,8,11714,0,1483,7,9243,1,988,4,630,4,5999,5,6629,California
Lassen,2021-07-19,3,11717,2,1485,1,9244,0,988,1,629,2,6001,1,6630,California
Lassen,2021-07-20,17,11734,0,1485,13,9257,4,992,5,626,12,6013,9,6639,California
Lassen,2021-07-21,13,11747,8,1493,5,9262,0,992,4,621,9,6022,4,6643,California
Lassen,2021-07-22,32,11779,17,1510,15,9277,0,992,15,619,17,6039,15,6658,California
Lassen,2021-07-23,21,11800,4,1514,16,9293,1,993,11,621,10,6049,12,6670,California
Lassen,2021-07-24,7,11807,0,1514,7,9300,0,993,3,620,4,6053,3,6673,California
Lassen,2021-07-25,2,11809,0,1514,2,9302,0,993,1,620,1,6054,1,6674,California
Lassen,2021-07-26,23,11832,0,1514,22,9324,1,994,14,626,9,6063,15,6689,California
Lassen,2021-07-27,38,11870,2,1516,26,9350,10,1004,20,638,18,6081,30,6719,California
Lassen,2021-07-28,18,11888,2,1518,14,9364,2,1006,10,643,7,6088,12,6731,California
Lassen,2021-07-29,22,11910,1,1519,18,9382,3,1009,12,648,10,6098,15,6746,California
Lassen,2021-07-30,27,11937,4,1523,19,9401,4,1013,13,651,14,6112,17,6763,California
Lassen,2021-07-31,13,11950,0,1523,10,9411,3,1016,9,659,4,6116,12,6775,California
Lassen,2021-08-01,9,11959,0,1523,7,9418,2,1018,5,662,4,6120,7,6782,California
Lassen,2021-08-02,21,11980,1,1524,19,9437,1,1019,19,680,2,6122,20,6802,California
Lassen,2021-08-03,43,12023,1,1525,32,9469,10,1029,20,688,22,6144,30,6832,California
Lassen,2021-08-04,24,12047,2,1527,16,9485,6,1035,13,697,9,6153,18,6850,California
Lassen,2021-08-05,40,12087,30,1557,9,9494,1,1036,28,715,11,6164,29,6879,California
Lassen,2021-08-06,36,12123,2,1559,30,9524,4,1040,16,715,20,6184,20,6899,California
Lassen,2021-08-07,11,12134,2,1561,5,9529,4,1044,5,718,6,6190,9,6908,California
Lassen,2021-08-08,5,12139,0,1561,5,9534,0,1044,4,721,1,6191,4,6912,California
Lassen,2021-08-09,19,12158,1,1562,11,9545,7,1051,11,731,8,6199,18,6930,California
Lassen,2021-08-10,31,12189,1,1563,27,9572,3,1054,15,734,16,6215,19,6949,California
Lassen,2021-08-11,22,12211,1,1564,17,9589,4,1058,9,735,12,6227,13,6962,California
Lassen,2021-08-12,50,12261,30,1594,19,9608,1,1059,31,748,19,6246,32,6994,California
Lassen,2021-08-13,27,12288,0,1594,20,9628,7,1066,11,750,16,6262,18,7012,California
Lassen,2021-08-14,15,12303,0,1594,12,9640,3,1069,8,755,6,6268,11,7023,California
Lassen,2021-08-15,12,12315,4,1598,8,9648,0,1069,8,760,3,6271,8,7031,California
Lassen,2021-08-16,21,12336,3,1601,18,9666,0,1069,16,775,1,6272,16,7047,California
Lassen,2021-08-17,26,12362,6,1607,16,9682,4,1073,15,785,9,6281,19,7066,California
Lassen,2021-08-18,16,12378,5,1612,11,9693,0,1073,10,790,5,6286,10,7076,California
Lassen,2021-08-19,21,12399,1,1613,20,9713,0,1073,17,803,4,6290,17,7093,California
Lassen,2021-08-20,27,12426,8,1621,19,9732,0,1073,21,820,4,6294,21,7114,California
Lassen,2021-08-21,17,12443,9,1630,6,9738,2,1075,10,824,7,6301,11,7125,California
Lassen,2021-08-22,2,12445,1,1631,0,9738,1,1076,1,825,1,6302,2,7127,California
Lassen,2021-08-23,30,12475,15,1646,15,9753,0,1076,23,841,7,6309,23,7150,California
Lassen,2021-08-24,25,12500,7,1653,13,9766,5,1081,12,845,13,6322,17,7167,California
Lassen,2021-08-25,44,12544,8,1661,30,9796,6,1087,25,860,16,6338,31,7198,California
Lassen,2021-08-26,48,12592,34,1695,13,9809,1,1088,20,857,24,6362,21,7219,California
Lassen,2021-08-27,40,12632,17,1712,20,9829,3,1091,21,863,18,6380,24,7243,California
Lassen,2021-08-28,25,12657,9,1721,12,9841,4,1095,11,864,14,6394,15,7258,California
Lassen,2021-08-29,21,12678,6,1727,10,9851,5,1100,7,863,13,6407,12,7270,California
Lassen,2021-08-30,6,12684,1,1728,3,9854,2,1102,1,861,5,6412,3,7273,California
Los Angeles,2020-12-15,410,410,410,410,0,0,0,0,410,410,0,0,410,410,California
Los Angeles,2020-12-16,3867,4277,3867,4277,0,0,0,0,3866,4276,0,0,3866,4276,California
Los Angeles,2020-12-17,10844,15121,10844,15121,0,0,0,0,10846,15122,0,0,10846,15122,California
Los Angeles,2020-12-18,15056,30177,15028,30149,28,28,0,0,15055,30177,0,0,15055,30177,California
Los Angeles,2020-12-19,7388,37565,7378,37527,10,38,0,0,7388,37563,2,2,7388,37565,California
Los Angeles,2020-12-20,4729,42294,4715,42242,14,52,0,0,4733,42296,0,2,4733,42298,California
Los Angeles,2020-12-21,13993,56287,13966,56208,27,79,0,0,13994,56288,2,4,13994,56292,California
Los Angeles,2020-12-22,11812,68099,11397,67605,415,494,0,0,11810,68094,4,8,11810,68102,California
Los Angeles,2020-12-23,12213,80312,10396,78001,1817,2311,0,0,12216,80310,0,8,12216,80318,California
Los Angeles,2020-12-24,7140,87452,4330,82331,2810,5121,0,0,7142,87452,0,8,7142,87460,California
Los Angeles,2020-12-25,545,87997,437,82768,108,5229,0,0,545,87997,0,8,545,88005,California
Los Angeles,2020-12-26,2591,90588,2225,84993,366,5595,0,0,2590,90585,2,10,2590,90595,California
Los Angeles,2020-12-27,1822,92410,1074,86067,748,6343,0,0,1822,92407,0,10,1822,92417,California
Los Angeles,2020-12-28,10552,102962,6551,92618,4001,10344,0,0,10549,102955,1,11,10549,102966,California
Los Angeles,2020-12-29,11864,114826,6202,98820,5662,16006,0,0,11861,114815,1,12,11861,114827,California
Los Angeles,2020-12-30,15156,129982,8217,107037,6939,22945,0,0,15155,129970,0,12,15155,129982,California
Los Angeles,2020-12-31,8162,138144,2813,109850,5349,28294,0,0,8157,138121,6,18,8157,138139,California
Los Angeles,2021-01-01,1236,139380,396,110246,840,29134,0,0,1229,139347,3,21,1229,139368,California
Los Angeles,2021-01-02,4576,143956,1731,111977,2845,31979,0,0,4575,143922,0,21,4575,143943,California
Los Angeles,2021-01-03,1006,144962,247,112224,759,32738,0,0,1004,144924,2,23,1004,144947,California
Los Angeles,2021-01-04,12912,157874,4924,117148,7988,40726,0,0,12894,157816,2,25,12894,157841,California
Los Angeles,2021-01-05,16396,174270,7241,124389,9155,49881,0,0,14373,170207,1992,2017,14383,172224,California
Los Angeles,2021-01-06,23160,197430,12323,136712,10837,60718,0,0,17168,181471,5917,7934,17181,189405,California
Los Angeles,2021-01-07,30240,227670,16386,153098,13854,74572,0,0,19082,189463,11110,19044,19102,208507,California
Los Angeles,2021-01-08,34027,261697,18476,171574,15551,90123,0,0,21151,197781,12847,31891,21165,229672,California
Los Angeles,2021-01-09,12735,274432,7286,178860,5449,95572,0,0,7705,200475,5022,36913,7716,237388,California
Los Angeles,2021-01-10,4841,279273,3756,182616,1085,96657,0,0,2026,199689,2813,39726,2027,239415,California
Los Angeles,2021-01-11,26425,305698,16603,199219,9822,106479,0,0,15238,203771,11173,50899,15255,254670,California
Los Angeles,2021-01-12,29914,335612,16457,215676,13457,119936,0,0,19505,212902,10390,61289,19521,274191,California
Los Angeles,2021-01-13,29986,365598,16055,231731,13931,133867,0,0,20852,224650,9111,70400,20859,295050,California
Los Angeles,2021-01-14,29814,395412,12883,244614,16931,150798,0,0,24132,243136,5661,76061,24147,319197,California
Los Angeles,2021-01-15,34600,430012,12593,257207,22007,172805,0,0,30885,270347,3689,79750,30900,350097,California
Los Angeles,2021-01-16,18116,448128,5108,262315,13008,185813,0,0,16277,284803,1828,81578,16284,366381,California
Los Angeles,2021-01-17,5326,453454,2379,264694,2947,188760,0,0,5050,289579,275,81853,5051,371432,California
Los Angeles,2021-01-18,15982,469436,10262,274956,5720,194480,0,0,11186,295988,4781,86634,11190,382622,California
Los Angeles,2021-01-19,39370,508806,20979,295935,18391,212871,0,0,31375,319431,7948,94582,31391,414013,California
Los Angeles,2021-01-20,47672,556478,24977,320912,22695,235566,0,0,39906,351620,7730,102312,39919,453932,California
Los Angeles,2021-01-21,49927,606405,22875,343787,27052,262618,0,0,45458,392712,4388,106700,45480,499412,California
Los Angeles,2021-01-22,49141,655546,22685,366472,26456,289074,0,0,45531,434706,3554,110254,45548,544960,California
Los Angeles,2021-01-23,34765,690311,15948,382420,18817,307891,0,0,32601,465191,2131,112385,32616,577576,California
Los Angeles,2021-01-24,15863,706174,12230,394650,3633,311524,0,0,15282,479906,571,112956,15286,592862,California
Los Angeles,2021-01-25,40508,746682,17147,411797,23361,334885,0,0,31566,502599,8892,121848,31585,624447,California
Los Angeles,2021-01-26,50890,797572,25409,437206,25481,360366,0,0,42329,536425,8524,130372,42350,666797,California
Los Angeles,2021-01-27,52107,849679,26520,463726,25587,385953,0,0,42355,569205,9606,139978,42386,709183,California
Los Angeles,2021-01-28,50282,899961,24245,487971,26037,411990,0,0,41523,602124,8625,148603,41544,750727,California
Los Angeles,2021-01-29,51059,951020,26368,514339,24691,436681,0,0,40472,632385,10231,158834,40492,791219,California
Los Angeles,2021-01-30,31087,982107,16118,530457,14969,451650,0,0,26632,654651,4373,163207,26639,817858,California
Los Angeles,2021-01-31,13551,995658,10693,541150,2858,454508,0,0,12586,666297,944,164151,12590,830448,California
Los Angeles,2021-02-01,39485,1035143,16794,557944,22691,477199,0,0,28429,683756,10982,175133,28441,858889,California
Los Angeles,2021-02-02,45802,1080945,18493,576437,27309,504508,0,0,33008,704046,12727,187860,33017,891906,California
Los Angeles,2021-02-03,53336,1134281,19919,596356,33417,537925,0,0,37918,726812,15162,203022,37928,929834,California
Los Angeles,2021-02-04,58344,1192625,21029,617385,37315,575240,0,0,39665,748167,18325,221347,39680,969514,California
Los Angeles,2021-02-05,62718,1255343,21272,638657,41446,616686,0,0,39932,765791,22324,243671,39948,1009462,California
Los Angeles,2021-02-06,36320,1291663,13718,652375,22602,639288,0,0,27544,784661,8694,252365,27564,1037026,California
Los Angeles,2021-02-07,11306,1302969,8760,661135,2546,641834,0,0,8842,791070,2442,254807,8851,1045877,California
Los Angeles,2021-02-08,48438,1351407,22544,683679,25894,667728,0,0,31530,805852,16755,271562,31537,1077414,California
Los Angeles,2021-02-09,57055,1408462,25113,708792,31942,699670,0,0,28579,806082,28361,299923,28591,1106005,California
Los Angeles,2021-02-10,68396,1476858,29923,738715,38473,738143,0,0,30700,799513,37290,337213,30721,1136726,California
Los Angeles,2021-02-11,59505,1536363,31754,770469,27751,765894,0,0,28449,797410,30565,367778,28462,1165188,California
Los Angeles,2021-02-12,61274,1597637,30336,800805,30938,796832,0,0,26571,789708,34301,402079,26599,1191787,California
Los Angeles,2021-02-13,34472,1632109,20112,820917,14360,811192,0,0,15557,786525,18796,420875,15613,1207400,California
Los Angeles,2021-02-14,22161,1654270,15073,835990,7088,818280,0,0,8842,782139,13243,434118,8857,1216257,California
Los Angeles,2021-02-15,34032,1688302,16518,852508,17514,835794,0,0,18415,785053,15521,449639,18435,1234692,California
Los Angeles,2021-02-16,65967,1754269,33732,886240,32235,868029,0,0,30042,779335,35786,485425,30068,1264760,California
Los Angeles,2021-02-17,66863,1821132,35787,922027,31076,899105,0,0,26719,766170,39903,525328,26738,1291498,California
Los Angeles,2021-02-18,70463,1891595,36064,958091,34399,933504,0,0,28846,753652,41387,566715,28869,1320367,California
Los Angeles,2021-02-19,60813,1952408,37496,995587,23317,956821,0,0,29252,751544,31382,598097,29274,1349641,California
Los Angeles,2021-02-20,34549,1986957,25245,1020832,9304,966125,0,0,16359,749836,18095,616192,16387,1366028,California
Los Angeles,2021-02-21,23651,2010608,21834,1042666,1817,967942,0,0,11525,749339,12029,628221,11532,1377560,California
Los Angeles,2021-02-22,37525,2048133,27414,1070080,10111,978053,0,0,18911,749811,18462,646683,18934,1396494,California
Los Angeles,2021-02-23,59186,2107319,25447,1095527,33739,1011792,0,0,22662,736257,36249,682932,22695,1419189,California
Los Angeles,2021-02-24,69548,2176867,31057,1126584,38491,1050283,0,0,29341,725733,39907,722839,29383,1448572,California
Los Angeles,2021-02-25,78950,2255817,36254,1162838,42696,1092979,0,0,40016,727130,38657,761496,40054,1488626,California
Los Angeles,2021-02-26,88740,2344557,41043,1203881,47697,1140676,0,0,49061,736901,39345,800841,49116,1537742,California
Los Angeles,2021-02-27,64497,2409054,28359,1232240,36127,1176803,11,11,32257,737209,31999,832840,32307,1570049,California
Los Angeles,2021-02-28,28620,2437674,19796,1252036,8821,1185624,3,14,19707,748187,8751,841591,19729,1589778,California
Los Angeles,2021-03-01,60601,2498275,34560,1286596,25964,1211588,77,91,36054,760108,24248,865839,36169,1625947,California
Los Angeles,2021-03-02,81485,2579760,39144,1325740,42331,1253919,10,101,50828,780561,30428,896267,50881,1676828,California
Los Angeles,2021-03-03,89251,2669011,45351,1371091,43873,1297792,27,128,55956,803523,33057,929324,56019,1732847,California
Los Angeles,2021-03-04,94616,2763627,48164,1419255,46434,1344226,18,146,59284,827795,35076,964400,59348,1792195,California
Los Angeles,2021-03-05,92988,2856615,45586,1464841,47366,1391592,36,182,61549,858293,31162,995562,61660,1853855,California
Los Angeles,2021-03-06,68810,2925425,34859,1499700,32081,1423673,1870,2052,44036,879595,24595,1020157,45897,1899752,California
Los Angeles,2021-03-07,28916,2954341,21158,1520858,6103,1429776,1655,3707,21776,895904,7091,1027248,23400,1923152,California
Los Angeles,2021-03-08,55497,3009838,29815,1550673,23553,1453329,2129,5836,41760,926183,13600,1040848,43879,1967031,California
Los Angeles,2021-03-09,83203,3093041,39708,1590381,40114,1493443,3381,9217,52862,952213,30157,1071005,56187,2023218,California
Los Angeles,2021-03-10,84910,3177951,41728,1632109,38256,1531699,4926,14143,53695,979762,30994,1101999,58543,2081761,California
Los Angeles,2021-03-11,94821,3272772,46638,1678747,41361,1573060,6822,20965,55431,1002768,39141,1141140,62147,2143908,California
Los Angeles,2021-03-12,100843,3373615,45874,1724621,41006,1614066,13963,34928,58730,1033400,41829,1182969,72461,2216369,California
Los Angeles,2021-03-13,76541,3450156,36199,1760820,28306,1642372,12036,46964,45580,1059999,30811,1213780,57410,2273779,California
Los Angeles,2021-03-14,39519,3489675,26533,1787353,10417,1652789,2569,49533,24056,1071212,15367,1229147,26580,2300359,California
Los Angeles,2021-03-15,76366,3566041,37546,1824899,33315,1686104,5505,55038,45814,1092155,30279,1259426,51222,2351581,California
Los Angeles,2021-03-16,101454,3667495,44712,1869611,50827,1736931,5915,60953,65315,1127358,35859,1295285,71062,2422643,California
Los Angeles,2021-03-17,99312,3766807,45403,1915014,45531,1782462,8378,69331,66286,1169003,32751,1328036,74396,2497039,California
Los Angeles,2021-03-18,104699,3871506,50307,1965321,48775,1831237,5617,74948,65497,1201200,38831,1366867,71028,2568067,California
Los Angeles,2021-03-19,110859,3982365,57977,2023298,48056,1879293,4826,79774,67475,1230369,43023,1409890,72192,2640259,California
Los Angeles,2021-03-20,78071,4060436,38329,2061627,35108,1914401,4634,84408,52657,1262433,25172,1435062,57236,2697495,California
Los Angeles,2021-03-21,35323,4095759,26266,2087893,8143,1922544,914,85322,22258,1272685,12910,1447972,23162,2720657,California
Los Angeles,2021-03-22,72132,4167891,42517,2130410,27407,1949951,2208,87530,50008,1303089,21791,1469763,52195,2772852,California
Los Angeles,2021-03-23,98307,4266198,53409,2183819,41631,1991582,3267,90797,58566,1325496,39399,1509162,61806,2834658,California
Los Angeles,2021-03-24,106803,4373001,56751,2240570,46841,2038423,3211,94008,60490,1343261,45896,1555058,63661,2898319,California
Los Angeles,2021-03-25,112940,4485941,60706,2301276,48275,2086698,3959,97967,62334,1359274,50233,1605291,66246,2964565,California
Los Angeles,2021-03-26,118156,4604097,64407,2365683,49489,2136187,4260,102227,64543,1374803,53218,1658509,68747,3033312,California
Los Angeles,2021-03-27,84979,4689076,44745,2410428,38079,2174266,2155,104382,42875,1378048,41778,1700287,45023,3078335,California
Los Angeles,2021-03-28,42857,4731933,29066,2439494,13197,2187463,594,104976,20118,1376189,22565,1722852,20706,3099041,California
Los Angeles,2021-03-29,86111,4818044,48013,2487507,36299,2223762,1799,106775,47166,1386520,38631,1761483,48962,3148003,California
Los Angeles,2021-03-30,112196,4930240,53368,2540875,52839,2276601,5989,112764,57925,1396388,53942,1815425,63810,3211813,California
Los Angeles,2021-03-31,125448,5055688,63308,2604183,53185,2329786,8955,121719,69271,1418706,55776,1871201,78094,3289907,California
Los Angeles,2021-04-01,137491,5193179,64423,2668606,57379,2387165,15689,137408,72914,1443041,64031,1935232,88366,3378273,California
Los Angeles,2021-04-02,135829,5329008,60609,2729215,59425,2446590,15795,153203,71702,1466711,63693,1998925,87363,3465636,California
Los Angeles,2021-04-03,100515,5429523,46108,2775323,40539,2487129,13868,167071,49570,1479294,50693,2049618,63276,3528912,California
Los Angeles,2021-04-04,39616,5469139,20749,2796072,12153,2499282,6714,173785,16387,1479216,23107,2072725,23029,3551941,California
Los Angeles,2021-04-05,97098,5566237,45565,2841637,40882,2540164,10651,184436,45563,1484036,51245,2123970,56065,3608006,California
Los Angeles,2021-04-06,124077,5690314,58376,2900013,45012,2585176,20689,205125,56728,1494189,67013,2190983,77166,3685172,California
Los Angeles,2021-04-07,123312,5813626,56093,2956106,45607,2630783,21612,226737,55353,1503275,67627,2258610,76713,3761885,California
Los Angeles,2021-04-08,135964,5949590,59917,3016023,51394,2682177,24653,251390,60931,1513941,74622,2333232,85288,3847173,California
Los Angeles,2021-04-09,134685,6084275,58385,3074408,51798,2733975,24502,275892,57498,1518869,76770,2410002,81698,3928871,California
Los Angeles,2021-04-10,104381,6188656,44382,3118790,35277,2769252,24722,300614,38755,1516767,65319,2475321,63217,3992088,California
Los Angeles,2021-04-11,42390,6231046,22862,3141652,10039,2779291,9489,310103,14627,1513132,27639,2502960,24004,4016092,California
Los Angeles,2021-04-12,81142,6312188,39512,3181164,34966,2814257,6664,316767,33116,1505076,47737,2550697,39681,4055773,California
Los Angeles,2021-04-13,120617,6432805,60818,3241982,59358,2873615,441,317208,63613,1512469,56671,2607368,64064,4119837,California
Los Angeles,2021-04-14,121130,6553935,60659,3302641,60325,2933940,146,317354,65101,1522075,55646,2663014,65252,4185089,California
Los Angeles,2021-04-15,132022,6685957,71136,3373777,60677,2994617,209,317563,74587,1539717,57031,2720045,74673,4259762,California
Los Angeles,2021-04-16,133044,6819001,70108,3443885,62788,3057405,148,317711,69566,1546331,63046,2783091,69660,4329422,California
Los Angeles,2021-04-17,100407,6919408,52506,3496391,47873,3105278,28,317739,56716,1559697,43379,2826470,56745,4386167,California
Los Angeles,2021-04-18,36155,6955563,24412,3520803,11740,3117018,3,317742,19644,1562950,16402,2842872,19655,4405822,California
Los Angeles,2021-04-19,78125,7033688,40853,3561656,37253,3154271,19,317761,34630,1554400,43215,2886087,34665,4440487,California
Los Angeles,2021-04-20,106310,7139998,52579,3614235,53694,3207965,37,317798,51893,1552278,54056,2940143,51934,4492421,California
Los Angeles,2021-04-21,116166,7256164,56917,3671152,59052,3267017,197,317995,51136,1539065,64560,3004703,51347,4543768,California
Los Angeles,2021-04-22,120443,7376607,62607,3733759,57797,3324814,39,318034,52683,1524517,67282,3071985,52734,4596502,California
Los Angeles,2021-04-23,120375,7496982,66090,3799849,54258,3379072,27,318061,56815,1518218,63155,3135140,56856,4653358,California
Los Angeles,2021-04-24,92587,7589569,58636,3858485,33904,3412976,47,318108,51099,1528207,41173,3176313,51162,4704520,California
Los Angeles,2021-04-25,38579,7628148,25548,3884033,13023,3425999,8,318116,20696,1531185,17729,3194042,20707,4725227,California
Los Angeles,2021-04-26,80263,7708411,41901,3925934,37839,3463838,523,318639,38954,1529656,41009,3235051,39480,4764707,California
Los Angeles,2021-04-27,96595,7805006,46494,3972428,48074,3511912,2027,320666,36806,1509047,59426,3294477,38817,4803524,California
Los Angeles,2021-04-28,89365,7894371,43343,4015771,43876,3555788,2146,322812,34855,1491945,54092,3348569,36990,4840514,California
Los Angeles,2021-04-29,96401,7990772,48306,4064077,45845,3601633,2250,325062,34210,1466724,61667,3410236,36446,4876960,California
Los Angeles,2021-04-30,104404,8095176,51666,4115743,50229,3651862,2509,327571,37609,1440594,66221,3476457,40091,4917051,California
Los Angeles,2021-05-01,78134,8173310,43525,4159268,33006,3684868,1603,329174,29509,1423527,48162,3524619,31095,4948146,California
Los Angeles,2021-05-02,28461,8201771,18262,4177530,9446,3694314,753,329927,10225,1416415,18090,3542709,10978,4959124,California
Los Angeles,2021-05-03,63844,8265615,31129,4208659,30438,3724752,2277,332204,22661,1400488,40846,3583555,24919,4984043,California
Los Angeles,2021-05-04,90040,8355655,50159,4258818,37520,3762272,2361,334565,27573,1368308,62089,3645644,29909,5013952,California
Los Angeles,2021-05-05,93061,8448716,54331,4313149,36298,3798570,2432,336997,25570,1329239,67056,3712700,27987,5041939,California
Los Angeles,2021-05-06,100835,8549551,61177,4374326,37086,3835656,2572,339569,23784,1278983,76590,3789290,26334,5068273,California
Los Angeles,2021-05-07,100099,8649650,59219,4433545,38473,3874129,2407,341976,27342,1236426,72282,3861572,29725,5097998,California
Los Angeles,2021-05-08,68228,8717878,44768,4478313,21650,3895779,1810,343786,18835,1208044,49017,3910589,20635,5118633,California
Los Angeles,2021-05-09,24673,8742551,18945,4497258,4979,3900758,749,344535,6168,1196563,18388,3928977,6907,5125540,California
Los Angeles,2021-05-10,51835,8794386,27493,4524751,22385,3923143,1957,346492,15616,1178211,35915,3964892,17563,5143103,California
Los Angeles,2021-05-11,72988,8867374,39890,4564641,30909,3954052,2189,348681,18925,1145578,53726,4018618,21093,5164196,California
Los Angeles,2021-05-12,73830,8941204,40348,4604989,31126,3985178,2356,351037,20786,1116024,52660,4071278,23106,5187302,California
Los Angeles,2021-05-13,79710,9020914,48015,4653004,29937,4015115,1758,352795,28312,1095133,50942,4122220,30051,5217353,California
Los Angeles,2021-05-14,91137,9112051,57959,4710963,31264,4046379,1914,354709,34259,1074843,56454,4178674,36164,5253517,California
Los Angeles,2021-05-15,77632,9189683,54294,4765257,21751,4068130,1587,356296,30140,1059436,47118,4225792,31711,5285228,California
Los Angeles,2021-05-16,31369,9221052,24872,4790129,5876,4074006,621,356917,12411,1053632,18832,4244624,13028,5298256,California
Los Angeles,2021-05-17,62977,9284029,40647,4830776,20508,4094514,1822,358739,25130,1042993,37562,4282186,26923,5325179,California
Los Angeles,2021-05-18,66200,9350229,39039,4869815,25288,4119802,1873,360612,25904,1030767,39971,4322157,27745,5352924,California
Los Angeles,2021-05-19,68481,9418710,41163,4910978,25408,4145210,1910,362522,29072,1022633,39093,4361250,30959,5383883,California
Los Angeles,2021-05-20,68067,9486777,38246,4949224,27681,4172891,2140,364662,25741,1008616,41881,4403131,27864,5411747,California
Los Angeles,2021-05-21,71330,9558107,43231,4992455,25979,4198870,2120,366782,27512,994875,43364,4446495,29623,5441370,California
Los Angeles,2021-05-22,58500,9616607,38038,5030493,18784,4217654,1678,368460,23669,985684,34528,4481023,25337,5466707,California
Los Angeles,2021-05-23,24526,9641133,17111,5047604,6566,4224220,849,369309,10827,983803,13551,4494574,11670,5478377,California
Los Angeles,2021-05-24,50071,9691204,27655,5075259,20520,4244740,1896,371205,18864,973632,30915,4525489,20744,5499121,California
Los Angeles,2021-05-25,50828,9742032,29365,5104624,19650,4264390,1813,373018,19522,963986,30970,4556459,21324,5520445,California
Los Angeles,2021-05-26,48041,9790073,27063,5131687,19055,4283445,1923,374941,20020,958242,27554,4584013,21810,5542255,California
Los Angeles,2021-05-27,46221,9836294,25797,5157484,18548,4301993,1876,376817,18994,952147,26945,4610958,20850,5563105,California
Los Angeles,2021-05-28,53372,9889666,30206,5187690,21231,4323224,1935,378752,23518,948120,29468,4640426,25441,5588546,California
Los Angeles,2021-05-29,31109,9920775,18024,5205714,12026,4335250,1059,379811,14382,947054,16498,4656924,15432,5603978,California
Los Angeles,2021-05-30,12659,9933434,8295,5214009,3621,4338871,743,380554,5852,946907,6737,4663661,6590,5610568,California
Los Angeles,2021-05-31,6210,9939644,3849,5217858,2049,4340920,312,380866,1776,944652,4339,4668000,2084,5612652,California
Los Angeles,2021-06-01,47211,9986855,26420,5244278,19174,4360094,1617,382483,17208,933880,29568,4697568,18796,5631448,California
Los Angeles,2021-06-02,39325,10026180,22724,5267002,15130,4375224,1471,383954,15354,927022,23653,4721221,16795,5648243,California
Los Angeles,2021-06-03,43664,10069844,28861,5295863,13169,4388393,1634,385588,14926,915136,28426,4749647,16540,5664783,California
Los Angeles,2021-06-04,53356,10123200,36004,5331867,15642,4404035,1710,387298,16804,897495,36137,4785784,18496,5683279,California
Los Angeles,2021-06-05,43143,10166343,30859,5362726,10870,4414905,1414,388712,12438,880832,30493,4816277,13830,5697109,California
Los Angeles,2021-06-06,14939,10181282,12323,5375049,1873,4416778,743,389455,3994,874701,10860,4827137,4729,5701838,California
Los Angeles,2021-06-07,37586,10218868,26803,5401852,9292,4426070,1491,390946,12060,862944,25291,4852428,13534,5715372,California
Los Angeles,2021-06-08,38837,10257705,26715,5428567,10492,4436562,1630,392576,12884,851813,25627,4878055,14496,5729868,California
Los Angeles,2021-06-09,40380,10298085,28435,5457002,10390,4446952,1555,394131,11852,836966,28221,4906276,13374,5743242,California
Los Angeles,2021-06-10,37126,10335211,25637,5482639,9850,4456802,1639,395770,11503,824722,25367,4931643,13123,5756365,California
Los Angeles,2021-06-11,41963,10377174,28714,5511353,11545,4468347,1704,397474,13625,812036,28000,4959643,15314,5771679,California
Los Angeles,2021-06-12,34038,10411212,24478,5535831,8310,4476657,1250,398724,10495,800403,23360,4983003,11727,5783406,California
Los Angeles,2021-06-13,11643,10422855,8343,5544174,2661,4479318,639,399363,2650,794767,8922,4991925,3286,5786692,California
Los Angeles,2021-06-14,33412,10456267,24013,5568187,7986,4487304,1413,400776,11708,786376,21487,5013412,13096,5799788,California
Los Angeles,2021-06-15,34722,10490989,23234,5591421,9742,4497046,1746,402522,12100,777976,22216,5035628,13816,5813604,California
Los Angeles,2021-06-16,33056,10524045,22825,5614246,8449,4505495,1782,404304,11620,770188,21174,5056802,13386,5826990,California
Los Angeles,2021-06-17,30267,10554312,20264,5634510,8239,4513734,1764,406068,11099,764153,18876,5075678,12841,5839831,California
Los Angeles,2021-06-18,35852,10590164,24600,5659110,9253,4522987,1999,408067,12629,755938,22821,5098499,14606,5854437,California
Los Angeles,2021-06-19,22894,10613058,15499,5674609,6007,4528994,1388,409455,8647,751944,14007,5112506,10013,5864450,California
Los Angeles,2021-06-20,8552,10621610,6020,5680629,2035,4531029,497,409952,3080,750126,5394,5117900,3576,5868026,California
Los Angeles,2021-06-21,19469,10641079,11930,5692559,6147,4537176,1392,411344,10424,753012,8916,5126816,11802,5879828,California
Los Angeles,2021-06-22,26770,10667849,18028,5710587,7176,4544352,1566,412910,10335,748674,16231,5143047,11893,5891721,California
Los Angeles,2021-06-23,25390,10693239,17414,5728001,6527,4550879,1449,414359,10156,745222,15025,5158072,11573,5903294,California
Los Angeles,2021-06-24,25310,10718549,17431,5745432,6220,4557099,1659,416018,9782,741330,15296,5173368,11404,5914698,California
Los Angeles,2021-06-25,29845,10748394,20750,5766182,7454,4564553,1641,417659,12183,737701,17429,5190797,13800,5928498,California
Los Angeles,2021-06-26,20284,10768678,14744,5780926,4504,4569057,1036,418695,8437,735433,11721,5202518,9453,5937951,California
Los Angeles,2021-06-27,8760,10777438,6380,5787306,1939,4570996,441,419136,3702,734588,4977,5207495,4132,5942083,California
Los Angeles,2021-06-28,20565,10798003,15812,5803118,3482,4574478,1271,420407,8981,733396,11424,5218919,10232,5952315,California
Los Angeles,2021-06-29,22924,10820927,15734,5818852,6081,4580559,1109,421516,10102,731950,12643,5231562,11197,5963512,California
Los Angeles,2021-06-30,23028,10843955,16215,5835067,5693,4586252,1120,422636,10519,731278,12293,5243855,11621,5975133,California
Los Angeles,2021-07-01,20624,10864579,14600,5849667,4985,4591237,1039,423675,9355,730539,11114,5254969,10375,5985508,California
Los Angeles,2021-07-02,24313,10888892,17154,5866821,6013,4597250,1146,424821,11026,729591,13098,5268067,12150,5997658,California
Los Angeles,2021-07-03,14016,10902908,9869,5876690,3624,4600874,523,425344,6415,729047,7475,5275542,6931,6004589,California
Los Angeles,2021-07-04,786,10903694,413,5877103,323,4601197,50,425394,372,729066,400,5275942,419,6005008,California
Los Angeles,2021-07-05,11375,10915069,8265,5885368,2829,4604026,281,425675,5295,728662,5981,5281923,5577,6010585,California
Los Angeles,2021-07-06,24675,10939744,17699,5903067,5748,4609774,1228,426903,9447,724291,15038,5296961,10667,6021252,California
Los Angeles,2021-07-07,20784,10960528,14702,5917769,4950,4614724,1132,428035,8726,722256,11877,5308838,9842,6031094,California
Los Angeles,2021-07-08,19401,10979929,13721,5931490,4598,4619322,1082,429117,8186,720434,11078,5319916,9256,6040350,California
Los Angeles,2021-07-09,23850,11003779,16846,5948336,5560,4624882,1444,430561,10312,718792,13363,5333279,11721,6052071,California
Los Angeles,2021-07-10,16982,11020761,12484,5960820,3713,4628595,785,431346,7311,717343,9537,5342816,8088,6060159,California
Los Angeles,2021-07-11,6622,11027383,4742,5965562,1576,4630171,304,431650,3223,717524,3344,5346160,3525,6063684,California
Los Angeles,2021-07-12,18669,11046052,13398,5978960,4153,4634324,1118,432768,7844,715777,10691,5356851,8944,6072628,California
Los Angeles,2021-07-13,19073,11065125,12907,5991867,5090,4639414,1076,433844,8828,715578,10086,5366937,9887,6082515,California
Los Angeles,2021-07-14,19116,11084241,13251,6005118,4823,4644237,1042,434886,8707,715037,10268,5377205,9727,6092242,California
Los Angeles,2021-07-15,18923,11103164,13401,6018519,4668,4648905,854,435740,8959,715016,9824,5387029,9803,6102045,California
Los Angeles,2021-07-16,24231,11127395,17396,6035915,5798,4654703,1037,436777,11945,715871,12112,5399141,12967,6115012,California
Los Angeles,2021-07-17,17037,11144432,12023,6047938,4155,4658858,859,437636,8305,716407,8621,5407762,9157,6124169,California
Los Angeles,2021-07-18,7493,11151925,5544,6053482,1669,4660527,280,437916,3846,716954,3579,5411341,4126,6128295,California
Los Angeles,2021-07-19,19482,11171407,14271,6067753,4345,4664872,866,438782,9546,717570,9780,5421121,10396,6138691,California
Los Angeles,2021-07-20,20955,11192362,14458,6082211,5706,4670578,791,439573,10740,719052,10033,5431154,11515,6150206,California
Los Angeles,2021-07-21,21207,11213569,14936,6097147,5020,4675598,1251,440824,10599,720439,10445,5441599,11832,6162038,California
Los Angeles,2021-07-22,21089,11234658,15014,6112161,4979,4680577,1096,441920,11180,722982,9710,5451309,12253,6174291,California
Los Angeles,2021-07-23,25177,11259835,17904,6130065,6068,4686645,1205,443125,13643,726489,11324,5462633,14831,6189122,California
Los Angeles,2021-07-24,16421,11276256,11503,6141568,4196,4690841,722,443847,9310,729556,6961,5469594,10028,6199150,California
Los Angeles,2021-07-25,7035,11283291,5015,6146583,1883,4692724,137,443984,5296,733316,1671,5471265,5431,6204581,California
Los Angeles,2021-07-26,19467,11302758,13604,6160187,4953,4697677,910,444894,12081,739081,7206,5478471,12971,6217552,California
Los Angeles,2021-07-27,22613,11325371,16263,6176450,5448,4703125,902,445796,13064,743678,9355,5487826,13952,6231504,California
Los Angeles,2021-07-28,23504,11348875,16603,6193053,5992,4709117,909,446705,14044,749381,9232,5497058,14935,6246439,California
Los Angeles,2021-07-29,22133,11371008,15818,6208871,5422,4714539,893,447598,13535,755445,8346,5505404,14410,6260849,California
Los Angeles,2021-07-30,25844,11396852,18708,6227579,6244,4720783,892,448490,15270,761288,10300,5515704,16143,6276992,California
Los Angeles,2021-07-31,17471,11414323,12654,6240233,4204,4724987,613,449103,10397,765439,6844,5522548,10995,6287987,California
Los Angeles,2021-08-01,7864,11422187,5929,6246162,1795,4726782,140,449243,5073,767949,2706,5525254,5216,6293203,California
Los Angeles,2021-08-02,21104,11443291,15764,6261926,4532,4731314,808,450051,13113,774087,7774,5533028,13912,6307115,California
Los Angeles,2021-08-03,23432,11466723,16990,6278916,5420,4736734,1022,451073,14232,780371,8953,5541981,15237,6322352,California
Los Angeles,2021-08-04,22168,11488891,16366,6295282,4950,4741684,852,451925,13499,786266,8436,5550417,14331,6336683,California
Los Angeles,2021-08-05,22483,11511374,16651,6311933,4909,4746593,923,452848,13637,792244,8571,5558988,14549,6351232,California
Los Angeles,2021-08-06,27592,11538966,20510,6332443,6066,4752659,1016,453864,16123,798242,11131,5570119,17129,6368361,California
Los Angeles,2021-08-07,18487,11557453,13816,6346259,4058,4756717,613,454477,10932,802420,7354,5577473,11532,6379893,California
Los Angeles,2021-08-08,9167,11566620,6769,6353028,2204,4758921,194,454671,5480,804539,3553,5581026,5672,6385565,California
Los Angeles,2021-08-09,23016,11589636,17603,6370631,4562,4763483,851,455522,13272,809148,9501,5590527,14110,6399675,California
Los Angeles,2021-08-10,23593,11613229,17180,6387811,5529,4769012,884,456406,13467,813633,9850,5600377,14335,6414010,California
Los Angeles,2021-08-11,20448,11633677,15225,6403036,4276,4773288,947,457353,11390,817167,8788,5609165,12322,6426332,California
Los Angeles,2021-08-12,23351,11657028,17039,6420075,5433,4778721,879,458232,13235,821514,9756,5618921,14103,6440435,California
Los Angeles,2021-08-13,28406,11685434,20765,6440840,6683,4785404,958,459190,15311,825282,12478,5631399,16246,6456681,California
Los Angeles,2021-08-14,20164,11705598,14438,6455278,5117,4790521,609,459799,10385,827740,8526,5639925,10984,6467665,California
Los Angeles,2021-08-15,9592,11715190,6887,6462165,2523,4793044,182,459981,4634,828539,4012,5643937,4811,6472476,California
Los Angeles,2021-08-16,24834,11740024,17041,6479206,6929,4799973,864,460845,11698,830196,10886,5654823,12543,6485019,California
Los Angeles,2021-08-17,25798,11765822,17544,6496750,7374,4807347,880,461725,11635,831139,11561,5666384,12504,6497523,California
Los Angeles,2021-08-18,25488,11791310,17481,6514231,7198,4814545,809,462534,10831,831034,11736,5678120,11631,6509154,California
Los Angeles,2021-08-19,24832,11816142,16902,6531133,6969,4821514,961,463495,10584,831224,11341,5689461,11531,6520685,California
Los Angeles,2021-08-20,30935,11847077,22030,6553163,8059,4829573,846,464341,12853,830312,14593,5704054,13681,6534366,California
Los Angeles,2021-08-21,20547,11867624,14771,6567934,5235,4834808,541,464882,8641,829665,9819,5713873,9172,6543538,California
Los Angeles,2021-08-22,10930,11878554,7583,6575517,3119,4837927,228,465110,4719,829783,4828,5718701,4946,6548484,California
Los Angeles,2021-08-23,26321,11904875,18780,6594297,6770,4844697,771,465881,10953,829114,12390,5731091,11721,6560205,California
Los Angeles,2021-08-24,25724,11930599,18609,6612906,6294,4850991,821,466702,10310,827700,12530,5743621,11116,6571321,California
Los Angeles,2021-08-25,24425,11955024,17744,6630650,6039,4857030,642,467344,9779,826247,11858,5755479,10405,6581726,California
Los Angeles,2021-08-26,24673,11979697,17693,6648343,6189,4863219,791,468135,9694,824763,11956,5767435,10472,6592198,California
Los Angeles,2021-08-27,30732,12010429,22744,6671087,7265,4870484,723,468858,11639,821896,15218,5782653,12351,6604549,California
Los Angeles,2021-08-28,20515,12030944,15267,6686354,4757,4875241,491,469349,7712,819273,10811,5793464,8188,6612737,California
Los Angeles,2021-08-29,10534,12041478,7660,6694014,2732,4877973,142,469491,3927,818044,5294,5798758,4065,6616802,California
Los Angeles,2021-08-30,17458,12058936,11937,6705951,4693,4882666,828,470319,6041,815885,9008,5807766,6849,6623651,California
Madera,2020-12-16,21,21,21,21,0,0,0,0,21,21,0,0,21,21,California
Madera,2020-12-17,12,33,12,33,0,0,0,0,12,33,0,0,12,33,California
Madera,2020-12-18,62,95,62,95,0,0,0,0,62,95,0,0,62,95,California
Madera,2020-12-19,6,101,6,101,0,0,0,0,6,101,0,0,6,101,California
Madera,2020-12-20,12,113,12,113,0,0,0,0,12,113,0,0,12,113,California
Madera,2020-12-21,61,174,61,174,0,0,0,0,61,174,0,0,61,174,California
Madera,2020-12-22,98,272,96,270,2,2,0,0,98,272,0,0,98,272,California
Madera,2020-12-23,66,338,66,336,0,2,0,0,66,338,0,0,66,338,California
Madera,2020-12-24,43,381,38,374,5,7,0,0,43,381,0,0,43,381,California
Madera,2020-12-26,28,409,27,401,1,8,0,0,28,409,0,0,28,409,California
Madera,2020-12-27,27,436,12,413,15,23,0,0,27,436,0,0,27,436,California
Madera,2020-12-28,110,546,36,449,74,97,0,0,110,546,0,0,110,546,California
Madera,2020-12-29,175,721,38,487,137,234,0,0,175,721,0,0,175,721,California
Madera,2020-12-30,228,949,89,576,139,373,0,0,228,949,0,0,228,949,California
Madera,2020-12-31,204,1153,82,658,122,495,0,0,204,1153,0,0,204,1153,California
Madera,2021-01-01,2,1155,1,659,1,496,0,0,2,1155,0,0,2,1155,California
Madera,2021-01-02,88,1243,32,691,56,552,0,0,88,1243,0,0,88,1243,California
Madera,2021-01-03,4,1247,4,695,0,552,0,0,4,1247,0,0,4,1247,California
Madera,2021-01-04,130,1377,67,762,63,615,0,0,130,1377,0,0,130,1377,California
Madera,2021-01-05,276,1653,141,903,135,750,0,0,272,1645,4,4,272,1649,California
Madera,2021-01-06,183,1836,26,929,157,907,0,0,164,1790,19,23,164,1813,California
Madera,2021-01-07,398,2234,116,1045,282,1189,0,0,375,2143,23,46,376,2189,California
Madera,2021-01-08,421,2655,72,1117,349,1538,0,0,366,2457,54,100,368,2557,California
Madera,2021-01-09,36,2691,14,1131,22,1560,0,0,27,2475,9,109,27,2584,California
Madera,2021-01-10,18,2709,15,1146,3,1563,0,0,6,2469,12,121,6,2590,California
Madera,2021-01-11,241,2950,194,1340,47,1610,0,0,195,2618,46,167,195,2785,California
Madera,2021-01-12,390,3340,157,1497,233,1843,0,0,286,2800,104,271,286,3071,California
Madera,2021-01-13,181,3521,88,1585,93,1936,0,0,130,2880,51,322,131,3202,California
Madera,2021-01-14,553,4074,84,1669,469,2405,0,0,518,3363,35,357,518,3720,California
Madera,2021-01-15,599,4673,156,1825,443,2848,0,0,577,3918,22,379,577,4297,California
Madera,2021-01-16,387,5060,48,1873,339,3187,0,0,358,4247,29,408,358,4655,California
Madera,2021-01-17,336,5396,15,1888,321,3508,0,0,332,4575,4,412,332,4987,California
Madera,2021-01-18,80,5476,64,1952,16,3524,0,0,61,4618,18,430,61,5048,California
Madera,2021-01-19,558,6034,128,2080,430,3954,0,0,532,5125,26,456,533,5581,California
Madera,2021-01-20,343,6377,185,2265,158,4112,0,0,247,5277,95,551,247,5828,California
Madera,2021-01-21,293,6670,182,2447,111,4223,0,0,228,5442,63,614,228,6056,California
Madera,2021-01-22,264,6934,81,2528,183,4406,0,0,245,5668,19,633,245,6301,California
Madera,2021-01-23,99,7033,54,2582,45,4451,0,0,75,5719,24,657,75,6376,California
Madera,2021-01-24,97,7130,81,2663,16,4467,0,0,78,5778,19,676,78,6454,California
Madera,2021-01-25,272,7402,125,2788,147,4614,0,0,147,5800,125,801,147,6601,California
Madera,2021-01-26,497,7899,190,2978,307,4921,0,0,306,5917,190,991,307,6908,California
Madera,2021-01-27,757,8656,74,3052,683,5604,0,0,615,6392,142,1133,617,7525,California
Madera,2021-01-28,560,9216,114,3166,446,6050,0,0,450,6737,110,1243,455,7980,California
Madera,2021-01-29,477,9693,95,3261,382,6432,0,0,422,7104,55,1298,422,8402,California
Madera,2021-01-30,503,10196,19,3280,484,6916,0,0,449,7500,54,1352,450,8852,California
Madera,2021-01-31,8,10204,4,3284,4,6920,0,0,7,7506,1,1353,7,8859,California
Madera,2021-02-01,333,10537,148,3432,185,7105,0,0,209,7591,124,1477,209,9068,California
Madera,2021-02-02,255,10792,93,3525,162,7267,0,0,164,7666,90,1567,165,9233,California
Madera,2021-02-03,602,11394,461,3986,141,7408,0,0,479,8026,121,1688,481,9714,California
Madera,2021-02-04,401,11795,128,4114,273,7681,0,0,121,7869,279,1967,122,9836,California
Madera,2021-02-05,982,12777,299,4413,683,8364,0,0,375,7645,601,2568,377,10213,California
Madera,2021-02-06,372,13149,335,4748,37,8401,0,0,332,7939,39,2607,333,10546,California
Madera,2021-02-07,34,13183,5,4753,29,8430,0,0,29,7963,5,2612,29,10575,California
Madera,2021-02-08,397,13580,318,5071,79,8509,0,0,278,8123,118,2730,278,10853,California
Madera,2021-02-09,491,14071,119,5190,372,8881,0,0,205,8046,283,3013,206,11059,California
Madera,2021-02-10,438,14509,150,5340,288,9169,0,0,284,8179,152,3165,285,11344,California
Madera,2021-02-11,933,15442,305,5645,628,9797,0,0,399,8047,532,3697,400,11744,California
Madera,2021-02-12,853,16295,118,5763,735,10532,0,0,320,7843,527,4224,323,12067,California
Madera,2021-02-13,486,16781,46,5809,440,10972,0,0,134,7629,351,4575,137,12204,California
Madera,2021-02-14,402,17183,74,5883,328,11300,0,0,137,7503,265,4840,139,12343,California
Madera,2021-02-15,248,17431,100,5983,148,11448,0,0,177,7611,69,4909,177,12520,California
Madera,2021-02-16,781,18212,182,6165,599,12047,0,0,233,7299,546,5455,234,12754,California
Madera,2021-02-17,632,18844,287,6452,345,12392,0,0,348,7372,277,5732,350,13104,California
Madera,2021-02-18,1312,20156,547,6999,765,13157,0,0,1123,8310,186,5918,1124,14228,California
Madera,2021-02-19,868,21024,546,7545,322,13479,0,0,719,8883,148,6066,721,14949,California
Madera,2021-02-20,1087,22111,997,8542,90,13569,0,0,1012,9822,74,6140,1013,15962,California
Madera,2021-02-21,1008,23119,864,9406,144,13713,0,0,1001,10817,6,6146,1001,16963,California
Madera,2021-02-22,974,24093,894,10300,80,13793,0,0,909,11661,65,6211,909,17872,California
Madera,2021-02-23,800,24893,510,10810,290,14083,0,0,558,11979,240,6451,558,18430,California
Madera,2021-02-24,945,25838,310,11120,635,14718,0,0,391,11817,553,7004,391,18821,California
Madera,2021-02-25,1079,26917,317,11437,762,15480,0,0,614,11973,458,7462,614,19435,California
Madera,2021-02-26,1116,28033,205,11642,911,16391,0,0,712,12283,402,7864,712,20147,California
Madera,2021-02-27,934,28967,279,11921,655,17046,0,0,494,12344,436,8300,497,20644,California
Madera,2021-02-28,196,29163,29,11950,167,17213,0,0,190,12528,6,8306,190,20834,California
Madera,2021-03-01,387,29550,123,12073,264,17477,0,0,200,12546,183,8489,201,21035,California
Madera,2021-03-02,780,30330,355,12428,424,17901,1,1,665,13100,112,8601,666,21701,California
Madera,2021-03-03,1384,31714,745,13173,639,18540,0,1,963,13674,418,9019,992,22693,California
Madera,2021-03-04,1215,32929,531,13704,684,19224,0,1,959,14381,257,9276,964,23657,California
Madera,2021-03-05,1378,34307,421,14125,945,20169,12,13,1087,15204,288,9564,1111,24768,California
Madera,2021-03-06,828,35135,644,14769,152,20321,32,45,504,15418,322,9886,536,25304,California
Madera,2021-03-07,161,35296,26,14795,109,20430,26,71,106,15495,55,9941,132,25436,California
Madera,2021-03-08,613,35909,341,15136,212,20642,60,131,308,15559,305,10246,369,25805,California
Madera,2021-03-09,614,36523,298,15434,282,20924,34,165,416,15820,196,10442,457,26262,California
Madera,2021-03-10,1197,37720,561,15995,558,21482,78,243,760,16228,431,10873,839,27101,California
Madera,2021-03-11,1691,39411,875,16870,491,21973,325,568,773,16423,914,11787,1109,28210,California
Madera,2021-03-12,1587,40998,821,17691,615,22588,151,719,804,16626,780,12567,983,29193,California
Madera,2021-03-13,1895,42893,1337,19028,362,22950,196,915,814,16579,1076,13643,1029,30222,California
Madera,2021-03-14,587,43480,449,19477,104,23054,34,949,280,16591,302,13945,314,30536,California
Madera,2021-03-15,755,44235,235,19712,475,23529,45,994,518,16960,232,14177,601,31137,California
Madera,2021-03-16,953,45188,534,20246,372,23901,47,1041,755,17585,195,14372,820,31957,California
Madera,2021-03-17,1480,46668,985,21231,432,24333,63,1104,912,18098,557,14929,1070,33027,California
Madera,2021-03-18,1969,48637,692,21923,1210,25543,67,1171,980,18257,980,15909,1139,34166,California
Madera,2021-03-19,1603,50240,585,22508,933,26476,85,1256,1042,18906,557,16466,1206,35372,California
Madera,2021-03-20,1188,51428,778,23286,360,26836,50,1306,591,19017,594,17060,705,36077,California
Madera,2021-03-21,1121,52549,911,24197,161,26997,49,1355,364,18680,752,17812,415,36492,California
Madera,2021-03-22,1365,53914,862,25059,438,27435,65,1420,653,18738,708,18520,766,37258,California
Madera,2021-03-23,1435,55349,877,25936,472,27907,86,1506,676,18829,757,19277,848,38106,California
Madera,2021-03-24,966,56315,518,26454,416,28323,32,1538,619,19141,343,19620,655,38761,California
Madera,2021-03-25,1193,57508,542,26996,626,28949,25,1563,649,19295,533,20153,687,39448,California
Madera,2021-03-26,1528,59036,582,27578,810,29759,136,1699,724,19357,802,20955,864,40312,California
Madera,2021-03-27,939,59975,609,28187,307,30066,23,1722,409,19265,525,21480,433,40745,California
Madera,2021-03-28,443,60418,151,28338,232,30298,60,1782,207,19393,235,21715,363,41108,California
Madera,2021-03-29,703,61121,189,28527,484,30782,30,1812,501,19731,198,21913,536,41644,California
Madera,2021-03-30,1078,62199,609,29136,439,31221,30,1842,466,19620,607,22520,496,42140,California
Madera,2021-03-31,1409,63608,546,29682,732,31953,131,1973,421,19190,982,23502,552,42692,California
Madera,2021-04-01,1415,65023,632,30314,733,32686,50,2023,487,18808,917,24419,535,43227,California
Madera,2021-04-02,1612,66635,461,30775,1093,33779,58,2081,472,18210,1128,25547,530,43757,California
Madera,2021-04-03,972,67607,772,31547,181,33960,19,2100,396,18063,573,26120,426,44183,California
Madera,2021-04-04,185,67792,64,31611,119,34079,2,2102,84,18049,101,26221,87,44270,California
Madera,2021-04-05,745,68537,256,31867,429,34508,60,2162,341,18062,402,26623,415,44685,California
Madera,2021-04-06,1718,70255,890,32757,470,34978,358,2520,531,17767,1184,27807,889,45574,California
Madera,2021-04-07,1240,71495,388,33145,704,35682,148,2668,428,17541,808,28615,582,46156,California
Madera,2021-04-08,1754,73249,676,33821,812,36494,266,2934,562,17190,1184,29799,833,46989,California
Madera,2021-04-09,1667,74916,707,34528,814,37308,146,3080,958,17594,704,30503,1108,48097,California
Madera,2021-04-10,989,75905,695,35223,225,37533,69,3149,721,18115,270,30773,791,48888,California
Madera,2021-04-11,822,76727,669,35892,73,37606,80,3229,288,17951,530,31303,366,49254,California
Madera,2021-04-12,825,77552,296,36188,451,38057,78,3307,314,17834,510,31813,393,49647,California
Madera,2021-04-13,1263,78815,621,36809,599,38656,43,3350,731,18091,526,32339,783,50430,California
Madera,2021-04-14,1409,80224,868,37677,541,39197,0,3350,581,17851,826,33165,586,51016,California
Madera,2021-04-15,1191,81415,516,38193,674,39871,1,3351,425,17527,753,33918,429,51445,California
Madera,2021-04-16,1376,82791,547,38740,829,40700,0,3351,375,16917,988,34906,378,51823,California
Madera,2021-04-17,1302,84093,1094,39834,208,40908,0,3351,775,17170,522,35428,775,52598,California
Madera,2021-04-18,257,84350,219,40053,38,40946,0,3351,87,17092,165,35593,87,52685,California
Madera,2021-04-19,821,85171,247,40300,573,41519,1,3352,282,16842,532,36125,282,52967,California
Madera,2021-04-20,909,86080,455,40755,454,41973,0,3352,230,16399,675,36800,232,53199,California
Madera,2021-04-21,906,86986,496,41251,410,42383,0,3352,303,16103,601,37401,305,53504,California
Madera,2021-04-22,1124,88110,547,41798,577,42960,0,3352,387,15759,732,38133,388,53892,California
Madera,2021-04-23,1000,89110,322,42120,678,43638,0,3352,350,15464,645,38778,350,54242,California
Madera,2021-04-24,731,89841,478,42598,253,43891,0,3352,255,15247,473,39251,256,54498,California
Madera,2021-04-25,273,90114,162,42760,107,43998,4,3356,120,15223,149,39400,125,54623,California
Madera,2021-04-26,576,90690,114,42874,456,44454,6,3362,138,14933,434,39834,144,54767,California
Madera,2021-04-27,642,91332,285,43159,332,44786,25,3387,322,14964,317,40151,348,55115,California
Madera,2021-04-28,521,91853,211,43370,292,45078,18,3405,250,14963,268,40419,267,55382,California
Madera,2021-04-29,578,92431,256,43626,292,45370,30,3435,272,14968,299,40718,304,55686,California
Madera,2021-04-30,972,93403,517,44143,437,45807,18,3453,288,14597,678,41396,307,55993,California
Madera,2021-05-01,993,94396,891,45034,88,45895,14,3467,394,14410,595,41991,408,56401,California
Madera,2021-05-02,401,94797,353,45387,43,45938,5,3472,143,14300,258,42249,148,56549,California
Madera,2021-05-03,506,95303,206,45593,261,46199,39,3511,106,14048,397,42646,145,56694,California
Madera,2021-05-04,923,96226,451,46044,428,46627,44,3555,223,13615,700,43346,267,56961,California
Madera,2021-05-05,1044,97270,509,46553,476,47103,59,3614,282,13198,759,44105,342,57303,California
Madera,2021-05-06,726,97996,264,46817,429,47532,33,3647,167,12844,554,44659,200,57503,California
Madera,2021-05-07,834,98830,295,47112,518,48050,21,3668,202,12440,626,45285,222,57725,California
Madera,2021-05-08,987,99817,774,47886,203,48253,10,3678,187,11837,800,46085,197,57922,California
Madera,2021-05-09,148,99965,21,47907,116,48369,11,3689,35,11772,111,46196,46,57968,California
Madera,2021-05-10,371,100336,78,47985,278,48647,15,3704,104,11626,265,46461,119,58087,California
Madera,2021-05-11,550,100886,193,48178,348,48995,9,3713,179,11445,369,46830,188,58275,California
Madera,2021-05-12,517,101403,235,48413,245,49240,37,3750,129,11225,385,47215,165,58440,California
Madera,2021-05-13,529,101932,317,48730,180,49420,32,3782,183,11097,343,47558,215,58655,California
Madera,2021-05-14,542,102474,275,49005,243,49663,24,3806,240,11062,299,47857,264,58919,California
Madera,2021-05-15,574,103048,486,49491,79,49742,9,3815,368,11236,202,48059,376,59295,California
Madera,2021-05-16,260,103308,193,49684,36,49778,31,3846,107,11222,152,48211,138,59433,California
Madera,2021-05-17,460,103768,192,49876,238,50016,30,3876,203,11201,254,48465,233,59666,California
Madera,2021-05-18,560,104328,375,50251,161,50177,24,3900,295,11261,259,48724,319,59985,California
Madera,2021-05-19,498,104826,232,50483,244,50421,22,3922,222,11231,274,48998,244,60229,California
Madera,2021-05-20,598,105424,271,50754,289,50710,38,3960,231,11141,359,49357,269,60498,California
Madera,2021-05-21,514,105938,195,50949,290,51000,29,3989,197,11055,312,49669,226,60724,California
Madera,2021-05-22,923,106861,838,51787,73,51073,12,4001,545,11235,377,50046,557,61281,California
Madera,2021-05-23,268,107129,241,52028,17,51090,10,4011,143,11264,124,50170,153,61434,California
Madera,2021-05-24,308,107437,140,52168,127,51217,41,4052,119,11237,188,50358,161,61595,California
Madera,2021-05-25,390,107827,173,52341,184,51401,33,4085,153,11188,235,50593,186,61781,California
Madera,2021-05-26,450,108277,262,52603,165,51566,23,4108,240,11244,207,50800,263,62044,California
Madera,2021-05-27,389,108666,140,52743,211,51777,38,4146,125,11147,259,51059,162,62206,California
Madera,2021-05-28,455,109121,176,52919,251,52028,28,4174,176,11074,277,51336,204,62410,California
Madera,2021-05-29,310,109431,219,53138,73,52101,18,4192,169,11120,141,51477,187,62597,California
Madera,2021-05-30,60,109491,27,53165,29,52130,4,4196,27,11120,31,51508,31,62628,California
Madera,2021-05-31,27,109518,10,53175,13,52143,4,4200,12,11121,15,51523,16,62644,California
Madera,2021-06-01,294,109812,147,53322,123,52266,24,4224,107,11067,185,51708,131,62775,California
Madera,2021-06-02,398,110210,125,53447,250,52516,23,4247,115,10923,282,51990,138,62913,California
Madera,2021-06-03,286,110496,153,53600,118,52634,15,4262,92,10836,194,52184,107,63020,California
Madera,2021-06-04,392,110888,250,53850,130,52764,12,4274,154,10765,237,52421,166,63186,California
Madera,2021-06-05,520,111408,394,54244,113,52877,13,4287,153,10570,361,52782,166,63352,California
Madera,2021-06-06,136,111544,116,54360,13,52890,7,4294,38,10517,98,52880,45,63397,California
Madera,2021-06-07,256,111800,159,54519,76,52966,21,4315,46,10375,209,53089,67,63464,California
Madera,2021-06-08,389,112189,274,54793,94,53060,21,4336,97,10202,291,53380,118,63582,California
Madera,2021-06-09,380,112569,242,55035,110,53170,28,4364,145,10142,233,53613,173,63755,California
Madera,2021-06-10,345,112914,198,55233,131,53301,16,4380,119,10053,224,53837,135,63890,California
Madera,2021-06-11,383,113297,221,55454,129,53430,33,4413,167,10036,215,54052,198,64088,California
Madera,2021-06-12,585,113882,516,55970,54,53484,15,4428,95,9656,490,54542,110,64198,California
Madera,2021-06-13,198,114080,164,56134,29,53513,5,4433,57,9578,140,54682,62,64260,California
Madera,2021-06-14,231,114311,162,56296,44,53557,25,4458,92,9557,136,54818,115,64375,California
Madera,2021-06-15,371,114682,257,56553,81,53638,33,4491,158,9539,209,55027,191,64566,California
Madera,2021-06-16,336,115018,259,56812,64,53702,13,4504,123,9466,209,55236,136,64702,California
Madera,2021-06-17,260,115278,128,56940,123,53825,9,4513,95,9406,164,55400,104,64806,California
Madera,2021-06-18,282,115560,178,57118,80,53905,24,4537,123,9394,158,55558,146,64952,California
Madera,2021-06-19,251,115811,203,57321,40,53945,8,4545,82,9315,169,55727,90,65042,California
Madera,2021-06-20,57,115868,46,57367,3,53948,8,4553,28,9322,29,55756,36,65078,California
Madera,2021-06-21,168,116036,83,57450,61,54009,24,4577,76,9331,91,55847,100,65178,California
Madera,2021-06-22,241,116277,159,57609,63,54072,19,4596,119,9348,120,55967,137,65315,California
Madera,2021-06-23,263,116540,189,57798,64,54136,10,4606,141,9377,122,56089,151,65466,California
Madera,2021-06-24,220,116760,103,57901,95,54231,22,4628,81,9342,138,56227,103,65569,California
Madera,2021-06-25,262,117022,169,58070,69,54300,24,4652,101,9309,158,56385,125,65694,California
Madera,2021-06-26,190,117212,142,58212,34,54334,14,4666,80,9293,110,56495,94,65788,California
Madera,2021-06-27,118,117330,93,58305,21,54355,4,4670,64,9307,54,56549,68,65856,California
Madera,2021-06-28,160,117490,96,58401,44,54399,20,4690,82,9333,77,56626,103,65959,California
Madera,2021-06-29,215,117705,152,58553,46,54445,17,4707,100,9336,114,56740,117,66076,California
Madera,2021-06-30,225,117930,149,58702,69,54514,7,4714,129,9379,94,56834,137,66213,California
Madera,2021-07-01,192,118122,121,58823,46,54560,25,4739,80,9373,111,56945,105,66318,California
Madera,2021-07-02,231,118353,173,58996,41,54601,17,4756,95,9349,136,57081,112,66430,California
Madera,2021-07-03,169,118522,118,59114,42,54643,9,4765,79,9350,87,57168,88,66518,California
Madera,2021-07-04,10,118532,0,59114,6,54649,4,4769,6,9356,4,57172,10,66528,California
Madera,2021-07-05,120,118652,102,59216,9,54658,9,4778,56,9359,62,57234,65,66593,California
Madera,2021-07-06,356,119008,256,59472,73,54731,27,4805,145,9320,210,57444,171,66764,California
Madera,2021-07-07,217,119225,153,59625,47,54778,17,4822,103,9325,114,57558,119,66883,California
Madera,2021-07-08,207,119432,131,59756,61,54839,15,4837,114,9362,92,57650,129,67012,California
Madera,2021-07-09,282,119714,206,59962,60,54899,16,4853,150,9397,130,57780,165,67177,California
Madera,2021-07-10,165,119879,125,60087,36,54935,4,4857,85,9408,79,57859,90,67267,California
Madera,2021-07-11,74,119953,57,60144,12,54947,5,4862,36,9411,38,57897,41,67308,California
Madera,2021-07-12,131,120084,98,60242,27,54974,6,4868,64,9414,67,57964,70,67378,California
Madera,2021-07-13,202,120286,156,60398,34,55008,12,4880,107,9439,94,58058,119,67497,California
Madera,2021-07-14,170,120456,126,60524,39,55047,5,4885,73,9420,97,58155,78,67575,California
Madera,2021-07-15,143,120599,89,60613,48,55095,6,4891,88,9459,55,58210,94,67669,California
Madera,2021-07-16,180,120779,138,60751,39,55134,3,4894,96,9475,83,58293,99,67768,California
Madera,2021-07-17,131,120910,102,60853,20,55154,9,4903,60,9474,71,58364,70,67838,California
Madera,2021-07-18,100,121010,86,60939,11,55165,3,4906,55,9487,45,58409,58,67896,California
Madera,2021-07-19,171,121181,134,61073,34,55199,3,4909,100,9520,70,58479,103,67999,California
Madera,2021-07-20,253,121434,176,61249,62,55261,15,4924,128,9540,123,58602,143,68142,California
Madera,2021-07-21,267,121701,176,61425,73,55334,18,4942,138,9569,127,58729,156,68298,California
Madera,2021-07-22,157,121858,111,61536,41,55375,5,4947,87,9593,68,58797,92,68390,California
Madera,2021-07-23,222,122080,169,61705,40,55415,13,4960,131,9646,91,58888,144,68534,California
Madera,2021-07-24,207,122287,158,61863,46,55461,3,4963,119,9682,86,58974,122,68656,California
Madera,2021-07-25,94,122381,73,61936,19,55480,2,4965,71,9732,23,58997,73,68729,California
Madera,2021-07-26,228,122609,153,62089,55,55535,20,4985,136,9796,92,59089,156,68885,California
Madera,2021-07-27,292,122901,221,62310,55,55590,16,5001,183,9886,108,59197,198,69083,California
Madera,2021-07-28,308,123209,192,62502,87,55677,29,5030,170,9948,137,59334,199,69282,California
Madera,2021-07-29,262,123471,187,62689,67,55744,8,5038,155,10005,106,59440,163,69445,California
Madera,2021-07-30,348,123819,261,62950,65,55809,22,5060,209,10099,137,59577,231,69676,California
Madera,2021-07-31,265,124084,199,63149,47,55856,19,5079,164,10182,100,59677,183,69859,California
Madera,2021-08-01,76,124160,58,63207,15,55871,3,5082,51,10213,24,59701,55,69914,California
Madera,2021-08-02,254,124414,166,63373,71,55942,17,5099,170,10320,80,59781,187,70101,California
Madera,2021-08-03,312,124726,243,63616,59,56001,10,5109,212,10445,97,59878,222,70323,California
Madera,2021-08-04,274,125000,186,63802,77,56078,11,5120,185,10552,89,59967,196,70519,California
Madera,2021-08-05,279,125279,189,63991,72,56150,18,5138,176,10644,102,60069,194,70713,California
Madera,2021-08-06,401,125680,306,64297,78,56228,17,5155,278,10818,121,60190,295,71008,California
Madera,2021-08-07,259,125939,201,64498,50,56278,8,5163,168,10904,89,60279,175,71183,California
Madera,2021-08-08,145,126084,117,64615,22,56300,6,5169,92,10949,53,60332,98,71281,California
Madera,2021-08-09,298,126382,215,64830,63,56363,20,5189,184,11040,113,60445,204,71485,California
Madera,2021-08-10,278,126660,205,65035,61,56424,12,5201,175,11124,103,60548,187,71672,California
Madera,2021-08-11,407,127067,315,65350,74,56498,18,5219,278,11296,124,60672,296,71968,California
Madera,2021-08-12,392,127459,306,65656,74,56572,12,5231,279,11476,111,60783,291,72259,California
Madera,2021-08-13,438,127897,325,65981,105,56677,8,5239,313,11677,120,60903,321,72580,California
Madera,2021-08-14,219,128116,174,66155,38,56715,7,5246,114,11695,103,61006,121,72701,California
Madera,2021-08-15,95,128211,59,66214,32,56747,4,5250,63,11732,30,61036,67,72768,California
Madera,2021-08-16,259,128470,176,66390,75,56822,8,5258,166,11830,76,61112,174,72942,California
Madera,2021-08-17,401,128871,280,66670,105,56927,16,5274,237,11932,151,61263,253,73195,California
Madera,2021-08-18,486,129357,349,67019,124,57051,13,5287,301,12084,161,61424,313,73508,California
Madera,2021-08-19,453,129810,358,67377,89,57140,6,5293,313,12277,126,61550,319,73827,California
Madera,2021-08-20,480,130290,347,67724,107,57247,26,5319,254,12365,191,61741,279,74106,California
Madera,2021-08-21,257,130547,204,67928,50,57297,3,5322,121,12363,126,61867,124,74230,California
Madera,2021-08-22,100,130647,73,68001,26,57323,1,5323,62,12389,37,61904,63,74293,California
Madera,2021-08-23,272,130919,196,68197,70,57393,6,5329,136,12413,118,62022,142,74435,California
Madera,2021-08-24,385,131304,311,68508,67,57460,7,5336,166,12391,195,62217,173,74608,California
Madera,2021-08-25,361,131665,247,68755,96,57556,18,5354,161,12378,192,62409,179,74787,California
Madera,2021-08-26,330,131995,252,69007,70,57626,8,5362,159,12394,151,62560,167,74954,California
Madera,2021-08-27,437,132432,338,69345,93,57719,6,5368,198,12385,213,62773,204,75158,California
Madera,2021-08-28,343,132775,292,69637,48,57767,3,5371,159,12368,179,62952,162,75320,California
Madera,2021-08-29,98,132873,75,69712,22,57789,1,5372,39,12353,55,63007,40,75360,California
Madera,2021-08-30,118,132991,54,69766,58,57847,6,5378,49,12346,63,63070,56,75416,California
Marin,2020-12-15,2,2,2,2,0,0,0,0,2,2,0,0,2,2,California
Marin,2020-12-16,109,111,109,111,0,0,0,0,109,111,0,0,109,111,California
Marin,2020-12-17,280,391,280,391,0,0,0,0,280,391,0,0,280,391,California
Marin,2020-12-18,386,777,386,777,0,0,0,0,386,777,0,0,386,777,California
Marin,2020-12-19,355,1132,354,1131,1,1,0,0,355,1132,0,0,355,1132,California
Marin,2020-12-20,166,1298,164,1295,2,3,0,0,166,1298,0,0,166,1298,California
Marin,2020-12-21,238,1536,235,1530,3,6,0,0,238,1536,0,0,238,1536,California
Marin,2020-12-22,522,2058,314,1844,208,214,0,0,522,2058,0,0,522,2058,California
Marin,2020-12-23,726,2784,311,2155,415,629,0,0,726,2784,0,0,726,2784,California
Marin,2020-12-24,362,3146,159,2314,203,832,0,0,361,3145,0,0,361,3145,California
Marin,2020-12-25,25,3171,0,2314,25,857,0,0,25,3170,0,0,25,3170,California
Marin,2020-12-26,143,3314,93,2407,50,907,0,0,143,3313,0,0,143,3313,California
Marin,2020-12-27,90,3404,53,2460,37,944,0,0,90,3403,0,0,90,3403,California
Marin,2020-12-28,408,3812,98,2558,310,1254,0,0,408,3811,0,0,408,3811,California
Marin,2020-12-29,414,4226,101,2659,313,1567,0,0,414,4225,0,0,414,4225,California
Marin,2020-12-30,643,4869,402,3061,241,1808,0,0,643,4868,0,0,643,4868,California
Marin,2020-12-31,205,5074,38,3099,167,1975,0,0,204,5071,1,1,204,5072,California
Marin,2021-01-01,36,5110,17,3116,19,1994,0,0,36,5107,0,1,36,5108,California
Marin,2021-01-02,112,5222,106,3222,6,2000,0,0,112,5219,0,1,112,5220,California
Marin,2021-01-03,50,5272,30,3252,20,2020,0,0,46,5265,0,1,46,5266,California
Marin,2021-01-04,301,5573,192,3444,109,2129,0,0,300,5564,1,2,300,5566,California
Marin,2021-01-05,370,5943,220,3664,150,2279,0,0,328,5850,42,44,328,5894,California
Marin,2021-01-06,818,6761,317,3981,501,2780,0,0,637,6306,181,225,637,6531,California
Marin,2021-01-07,885,7646,500,4481,385,3165,0,0,522,6466,363,588,523,7054,California
Marin,2021-01-08,978,8624,521,5002,457,3622,0,0,585,6659,392,980,585,7639,California
Marin,2021-01-09,627,9251,225,5227,402,4024,0,0,498,7028,129,1109,498,8137,California
Marin,2021-01-10,132,9383,103,5330,29,4053,0,0,57,7010,75,1184,57,8194,California
Marin,2021-01-11,477,9860,333,5663,144,4197,0,0,253,7041,224,1408,255,8449,California
Marin,2021-01-12,928,10788,532,6195,396,4593,0,0,568,7252,357,1765,568,9017,California
Marin,2021-01-13,1178,11966,503,6698,675,5268,0,0,943,7960,235,2000,943,9960,California
Marin,2021-01-14,1073,13039,319,7017,754,6022,0,0,922,8733,149,2149,922,10882,California
Marin,2021-01-15,1165,14204,350,7367,815,6837,0,0,1034,9639,130,2279,1036,11918,California
Marin,2021-01-16,1118,15322,908,8275,210,7047,0,0,1042,10605,76,2355,1042,12960,California
Marin,2021-01-17,1232,16554,1112,9387,120,7167,0,0,1192,11761,39,2394,1195,14155,California
Marin,2021-01-18,365,16919,161,9548,204,7371,0,0,317,12030,48,2442,317,14472,California
Marin,2021-01-19,1155,18074,902,10450,253,7624,0,0,973,12822,181,2623,973,15445,California
Marin,2021-01-20,1823,19897,1219,11669,604,8228,0,0,1082,13175,730,3353,1083,16528,California
Marin,2021-01-21,1696,21593,1066,12735,630,8858,0,0,1334,14153,359,3712,1337,17865,California
Marin,2021-01-22,1713,23306,1092,13827,621,9479,0,0,1540,15521,173,3885,1541,19406,California
Marin,2021-01-23,1864,25170,1351,15178,513,9992,0,0,1773,17203,91,3976,1773,21179,California
Marin,2021-01-24,622,25792,166,15344,456,10448,0,0,587,17755,35,4011,587,21766,California
Marin,2021-01-25,1138,26930,232,15576,906,11354,0,0,696,18010,442,4453,697,22463,California
Marin,2021-01-26,1530,28460,781,16357,749,12103,0,0,1143,18767,386,4839,1143,23606,California
Marin,2021-01-27,1732,30192,897,17254,835,12938,0,0,1362,19762,368,5207,1363,24969,California
Marin,2021-01-28,2086,32278,1077,18331,1009,13947,0,0,1813,21304,272,5479,1814,26783,California
Marin,2021-01-29,2223,34501,1446,19777,777,14724,0,0,2017,23127,196,5675,2019,28802,California
Marin,2021-01-30,1724,36225,916,20693,808,15532,0,0,1643,24689,81,5756,1643,30445,California
Marin,2021-01-31,458,36683,321,21014,137,15669,0,0,430,25091,28,5784,430,30875,California
Marin,2021-02-01,1103,37786,419,21433,684,16353,0,0,899,25789,202,5986,900,31775,California
Marin,2021-02-02,1486,39272,490,21923,996,17349,0,0,817,25949,658,6644,818,32593,California
Marin,2021-02-03,1815,41087,442,22365,1373,18722,0,0,1293,26722,520,7164,1293,33886,California
Marin,2021-02-04,1599,42686,510,22875,1089,19811,0,0,991,27108,605,7769,991,34877,California
Marin,2021-02-05,2178,44864,669,23544,1509,21320,0,0,1338,27610,836,8605,1338,36215,California
Marin,2021-02-06,1426,46290,836,24380,590,21910,0,0,601,27389,822,9427,601,36816,California
Marin,2021-02-07,1308,47598,1021,25401,287,22197,0,0,497,27076,810,10237,497,37313,California
Marin,2021-02-08,1559,49157,773,26174,786,22983,0,0,738,26996,818,11055,738,38051,California
Marin,2021-02-09,1794,50951,1125,27299,669,23652,0,0,850,26903,943,11998,850,38901,California
Marin,2021-02-10,2363,53314,1498,28797,865,24517,0,0,1229,27002,1131,13129,1230,40131,California
Marin,2021-02-11,2886,56200,1645,30442,1241,25758,0,0,1459,27044,1421,14550,1463,41594,California
Marin,2021-02-12,3103,59303,1550,31992,1553,27311,0,0,1571,27089,1527,16077,1572,43166,California
Marin,2021-02-13,2334,61637,1243,33235,1091,28402,0,0,1123,27004,1208,17285,1123,44289,California
Marin,2021-02-14,832,62469,310,33545,522,28924,0,0,737,27647,95,17380,738,45027,California
Marin,2021-02-15,1239,63708,369,33914,870,29794,0,0,849,28109,388,17768,850,45877,California
Marin,2021-02-16,2505,66213,1068,34982,1437,31231,0,0,1523,28651,981,18749,1523,47400,California
Marin,2021-02-17,2140,68353,958,35940,1182,32413,0,0,1107,28728,1030,19779,1107,48507,California
Marin,2021-02-18,2439,70792,1598,37538,841,33254,0,0,1067,28429,1366,21145,1067,49574,California
Marin,2021-02-19,2829,73621,2204,39742,625,33879,0,0,1259,28136,1553,22698,1260,50834,California
Marin,2021-02-20,2688,76309,2197,41939,491,34370,0,0,1260,27977,1421,24119,1262,52096,California
Marin,2021-02-21,1372,77681,1163,43102,209,34579,0,0,966,28541,402,24521,966,53062,California
Marin,2021-02-22,1915,79596,1473,44575,442,35021,0,0,1257,29145,653,25174,1257,54319,California
Marin,2021-02-23,2990,82586,1709,46284,1281,36302,0,0,2004,30180,970,26144,2005,56324,California
Marin,2021-02-24,3674,86260,1692,47976,1982,38284,0,0,2347,31214,1314,27458,2348,58672,California
Marin,2021-02-25,4231,90491,1985,49961,2246,40530,0,0,2974,32945,1245,28703,2976,61648,California
Marin,2021-02-26,3815,94306,2078,52039,1737,42267,0,0,2751,34645,1052,29755,2752,64400,California
Marin,2021-02-27,2781,97087,1641,53680,1140,43407,0,0,1923,35719,851,30606,1925,66325,California
Marin,2021-02-28,1701,98788,962,54642,739,44146,0,0,1337,36698,358,30964,1337,67662,California
Marin,2021-03-01,2762,101550,1712,56354,1049,45195,1,1,1845,37645,900,31864,1847,69509,California
Marin,2021-03-02,2689,104239,1750,58104,938,46133,1,2,1784,38531,899,32763,1785,71294,California
Marin,2021-03-03,4519,108758,2502,60606,2013,48146,4,6,2939,39899,1575,34338,2943,74237,California
Marin,2021-03-04,3481,112239,1727,62333,1753,49899,1,7,2364,41158,1110,35448,2369,76606,California
Marin,2021-03-05,3141,115380,1197,63530,1930,51829,14,21,1825,41686,1310,36758,1838,78444,California
Marin,2021-03-06,3273,118653,2345,65875,852,52681,76,97,2677,43849,589,37347,2752,81196,California
Marin,2021-03-07,1460,120113,1193,67068,216,52897,51,148,1018,44480,437,37784,1068,82264,California
Marin,2021-03-08,1924,122037,1401,68469,394,53291,129,277,1427,45538,493,38277,1551,83815,California
Marin,2021-03-09,2286,124323,1375,69844,797,54088,114,391,1573,46508,709,38986,1679,85494,California
Marin,2021-03-10,4512,128835,2537,72381,1679,55767,296,687,3251,48793,1255,40241,3540,89034,California
Marin,2021-03-11,4615,133450,1898,74279,2583,58350,134,821,3302,50922,1303,41544,3432,92466,California
Marin,2021-03-12,4018,137468,1567,75846,2098,60448,353,1174,1562,50386,2439,43983,1903,94369,California
Marin,2021-03-13,4115,141583,2879,78725,1165,61613,71,1245,2387,51113,1719,45702,2446,96815,California
Marin,2021-03-14,2303,143886,1113,79838,1075,62688,115,1360,705,50333,1596,47298,816,97631,California
Marin,2021-03-15,3256,147142,1784,81622,1427,64115,45,1405,1190,49521,2048,49346,1236,98867,California
Marin,2021-03-16,4301,151443,2319,83941,1616,65731,366,1771,1438,48457,2858,52204,1794,100661,California
Marin,2021-03-17,4226,155669,2295,86236,1880,67611,51,1822,2024,48343,2186,54390,2072,102733,California
Marin,2021-03-18,4517,160186,2283,88519,2158,69769,76,1898,2105,48126,2395,56785,2178,104911,California
Marin,2021-03-19,4492,164678,2305,90824,1966,71735,221,2119,2304,48463,2177,58962,2514,107425,California
Marin,2021-03-20,3622,168300,2015,92839,1499,73234,108,2227,1940,48837,1670,60632,2044,109469,California
Marin,2021-03-21,1553,169853,1155,93994,376,73610,22,2249,785,48878,765,61397,806,110275,California
Marin,2021-03-22,2504,172357,2166,96160,170,73780,168,2417,905,48355,1590,62987,1067,111342,California
Marin,2021-03-23,4335,176692,2273,98433,1935,75715,127,2544,1878,47910,2449,65436,2004,113346,California
Marin,2021-03-24,4515,181207,2935,101368,1469,77184,111,2655,1780,47076,2720,68156,1886,115232,California
Marin,2021-03-25,4701,185908,2859,104227,1768,78952,74,2729,2205,46875,2477,70633,2276,117508,California
Marin,2021-03-26,4358,190266,2381,106608,1763,80715,214,2943,2387,47523,1952,72585,2600,120108,California
Marin,2021-03-27,3720,193986,2679,109287,1024,81739,17,2960,1128,46086,2581,75166,1144,121252,California
Marin,2021-03-28,2413,196399,1736,111023,671,82410,6,2966,837,45361,1568,76734,843,122095,California
Marin,2021-03-29,2713,199112,2113,113136,575,82985,25,2991,1139,44956,1569,78303,1164,123259,California
Marin,2021-03-30,4691,203803,3671,116807,987,83972,33,3024,2941,46183,1748,80051,2975,126234,California
Marin,2021-03-31,5904,209707,4176,120983,1675,85647,53,3077,2528,45398,3364,83415,2579,128813,California
Marin,2021-04-01,4496,214203,2305,123288,1936,87583,255,3332,2132,45424,2344,85759,2370,131183,California
Marin,2021-04-02,3757,217960,1866,125154,1517,89100,374,3706,1995,46019,1754,87513,2349,133532,California
Marin,2021-04-03,3869,221829,2517,127671,971,90071,381,4087,1466,45465,2390,89903,1836,135368,California
Marin,2021-04-04,1647,223476,1245,128916,203,90274,199,4286,1203,46418,442,90345,1395,136763,California
Marin,2021-04-05,2254,225730,1568,130484,306,90580,380,4666,1299,47142,949,91294,1673,138436,California
Marin,2021-04-06,4015,229745,2127,132611,1321,91901,567,5233,2221,48133,1784,93078,2775,141211,California
Marin,2021-04-07,3975,233720,1999,134610,1329,93230,647,5880,1441,47685,2524,95602,2076,143287,California
Marin,2021-04-08,5073,238793,1982,136592,2482,95712,609,6489,2316,47847,2744,98346,2906,146193,California
Marin,2021-04-09,4040,242833,1580,138172,1717,97429,743,7232,1343,47228,2690,101036,2071,148264,California
Marin,2021-04-10,3233,246066,1494,139666,1298,98727,441,7673,1451,47344,1766,102802,1882,150146,California
Marin,2021-04-11,1066,247132,812,140478,91,98818,163,7836,476,47393,587,103389,636,150782,California
Marin,2021-04-12,1761,248893,1249,141727,350,99168,162,7998,931,47657,827,104216,1091,151873,California
Marin,2021-04-13,3795,252688,2336,144063,1452,100620,7,8005,1369,46619,2414,106630,1376,153249,California
Marin,2021-04-14,4248,256936,2551,146614,1694,102314,3,8008,1726,45849,2497,109127,1727,154976,California
Marin,2021-04-15,5651,262587,3995,150609,1656,103970,0,8008,3220,46655,2415,111542,3221,158197,California
Marin,2021-04-16,4320,266907,2265,152874,2052,106022,3,8011,2095,46545,2210,113752,2100,160297,California
Marin,2021-04-17,3608,270515,2194,155068,1414,107436,0,8011,1791,46529,1810,115562,1794,162091,California
Marin,2021-04-18,3238,273753,3146,158214,92,107528,0,8011,2549,48392,686,116248,2549,164640,California
Marin,2021-04-19,2059,275812,1884,160098,174,107702,1,8012,1127,48599,923,117171,1130,165770,California
Marin,2021-04-20,3777,279589,2627,162725,1150,108852,0,8012,1446,47728,2320,119491,1449,167219,California
Marin,2021-04-21,4159,283748,3069,165794,1087,109939,3,8015,1381,46353,2757,122248,1382,168601,California
Marin,2021-04-22,4347,288095,3325,169119,1022,110961,0,8015,1503,45032,2829,125077,1508,170109,California
Marin,2021-04-23,3350,291445,1902,171021,1448,112409,0,8015,1258,44215,2076,127153,1259,171368,California
Marin,2021-04-24,2540,293985,1698,172719,842,113251,0,8015,916,43523,1609,128762,917,172285,California
Marin,2021-04-25,1404,295389,1285,174004,119,113370,0,8015,299,42727,1096,129858,300,172585,California
Marin,2021-04-26,1685,297074,1444,175448,238,113608,3,8018,403,41858,1278,131136,409,172994,California
Marin,2021-04-27,3116,300190,2246,177694,819,114427,51,8069,1013,40824,2093,133229,1059,174053,California
Marin,2021-04-28,2389,302579,1643,179337,692,115119,54,8123,744,39981,1640,134869,797,174850,California
Marin,2021-04-29,2975,305554,2037,181374,875,115994,63,8186,826,38734,2138,137007,891,175741,California
Marin,2021-04-30,2030,307584,1316,182690,627,116621,87,8273,720,38244,1299,138306,809,176550,California
Marin,2021-05-01,1874,309458,1037,183727,813,117434,24,8297,549,37503,1313,139619,572,177122,California
Marin,2021-05-02,741,310199,595,184322,115,117549,31,8328,201,37201,533,140152,231,177353,California
Marin,2021-05-03,1240,311439,1006,185328,174,117723,60,8388,245,36513,992,141144,304,177657,California
Marin,2021-05-04,3009,314448,2024,187352,891,118614,94,8482,485,34580,2513,143657,580,178237,California
Marin,2021-05-05,2816,317264,2048,189400,642,119256,126,8608,458,32813,2350,146007,583,178820,California
Marin,2021-05-06,3319,320583,2576,191976,653,119909,90,8698,431,30456,2875,148882,518,179338,California
Marin,2021-05-07,2073,322656,1558,193534,429,120338,86,8784,384,29241,1683,150565,468,179806,California
Marin,2021-05-08,2555,325211,1930,195464,503,120841,122,8906,359,27535,2188,152753,482,180288,California
Marin,2021-05-09,1004,326215,913,196377,72,120913,19,8925,117,26789,883,153636,137,180425,California
Marin,2021-05-10,1444,327659,1178,197555,195,121108,71,8996,210,25839,1229,154865,279,180704,California
Marin,2021-05-11,2374,330033,1890,199445,428,121536,56,9052,303,24132,2065,156930,358,181062,California
Marin,2021-05-12,1862,331895,1468,200913,323,121859,71,9123,297,22940,1558,158488,366,181428,California
Marin,2021-05-13,2700,334595,2310,203223,334,122193,56,9179,1428,23160,1262,159750,1482,182910,California
Marin,2021-05-14,2263,336858,1483,204706,678,122871,102,9281,893,22791,1362,161112,993,183903,California
Marin,2021-05-15,2783,339641,2301,207007,400,123271,82,9363,1685,23463,1094,162206,1766,185669,California
Marin,2021-05-16,1738,341379,1677,208684,53,123324,8,9371,1408,24551,328,162534,1416,187085,California
Marin,2021-05-17,2174,343553,2026,210710,105,123429,43,9414,1733,25894,434,162968,1777,188862,California
Marin,2021-05-18,1552,345105,1201,211911,294,123723,57,9471,800,26004,745,163713,855,189717,California
Marin,2021-05-19,1575,346680,1249,213160,254,123977,72,9543,779,26062,790,164503,848,190565,California
Marin,2021-05-20,1855,348535,1512,214672,256,124233,87,9630,761,25830,1082,165585,850,191415,California
Marin,2021-05-21,1487,350022,855,215527,582,124815,50,9680,442,25286,1036,166621,492,191907,California
Marin,2021-05-22,1448,351470,1102,216629,289,125104,57,9737,968,25838,473,167094,1025,192932,California
Marin,2021-05-23,484,351954,430,217059,42,125146,12,9749,223,25815,259,167353,236,193168,California
Marin,2021-05-24,661,352615,490,217549,129,125275,42,9791,354,25906,304,167657,395,193563,California
Marin,2021-05-25,1017,353632,639,218188,332,125607,46,9837,321,25586,684,168341,364,193927,California
Marin,2021-05-26,722,354354,490,218678,184,125791,48,9885,264,25445,453,168794,312,194239,California
Marin,2021-05-27,1043,355397,668,219346,294,126085,81,9966,339,25166,699,169493,420,194659,California
Marin,2021-05-28,1121,356518,727,220073,314,126399,80,10046,330,24790,785,170278,409,195068,California
Marin,2021-05-29,380,356898,219,220292,151,126550,10,10056,206,24832,174,170452,216,195284,California
Marin,2021-05-30,101,356999,60,220352,36,126586,5,10061,57,24851,43,170495,62,195346,California
Marin,2021-05-31,31,357030,14,220366,16,126602,1,10062,16,24854,14,170509,17,195363,California
Marin,2021-06-01,760,357790,553,220919,161,126763,46,10108,317,24778,439,170948,363,195726,California
Marin,2021-06-02,633,358423,481,221400,100,126863,52,10160,219,24640,407,171355,269,195995,California
Marin,2021-06-03,1522,359945,1351,222751,114,126977,57,10217,234,23645,1286,172641,291,196286,California
Marin,2021-06-04,1042,360987,867,223618,140,127117,35,10252,182,23006,854,173495,215,196501,California
Marin,2021-06-05,1951,362938,1729,225347,174,127291,48,10300,329,21770,1613,175108,377,196878,California
Marin,2021-06-06,1418,364356,1371,226718,13,127304,34,10334,149,20685,1268,176376,183,197061,California
Marin,2021-06-07,1956,366312,1838,228556,67,127371,51,10385,240,19267,1709,178085,291,197352,California
Marin,2021-06-08,980,367292,869,229425,71,127442,40,10425,225,18784,748,178833,265,197617,California
Marin,2021-06-09,745,368037,669,230094,66,127508,10,10435,135,18319,609,179442,144,197761,California
Marin,2021-06-10,890,368927,778,230872,61,127569,51,10486,175,17833,712,180154,226,197987,California
Marin,2021-06-11,714,369641,598,231470,84,127653,32,10518,153,17460,558,180712,185,198172,California
Marin,2021-06-12,942,370583,807,232277,91,127744,44,10562,159,16883,780,181492,203,198375,California
Marin,2021-06-13,420,371003,386,232663,22,127766,12,10574,68,16615,348,181840,80,198455,California
Marin,2021-06-14,886,371889,756,233419,82,127848,48,10622,222,16222,660,182500,267,198722,California
Marin,2021-06-15,563,372452,449,233868,87,127935,27,10649,179,16046,382,182882,206,198928,California
Marin,2021-06-16,507,372959,412,234280,47,127982,48,10697,167,15926,333,183215,213,199141,California
Marin,2021-06-17,555,373514,476,234756,48,128030,31,10728,191,15787,360,183575,221,199362,California
Marin,2021-06-18,500,374014,387,235143,76,128106,37,10765,174,15679,318,183893,210,199572,California
Marin,2021-06-19,364,374378,292,235435,36,128142,36,10801,143,15636,220,184113,177,199749,California
Marin,2021-06-20,115,374493,89,235524,15,128157,11,10812,46,15624,69,184182,57,199806,California
Marin,2021-06-21,347,374840,245,235769,47,128204,55,10867,137,15607,209,184391,192,199998,California
Marin,2021-06-22,482,375322,356,236125,95,128299,31,10898,144,15448,334,184725,175,200173,California
Marin,2021-06-23,356,375678,291,236416,32,128331,33,10931,121,15366,235,184960,153,200326,California
Marin,2021-06-24,404,376082,309,236725,45,128376,50,10981,133,15280,267,185227,181,200507,California
Marin,2021-06-25,386,376468,281,237006,60,128436,45,11026,175,15291,209,185436,220,200727,California
Marin,2021-06-26,325,376793,273,237279,20,128456,32,11058,118,15235,206,185642,150,200877,California
Marin,2021-06-27,213,377006,164,237443,23,128479,26,11084,69,15187,142,185784,94,200971,California
Marin,2021-06-28,408,377414,348,237791,32,128511,28,11112,140,15089,266,186050,168,201139,California
Marin,2021-06-29,451,377865,351,238142,60,128571,40,11152,160,15002,287,186337,200,201339,California
Marin,2021-06-30,273,378138,232,238374,26,128597,15,11167,115,14976,156,186493,130,201469,California
Marin,2021-07-01,280,378418,211,238585,49,128646,20,11187,113,14946,163,186656,133,201602,California
Marin,2021-07-02,378,378796,295,238880,45,128691,38,11225,152,14913,222,186878,189,201791,California
Marin,2021-07-03,280,379076,227,239107,23,128714,30,11255,117,14897,163,187041,147,201938,California
Marin,2021-07-05,119,379195,92,239199,11,128725,16,11271,40,14874,78,187119,55,201993,California
Marin,2021-07-06,457,379652,360,239559,56,128781,41,11312,164,14789,288,187407,203,202196,California
Marin,2021-07-07,229,379881,186,239745,28,128809,15,11327,93,14762,133,187540,106,202302,California
Marin,2021-07-08,286,380167,228,239973,37,128846,21,11348,104,14709,178,187718,125,202427,California
Marin,2021-07-09,343,380510,277,240250,32,128878,34,11382,140,14681,201,187919,173,202600,California
Marin,2021-07-10,300,380810,240,240490,25,128903,35,11417,119,14654,181,188100,154,202754,California
Marin,2021-07-11,103,380913,81,240571,8,128911,14,11431,35,14634,68,188168,48,202802,California
Marin,2021-07-12,394,381307,292,240863,45,128956,57,11488,131,14563,260,188428,189,202991,California
Marin,2021-07-13,318,381625,244,241107,44,129000,30,11518,136,14552,176,188604,165,203156,California
Marin,2021-07-14,174,381799,130,241237,32,129032,12,11530,71,14536,98,188702,82,203238,California
Marin,2021-07-15,297,382096,228,241465,37,129069,32,11562,134,14544,157,188859,165,203403,California
Marin,2021-07-16,324,382420,243,241708,57,129126,24,11586,127,14501,193,189052,150,203553,California
Marin,2021-07-17,210,382630,171,241879,22,129148,17,11603,88,14484,122,189174,105,203658,California
Marin,2021-07-18,126,382756,92,241971,12,129160,22,11625,56,14493,69,189243,78,203736,California
Marin,2021-07-19,310,383066,256,242227,37,129197,17,11642,144,14494,159,189402,160,203896,California
Marin,2021-07-20,369,383435,280,242507,54,129251,35,11677,163,14495,196,189598,197,204093,California
Marin,2021-07-21,235,383670,187,242694,36,129287,12,11689,122,14520,108,189706,133,204226,California
Marin,2021-07-22,310,383980,218,242912,54,129341,38,11727,150,14554,154,189860,188,204414,California
Marin,2021-07-23,303,384283,234,243146,52,129393,17,11744,146,14564,153,190013,163,204577,California
Marin,2021-07-24,237,384520,207,243353,16,129409,14,11758,100,14547,131,190144,114,204691,California
Marin,2021-07-25,67,384587,48,243401,12,129421,7,11765,42,14572,22,190166,47,204738,California
Marin,2021-07-26,253,384840,170,243571,52,129473,31,11796,151,14654,99,190265,181,204919,California
Marin,2021-07-27,315,385155,237,243808,52,129525,26,11822,165,14698,147,190412,191,205110,California
Marin,2021-07-28,238,385393,185,243993,29,129554,24,11846,128,14743,107,190519,152,205262,California
Marin,2021-07-29,278,385671,201,244194,47,129601,30,11876,124,14750,145,190664,152,205414,California
Marin,2021-07-30,344,386015,249,244443,59,129660,36,11912,178,14806,157,190821,213,205627,California
Marin,2021-07-31,287,386302,220,244663,31,129691,36,11948,129,14814,155,190976,163,205790,California
Marin,2021-08-01,114,386416,82,244745,22,129713,10,11958,66,14848,40,191016,74,205864,California
Marin,2021-08-02,344,386760,257,245002,59,129772,28,11986,189,14918,146,191162,216,206080,California
Marin,2021-08-03,415,387175,308,245310,81,129853,26,12012,221,14979,184,191346,245,206325,California
Marin,2021-08-04,288,387463,204,245514,48,129901,36,12048,149,15036,127,191473,184,206509,California
Marin,2021-08-05,337,387800,256,245770,53,129954,28,12076,171,15080,155,191628,199,206708,California
Marin,2021-08-06,328,388128,250,246020,66,130020,12,12088,167,15113,146,191774,179,206887,California
Marin,2021-08-07,254,388382,176,246196,39,130059,39,12127,138,15181,109,191883,177,207064,California
Marin,2021-08-08,147,388529,101,246297,26,130085,20,12147,75,15206,70,191953,95,207159,California
Marin,2021-08-09,411,388940,339,246636,50,130135,22,12169,226,15280,174,192127,248,207407,California
Marin,2021-08-10,328,389268,256,246892,55,130190,17,12186,176,15326,146,192273,192,207599,California
Marin,2021-08-11,253,389521,201,247093,34,130224,18,12204,122,15346,120,192393,140,207739,California
Marin,2021-08-12,341,389862,251,247344,49,130273,41,12245,158,15375,169,192562,198,207937,California
Marin,2021-08-13,313,390175,215,247559,72,130345,26,12271,137,15392,145,192707,162,208099,California
Marin,2021-08-14,333,390508,227,247786,68,130413,38,12309,142,15455,117,192824,180,208279,California
Marin,2021-08-15,215,390723,132,247918,71,130484,12,12321,63,15461,69,192893,75,208354,California
Marin,2021-08-16,541,391264,348,248266,163,130647,30,12351,190,15488,192,193085,219,208573,California
Marin,2021-08-17,561,391825,371,248637,156,130803,34,12385,205,15538,190,193275,240,208813,California
Marin,2021-08-18,395,392220,262,248899,119,130922,14,12399,105,15543,114,193389,119,208932,California
Marin,2021-08-19,515,392735,336,249235,161,131083,18,12417,150,15576,135,193524,168,209100,California
Marin,2021-08-20,630,393365,374,249609,230,131313,26,12443,154,15583,171,193695,178,209278,California
Marin,2021-08-21,1139,394504,689,250298,428,131741,22,12465,162,15619,148,193843,184,209462,California
Marin,2021-08-22,261,394765,202,250500,57,131798,2,12467,48,15612,57,193900,50,209512,California
Marin,2021-08-23,603,395368,398,250898,177,131975,28,12495,156,15594,202,194102,184,209696,California
Marin,2021-08-24,566,395934,370,251268,180,132155,16,12511,152,15564,199,194301,169,209865,California
Marin,2021-08-25,483,396417,315,251583,144,132299,24,12535,115,15545,156,194457,137,210002,California
Marin,2021-08-26,550,396967,354,251937,169,132468,27,12562,112,15515,169,194626,139,210141,California
Marin,2021-08-27,480,397447,321,252258,147,132615,12,12574,113,15484,155,194781,124,210265,California
Marin,2021-08-28,1006,398453,623,252881,351,132966,32,12606,160,15486,190,194971,192,210457,California
Marin,2021-08-29,163,398616,103,252984,60,133026,0,12606,52,15497,41,195012,52,210509,California
Marin,2021-08-30,467,399083,289,253273,165,133191,13,12619,97,15443,164,195176,110,210619,California
Mariposa,2020-12-17,39,39,39,39,0,0,0,0,41,41,0,0,41,41,California
Mariposa,2020-12-18,55,94,55,94,0,0,0,0,56,97,0,0,56,97,California
Mariposa,2020-12-20,2,96,2,96,0,0,0,0,2,99,0,0,2,99,California
Mariposa,2020-12-21,49,145,49,145,0,0,0,0,53,152,0,0,53,152,California
Mariposa,2020-12-22,6,151,6,151,0,0,0,0,6,158,0,0,6,158,California
Mariposa,2020-12-23,17,168,17,168,0,0,0,0,17,175,0,0,17,175,California
Mariposa,2020-12-24,1,169,0,168,1,1,0,0,0,175,1,1,1,176,California
Mariposa,2020-12-26,1,170,1,169,0,1,0,0,1,176,0,1,1,177,California
Mariposa,2020-12-27,1,171,0,169,1,2,0,0,1,177,0,1,1,178,California
Mariposa,2020-12-28,5,176,3,172,2,4,0,0,5,182,0,1,5,183,California
Mariposa,2020-12-29,34,210,3,175,31,35,0,0,34,216,0,1,34,217,California
Mariposa,2020-12-30,27,237,5,180,22,57,0,0,27,243,0,1,27,244,California
Mariposa,2020-12-31,17,254,0,180,17,74,0,0,17,260,0,1,17,261,California
Mariposa,2021-01-01,1,255,0,180,1,75,0,0,1,261,0,1,1,262,California
Mariposa,2021-01-02,1,256,1,181,0,75,0,0,1,262,0,1,1,263,California
Mariposa,2021-01-04,11,267,2,183,9,84,0,0,11,273,0,1,11,274,California
Mariposa,2021-01-05,25,292,15,198,10,94,0,0,15,278,10,11,15,289,California
Mariposa,2021-01-06,8,300,4,202,4,98,0,0,5,280,3,14,5,294,California
Mariposa,2021-01-07,54,354,47,249,7,105,0,0,8,242,46,60,8,302,California
Mariposa,2021-01-08,112,466,80,329,32,137,0,0,36,202,76,136,36,338,California
Mariposa,2021-01-11,33,499,11,340,22,159,0,0,25,219,8,144,25,363,California
Mariposa,2021-01-12,19,518,4,344,15,174,0,0,15,230,4,148,15,378,California
Mariposa,2021-01-13,23,541,5,349,18,192,0,0,19,245,4,152,19,397,California
Mariposa,2021-01-14,76,617,7,356,69,261,0,0,70,309,6,158,70,467,California
Mariposa,2021-01-15,69,686,27,383,42,303,0,0,59,358,10,168,59,526,California
Mariposa,2021-01-16,14,700,2,385,12,315,0,0,13,370,1,169,13,539,California
Mariposa,2021-01-17,6,706,1,386,5,320,0,0,5,374,1,170,5,544,California
Mariposa,2021-01-18,5,711,4,390,1,321,0,0,3,375,2,172,3,547,California
Mariposa,2021-01-19,8,719,5,395,3,324,0,0,5,378,2,174,5,552,California
Mariposa,2021-01-20,23,742,1,396,22,346,0,0,22,399,1,175,22,574,California
Mariposa,2021-01-21,67,809,9,405,58,404,0,0,62,456,5,180,62,636,California
Mariposa,2021-01-22,60,869,5,410,55,459,0,0,60,516,0,180,60,696,California
Mariposa,2021-01-23,117,986,2,412,115,574,0,0,115,629,2,182,115,811,California
Mariposa,2021-01-24,2,988,2,414,0,574,0,0,2,631,0,182,2,813,California
Mariposa,2021-01-25,3,991,1,415,2,576,0,0,0,628,3,185,0,813,California
Mariposa,2021-01-26,41,1032,4,419,37,613,0,0,4,601,37,222,10,823,California
Mariposa,2021-01-27,26,1058,2,421,24,637,0,0,11,599,14,236,12,835,California
Mariposa,2021-01-28,127,1185,3,424,124,761,0,0,113,700,13,249,114,949,California
Mariposa,2021-01-29,94,1279,22,446,72,833,0,0,92,791,2,251,93,1042,California
Mariposa,2021-01-30,10,1289,2,448,8,841,0,0,4,794,6,257,9,1051,California
Mariposa,2021-02-01,96,1385,33,481,63,904,0,0,73,844,23,280,73,1124,California
Mariposa,2021-02-02,14,1399,3,484,11,915,0,0,8,846,6,286,8,1132,California
Mariposa,2021-02-03,24,1423,1,485,23,938,0,0,12,850,11,297,15,1147,California
Mariposa,2021-02-04,101,1524,8,493,93,1031,0,0,94,940,6,303,96,1243,California
Mariposa,2021-02-05,197,1721,7,500,190,1221,0,0,163,1074,34,337,168,1411,California
Mariposa,2021-02-06,12,1733,4,504,8,1229,0,0,9,1082,3,340,11,1422,California
Mariposa,2021-02-07,1,1734,0,504,1,1230,0,0,1,1083,0,340,1,1423,California
Mariposa,2021-02-08,43,1777,4,508,39,1269,0,0,23,1086,20,360,23,1446,California
Mariposa,2021-02-09,45,1822,25,533,20,1289,0,0,38,1117,7,367,38,1484,California
Mariposa,2021-02-10,31,1853,4,537,27,1316,0,0,16,1128,14,381,25,1509,California
Mariposa,2021-02-11,391,2244,7,544,384,1700,0,0,372,1484,19,400,375,1884,California
Mariposa,2021-02-12,195,2439,10,554,185,1885,0,0,147,1583,48,448,147,2031,California
Mariposa,2021-02-13,12,2451,3,557,9,1894,0,0,10,1591,2,450,10,2041,California
Mariposa,2021-02-14,12,2463,4,561,8,1902,0,0,6,1591,6,456,6,2047,California
Mariposa,2021-02-15,11,2474,4,565,7,1909,0,0,9,1598,2,458,9,2056,California
Mariposa,2021-02-16,61,2535,37,602,24,1933,0,0,37,1612,24,482,38,2094,California
Mariposa,2021-02-17,37,2572,9,611,28,1961,0,0,29,1635,7,489,30,2124,California
Mariposa,2021-02-18,62,2634,7,618,55,2016,0,0,25,1623,37,526,25,2149,California
Mariposa,2021-02-19,84,2718,4,622,80,2096,0,0,74,1688,10,536,75,2224,California
Mariposa,2021-02-20,266,2984,7,629,259,2355,0,0,232,1888,32,568,232,2456,California
Mariposa,2021-02-21,248,3232,5,634,243,2598,0,0,245,2131,2,570,245,2701,California
Mariposa,2021-02-22,27,3259,11,645,16,2614,0,0,22,2149,4,574,22,2723,California
Mariposa,2021-02-23,45,3304,38,683,7,2621,0,0,26,2157,18,592,26,2749,California
Mariposa,2021-02-24,23,3327,3,686,20,2641,0,0,10,2156,11,603,10,2759,California
Mariposa,2021-02-25,19,3346,9,695,10,2651,0,0,12,2161,7,610,12,2771,California
Mariposa,2021-02-26,441,3787,7,702,434,3085,0,0,371,2465,68,678,372,3143,California
Mariposa,2021-02-27,186,3973,6,708,180,3265,0,0,175,2634,6,684,175,3318,California
Mariposa,2021-02-28,1,3974,1,709,0,3265,0,0,0,2633,1,685,0,3318,California
Mariposa,2021-03-01,88,4062,26,735,62,3327,0,0,18,2583,68,753,18,3336,California
Mariposa,2021-03-02,19,4081,12,747,7,3334,0,0,10,2585,8,761,10,3346,California
Mariposa,2021-03-03,74,4155,5,752,69,3403,0,0,65,2646,5,766,66,3412,California
Mariposa,2021-03-04,47,4202,11,763,36,3439,0,0,23,2647,23,789,24,3436,California
Mariposa,2021-03-05,68,4270,10,773,58,3497,0,0,40,2673,23,812,49,3485,California
Mariposa,2021-03-06,20,4290,9,782,11,3508,0,0,9,2674,9,821,10,3495,California
Mariposa,2021-03-07,1,4291,1,783,0,3508,0,0,0,2673,1,822,0,3495,California
Mariposa,2021-03-08,42,4333,4,787,27,3535,11,11,12,2666,30,852,23,3518,California
Mariposa,2021-03-09,46,4379,18,805,18,3553,10,21,15,2660,31,883,25,3543,California
Mariposa,2021-03-10,36,4415,12,817,14,3567,10,31,10,2656,24,907,20,3563,California
Mariposa,2021-03-11,474,4889,8,825,445,4012,21,52,218,2643,255,1162,242,3805,California
Mariposa,2021-03-12,263,5152,9,834,226,4238,28,80,113,2632,150,1312,139,3944,California
Mariposa,2021-03-13,37,5189,8,842,14,4252,15,95,12,2633,25,1337,26,3970,California
Mariposa,2021-03-14,18,5207,2,844,5,4257,11,106,2,2631,15,1352,13,3983,California
Mariposa,2021-03-15,80,5287,10,854,31,4288,39,145,33,2654,47,1399,70,4053,California
Mariposa,2021-03-16,85,5372,35,889,15,4303,35,180,26,2655,59,1458,60,4113,California
Mariposa,2021-03-17,74,5446,11,900,55,4358,8,188,53,2696,20,1478,61,4174,California
Mariposa,2021-03-18,69,5515,15,915,45,4403,9,197,41,2718,28,1506,50,4224,California
Mariposa,2021-03-19,342,5857,14,929,321,4724,7,204,301,2986,41,1547,309,4533,California
Mariposa,2021-03-20,433,6290,6,935,425,5149,2,206,35,2631,397,1944,42,4575,California
Mariposa,2021-03-21,16,6306,8,943,7,5156,1,207,9,2635,6,1950,10,4585,California
Mariposa,2021-03-22,42,6348,10,953,24,5180,8,215,29,2661,13,1963,39,4624,California
Mariposa,2021-03-23,58,6406,38,991,10,5190,10,225,37,2687,21,1984,47,4671,California
Mariposa,2021-03-24,60,6466,6,997,52,5242,2,227,53,2735,7,1991,55,4726,California
Mariposa,2021-03-25,77,6543,16,1013,53,5295,8,235,53,2774,22,2013,61,4787,California
Mariposa,2021-03-26,499,7042,10,1023,488,5783,1,236,245,2766,254,2267,246,5033,California
Mariposa,2021-03-27,238,7280,9,1032,229,6012,0,236,87,2704,151,2418,89,5122,California
Mariposa,2021-03-28,5,7285,0,1032,2,6014,3,239,1,2704,4,2422,4,5126,California
Mariposa,2021-03-29,19,7304,5,1037,14,6028,0,239,11,2707,8,2430,11,5137,California
Mariposa,2021-03-30,38,7342,13,1050,9,6037,16,255,15,2715,23,2453,31,5168,California
Mariposa,2021-03-31,95,7437,15,1065,70,6107,10,265,70,2770,25,2478,80,5248,California
Mariposa,2021-04-01,57,7494,12,1077,36,6143,9,274,35,2792,22,2500,44,5292,California
Mariposa,2021-04-02,354,7848,15,1092,335,6478,4,278,308,3059,45,2545,312,5604,California
Mariposa,2021-04-03,11,7859,8,1100,3,6481,0,278,6,3060,5,2550,6,5610,California
Mariposa,2021-04-04,2,7861,1,1101,0,6481,1,279,0,3059,2,2552,1,5611,California
Mariposa,2021-04-05,36,7897,23,1124,9,6490,4,283,16,3059,20,2572,20,5631,California
Mariposa,2021-04-06,45,7942,20,1144,9,6499,16,299,14,3059,30,2602,30,5661,California
Mariposa,2021-04-07,100,8042,9,1153,73,6572,18,317,30,3037,70,2672,48,5709,California
Mariposa,2021-04-08,283,8325,16,1169,248,6820,19,336,147,3070,134,2806,167,5876,California
Mariposa,2021-04-09,38,8363,8,1177,15,6835,15,351,9,3065,29,2835,24,5900,California
Mariposa,2021-04-10,205,8568,7,1184,189,7024,9,360,190,3251,13,2848,199,6099,California
Mariposa,2021-04-11,123,8691,3,1187,118,7142,2,362,58,3247,65,2913,61,6160,California
Mariposa,2021-04-12,43,8734,14,1201,27,7169,2,364,13,3233,29,2942,15,6175,California
Mariposa,2021-04-13,58,8792,49,1250,9,7178,0,364,34,3243,24,2966,34,6209,California
Mariposa,2021-04-14,114,8906,9,1259,105,7283,0,364,57,3244,56,3022,57,6266,California
Mariposa,2021-04-15,65,8971,21,1280,44,7327,0,364,45,3272,17,3039,45,6311,California
Mariposa,2021-04-16,382,9353,15,1295,367,7694,0,364,106,3104,275,3314,107,6418,California
Mariposa,2021-04-17,9,9362,5,1300,4,7698,0,364,7,3109,2,3316,7,6425,California
Mariposa,2021-04-18,8,9370,0,1300,8,7706,0,364,3,3107,5,3321,3,6428,California
Mariposa,2021-04-19,60,9430,27,1327,33,7739,0,364,32,3113,26,3347,32,6460,California
Mariposa,2021-04-20,62,9492,48,1375,14,7753,0,364,37,3127,23,3370,37,6497,California
Mariposa,2021-04-21,93,9585,15,1390,78,7831,0,364,41,3117,51,3421,41,6538,California
Mariposa,2021-04-22,50,9635,11,1401,39,7870,0,364,37,3142,12,3433,37,6575,California
Mariposa,2021-04-23,318,9953,73,1474,245,8115,0,364,144,3114,174,3607,146,6721,California
Mariposa,2021-04-24,110,10063,10,1484,100,8215,0,364,42,3089,67,3674,42,6763,California
Mariposa,2021-04-26,17,10080,12,1496,5,8220,0,364,6,3084,11,3685,6,6769,California
Mariposa,2021-04-27,34,10114,17,1513,15,8235,2,366,15,3085,16,3701,17,6786,California
Mariposa,2021-04-28,77,10191,14,1527,56,8291,7,373,27,3069,50,3751,34,6820,California
Mariposa,2021-04-29,84,10275,12,1539,71,8362,1,374,78,3142,6,3757,79,6899,California
Mariposa,2021-04-30,212,10487,5,1544,202,8564,5,379,62,3059,150,3907,67,6966,California
Mariposa,2021-05-01,6,10493,4,1548,2,8566,0,379,1,3055,5,3912,1,6967,California
Mariposa,2021-05-02,4,10497,2,1550,1,8567,1,380,0,3052,4,3916,1,6968,California
Mariposa,2021-05-03,16,10513,12,1562,3,8570,1,381,7,3051,9,3925,8,6976,California
Mariposa,2021-05-04,52,10565,31,1593,17,8587,4,385,37,3078,14,3939,41,7017,California
Mariposa,2021-05-05,57,10622,9,1602,46,8633,2,387,18,3059,39,3978,20,7037,California
Mariposa,2021-05-06,60,10682,38,1640,17,8650,5,392,41,3086,19,3997,46,7083,California
Mariposa,2021-05-07,27,10709,8,1648,16,8666,3,395,12,3086,15,4012,15,7098,California
Mariposa,2021-05-08,283,10992,7,1655,276,8942,0,395,32,2869,251,4263,34,7132,California
Mariposa,2021-05-09,3,10995,1,1656,2,8944,0,395,0,2866,3,4266,0,7132,California
Mariposa,2021-05-10,21,11016,10,1666,9,8953,2,397,4,2856,16,4282,6,7138,California
Mariposa,2021-05-11,29,11045,17,1683,11,8964,1,398,21,2871,7,4289,22,7160,California
Mariposa,2021-05-12,68,11113,4,1687,58,9022,6,404,6,2821,62,4351,12,7172,California
Mariposa,2021-05-13,49,11162,8,1695,39,9061,2,406,13,2800,36,4387,15,7187,California
Mariposa,2021-05-14,249,11411,121,1816,121,9182,7,413,118,2794,131,4518,125,7312,California
Mariposa,2021-05-15,20,11431,9,1825,8,9190,3,416,11,2800,7,4525,13,7325,California
Mariposa,2021-05-16,3,11434,1,1826,1,9191,1,417,1,2800,2,4527,2,7327,California
Mariposa,2021-05-17,18,11452,7,1833,7,9198,4,421,7,2799,11,4538,10,7337,California
Mariposa,2021-05-18,64,11516,43,1876,16,9214,5,426,46,2834,16,4554,51,7388,California
Mariposa,2021-05-19,71,11587,32,1908,37,9251,2,428,52,2870,18,4572,54,7442,California
Mariposa,2021-05-20,34,11621,18,1926,14,9265,2,430,13,2864,21,4593,15,7457,California
Mariposa,2021-05-21,94,11715,9,1935,83,9348,2,432,43,2860,49,4642,45,7502,California
Mariposa,2021-05-22,48,11763,7,1942,40,9388,1,433,18,2849,30,4672,19,7521,California
Mariposa,2021-05-23,3,11766,2,1944,0,9388,1,434,2,2851,1,4673,3,7524,California
Mariposa,2021-05-24,15,11781,8,1952,5,9393,2,436,9,2856,6,4679,11,7535,California
Mariposa,2021-05-25,26,11807,16,1968,10,9403,0,436,18,2866,8,4687,18,7553,California
Mariposa,2021-05-26,34,11841,4,1972,27,9430,3,439,28,2891,6,4693,31,7584,California
Mariposa,2021-05-27,122,11963,64,2036,57,9487,1,440,62,2894,60,4753,63,7647,California
Mariposa,2021-05-28,65,12028,4,2040,57,9544,4,444,24,2881,41,4794,28,7675,California
Mariposa,2021-05-29,7,12035,1,2041,5,9549,1,445,3,2883,2,4796,4,7679,California
Mariposa,2021-05-30,1,12036,0,2041,0,9549,1,446,0,2883,1,4797,1,7680,California
Mariposa,2021-05-31,2,12038,0,2041,1,9550,1,447,0,2882,2,4799,1,7681,California
Mariposa,2021-06-01,14,12052,3,2044,11,9561,0,447,5,2878,9,4808,5,7686,California
Mariposa,2021-06-02,27,12079,14,2058,8,9569,5,452,7,2871,19,4827,12,7698,California
Mariposa,2021-06-03,20,12099,10,2068,7,9576,3,455,7,2868,13,4840,10,7708,California
Mariposa,2021-06-04,90,12189,80,2148,8,9584,2,457,27,2835,61,4901,28,7736,California
Mariposa,2021-06-05,29,12218,3,2151,24,9608,2,459,7,2822,22,4923,9,7745,California
Mariposa,2021-06-06,4,12222,3,2154,0,9608,1,460,1,2821,3,4926,2,7747,California
Mariposa,2021-06-07,9,12231,4,2158,5,9613,0,460,3,2819,5,4931,3,7750,California
Mariposa,2021-06-08,48,12279,34,2192,12,9625,2,462,16,2805,32,4963,18,7768,California
Mariposa,2021-06-09,28,12307,21,2213,2,9627,5,467,6,2794,22,4985,11,7779,California
Mariposa,2021-06-10,16,12323,8,2221,5,9632,3,470,6,2794,10,4995,10,7789,California
Mariposa,2021-06-11,44,12367,13,2234,23,9655,8,478,10,2778,34,5029,18,7807,California
Mariposa,2021-06-12,17,12384,11,2245,5,9660,1,479,3,2767,14,5043,3,7810,California
Mariposa,2021-06-13,1,12385,0,2245,0,9660,1,480,0,2767,1,5044,1,7811,California
Mariposa,2021-06-14,13,12398,4,2249,8,9668,1,481,5,2765,8,5052,6,7817,California
Mariposa,2021-06-15,24,12422,12,2261,11,9679,1,482,7,2756,17,5069,8,7825,California
Mariposa,2021-06-16,28,12450,12,2273,15,9694,1,483,8,2745,20,5089,9,7834,California
Mariposa,2021-06-17,12,12462,6,2279,6,9700,0,483,4,2741,8,5097,4,7838,California
Mariposa,2021-06-18,68,12530,49,2328,16,9716,3,486,33,2742,34,5131,35,7873,California
Mariposa,2021-06-19,17,12547,5,2333,12,9728,0,486,5,2735,12,5143,5,7878,California
Mariposa,2021-06-20,1,12548,1,2334,0,9728,0,486,1,2736,0,5143,1,7879,California
Mariposa,2021-06-21,11,12559,4,2338,7,9735,0,486,7,2740,3,5146,7,7886,California
Mariposa,2021-06-22,24,12583,10,2348,11,9746,3,489,14,2747,10,5156,17,7903,California
Mariposa,2021-06-23,9,12592,3,2351,3,9749,3,492,5,2751,4,5160,8,7911,California
Mariposa,2021-06-24,12,12604,5,2356,7,9756,0,492,6,2751,6,5166,6,7917,California
Mariposa,2021-06-25,51,12655,23,2379,27,9783,1,493,18,2738,32,5198,19,7936,California
Mariposa,2021-06-26,5,12660,4,2383,1,9784,0,493,2,2737,3,5201,2,7938,California
Mariposa,2021-06-27,2,12662,1,2384,0,9784,1,494,0,2736,2,5203,1,7939,California
Mariposa,2021-06-28,4,12666,4,2388,0,9784,0,494,3,2738,1,5204,3,7942,California
Mariposa,2021-06-29,12,12678,4,2392,7,9791,1,495,6,2739,6,5210,7,7949,California
Mariposa,2021-06-30,6,12684,1,2393,4,9795,1,496,3,2740,3,5213,4,7953,California
Mariposa,2021-07-01,26,12710,18,2411,6,9801,2,498,11,2738,15,5228,13,7966,California
Mariposa,2021-07-02,7,12717,6,2417,1,9802,0,498,5,2742,1,5229,5,7971,California
Mariposa,2021-07-03,6,12723,3,2420,3,9805,0,498,1,2738,5,5234,1,7972,California
Mariposa,2021-07-04,1,12724,0,2420,1,9806,0,498,0,2737,1,5235,0,7972,California
Mariposa,2021-07-05,4,12728,1,2421,2,9808,1,499,1,2736,3,5238,2,7974,California
Mariposa,2021-07-06,19,12747,5,2426,8,9816,6,505,7,2737,12,5250,13,7987,California
Mariposa,2021-07-07,18,12765,16,2442,1,9817,1,506,11,2742,7,5257,12,7999,California
Mariposa,2021-07-08,33,12798,19,2461,10,9827,4,510,14,2741,19,5276,18,8017,California
Mariposa,2021-07-09,9,12807,5,2466,2,9829,2,512,3,2740,6,5282,5,8022,California
Mariposa,2021-07-10,3,12810,1,2467,1,9830,1,513,2,2742,1,5283,3,8025,California
Mariposa,2021-07-12,13,12823,8,2475,4,9834,1,514,6,2742,7,5290,7,8032,California
Mariposa,2021-07-13,14,12837,7,2482,7,9841,0,514,11,2750,3,5293,11,8043,California
Mariposa,2021-07-14,19,12856,8,2490,10,9851,1,515,10,2752,9,5302,11,8054,California
Mariposa,2021-07-15,30,12886,18,2508,10,9861,2,517,13,2750,17,5319,15,8069,California
Mariposa,2021-07-16,16,12902,11,2519,5,9866,0,517,12,2758,4,5323,12,8081,California
Mariposa,2021-07-17,10,12912,9,2528,1,9867,0,517,7,2762,3,5326,7,8088,California
Mariposa,2021-07-18,6,12918,6,2534,0,9867,0,517,4,2764,2,5328,4,8092,California
Mariposa,2021-07-19,9,12927,2,2536,7,9874,0,517,5,2765,4,5332,5,8097,California
Mariposa,2021-07-20,17,12944,6,2542,9,9883,2,519,7,2765,9,5341,9,8106,California
Mariposa,2021-07-21,19,12963,10,2552,7,9890,2,521,14,2776,5,5346,16,8122,California
Mariposa,2021-07-22,26,12989,15,2567,10,9900,1,522,16,2783,10,5356,17,8139,California
Mariposa,2021-07-23,10,12999,8,2575,2,9902,0,522,5,2783,5,5361,5,8144,California
Mariposa,2021-07-24,9,13008,5,2580,4,9906,0,522,8,2790,1,5362,8,8152,California
Mariposa,2021-07-26,10,13018,5,2585,4,9910,1,523,7,2795,3,5365,8,8160,California
Mariposa,2021-07-27,25,13043,15,2600,9,9919,1,524,21,2813,4,5369,22,8182,California
Mariposa,2021-07-28,18,13061,11,2611,7,9926,0,524,10,2815,8,5377,10,8192,California
Mariposa,2021-07-29,41,13102,28,2639,11,9937,2,526,33,2843,6,5383,34,8226,California
Mariposa,2021-07-30,13,13115,9,2648,3,9940,1,527,10,2851,3,5386,11,8237,California
Mariposa,2021-07-31,18,13133,15,2663,1,9941,2,529,15,2865,3,5389,17,8254,California
Mariposa,2021-08-01,4,13137,1,2664,2,9943,1,530,1,2864,3,5392,2,8256,California
Mariposa,2021-08-02,16,13153,9,2673,6,9949,1,531,13,2875,3,5395,14,8270,California
Mariposa,2021-08-03,13,13166,7,2680,5,9954,1,532,6,2875,7,5402,7,8277,California
Mariposa,2021-08-04,20,13186,9,2689,9,9963,2,534,12,2881,8,5410,14,8291,California
Mariposa,2021-08-05,61,13247,29,2718,24,9987,8,542,37,2903,22,5432,44,8335,California
Mariposa,2021-08-06,25,13272,16,2734,9,9996,0,542,21,2920,4,5436,21,8356,California
Mariposa,2021-08-07,13,13285,6,2740,7,10003,0,542,8,2923,5,5441,8,8364,California
Mariposa,2021-08-08,8,13293,3,2743,3,10006,2,544,1,2919,7,5448,3,8367,California
Mariposa,2021-08-09,18,13311,12,2755,5,10011,1,545,12,2926,6,5454,13,8380,California
Mariposa,2021-08-10,16,13327,10,2765,6,10017,0,545,6,2922,10,5464,6,8386,California
Mariposa,2021-08-11,26,13353,16,2781,9,10026,1,546,17,2931,9,5473,18,8404,California
Mariposa,2021-08-12,42,13395,25,2806,10,10036,7,553,24,2944,18,5491,31,8435,California
Mariposa,2021-08-13,13,13408,7,2813,6,10042,0,553,7,2945,6,5497,7,8442,California
Mariposa,2021-08-14,16,13424,11,2824,5,10047,0,553,7,2945,7,5504,7,8449,California
Mariposa,2021-08-15,3,13427,2,2826,1,10048,0,553,2,2946,1,5505,2,8451,California
Mariposa,2021-08-16,13,13440,8,2834,5,10053,0,553,8,2949,5,5510,8,8459,California
Mariposa,2021-08-17,21,13461,13,2847,8,10061,0,553,15,2959,5,5515,15,8474,California
Mariposa,2021-08-18,25,13486,12,2859,13,10074,0,553,16,2969,6,5521,16,8490,California
Mariposa,2021-08-19,54,13540,33,2892,16,10090,5,558,27,2977,24,5545,32,8522,California
Mariposa,2021-08-20,27,13567,12,2904,11,10101,4,562,15,2986,10,5555,19,8541,California
Mariposa,2021-08-21,21,13588,13,2917,8,10109,0,562,7,2980,13,5568,7,8548,California
Mariposa,2021-08-22,9,13597,6,2923,3,10112,0,562,8,2987,1,5569,8,8556,California
Mariposa,2021-08-23,21,13618,11,2934,10,10122,0,562,9,2986,10,5579,9,8565,California
Mariposa,2021-08-24,15,13633,10,2944,5,10127,0,562,6,2983,9,5588,6,8571,California
Mariposa,2021-08-25,23,13656,10,2954,11,10138,2,564,13,2989,9,5597,15,8586,California
Mariposa,2021-08-26,62,13718,32,2986,19,10157,11,575,26,2993,33,5630,37,8623,California
Mariposa,2021-08-27,32,13750,24,3010,7,10164,1,576,18,2998,14,5644,19,8642,California
Mariposa,2021-08-28,14,13764,12,3022,2,10166,0,576,9,3002,5,5649,9,8651,California
Mariposa,2021-08-29,6,13770,5,3027,1,10167,0,576,3,3002,3,5652,3,8654,California
Mariposa,2021-08-30,5,13775,2,3029,2,10169,1,577,2,3002,3,5655,3,8657,California
Mendocino,2020-12-17,69,69,69,69,0,0,0,0,69,69,0,0,69,69,California
Mendocino,2020-12-18,83,152,82,151,1,1,0,0,83,152,0,0,83,152,California
Mendocino,2020-12-19,3,155,3,154,0,1,0,0,3,155,0,0,3,155,California
Mendocino,2020-12-20,8,163,8,162,0,1,0,0,8,163,0,0,8,163,California
Mendocino,2020-12-21,234,397,234,396,0,1,0,0,78,241,0,0,78,241,California
Mendocino,2020-12-22,257,654,196,592,61,62,0,0,257,498,0,0,257,498,California
Mendocino,2020-12-23,274,928,50,642,224,286,0,0,274,772,0,0,274,772,California
Mendocino,2020-12-24,47,975,8,650,39,325,0,0,47,819,0,0,47,819,California
Mendocino,2020-12-25,1,976,0,650,1,326,0,0,1,820,0,0,1,820,California
Mendocino,2020-12-26,2,978,2,652,0,326,0,0,2,822,0,0,2,822,California
Mendocino,2020-12-27,1,979,0,652,1,327,0,0,1,823,0,0,1,823,California
Mendocino,2020-12-28,75,1054,10,662,65,392,0,0,75,898,0,0,75,898,California
Mendocino,2020-12-29,123,1177,63,725,60,452,0,0,123,1021,0,0,123,1021,California
Mendocino,2020-12-30,136,1313,73,798,63,515,0,0,136,1157,0,0,136,1157,California
Mendocino,2020-12-31,134,1447,98,896,36,551,0,0,134,1291,0,0,134,1291,California
Mendocino,2021-01-01,17,1464,9,905,8,559,0,0,17,1308,0,0,17,1308,California
Mendocino,2021-01-02,1,1465,1,906,0,559,0,0,1,1309,0,0,1,1309,California
Mendocino,2021-01-04,847,2312,18,924,829,1388,0,0,847,2156,0,0,847,2156,California
Mendocino,2021-01-05,77,2389,38,962,39,1427,0,0,63,2205,14,14,63,2219,California
Mendocino,2021-01-06,157,2546,133,1095,24,1451,0,0,149,2346,8,22,149,2368,California
Mendocino,2021-01-07,456,3002,247,1342,209,1660,0,0,394,2678,62,84,394,2762,California
Mendocino,2021-01-08,95,3097,81,1423,14,1674,0,0,42,2668,53,137,43,2805,California
Mendocino,2021-01-09,11,3108,7,1430,4,1678,0,0,9,2675,2,139,9,2814,California
Mendocino,2021-01-10,9,3117,8,1438,1,1679,0,0,1,2668,8,147,1,2815,California
Mendocino,2021-01-11,161,3278,94,1532,67,1746,0,0,102,2712,58,205,102,2917,California
Mendocino,2021-01-12,395,3673,385,1917,10,1756,0,0,274,2865,121,326,274,3191,California
Mendocino,2021-01-13,504,4177,157,2074,347,2103,0,0,452,3267,50,376,452,3643,California
Mendocino,2021-01-14,767,4944,27,2101,740,2843,0,0,752,4004,15,391,752,4395,California
Mendocino,2021-01-15,1885,6829,872,2973,1013,3856,0,0,1878,5878,5,396,1879,6274,California
Mendocino,2021-01-16,789,7618,48,3021,741,4597,0,0,786,6661,3,399,786,7060,California
Mendocino,2021-01-17,558,8176,2,3023,556,5153,0,0,555,7214,2,401,555,7615,California
Mendocino,2021-01-18,489,8665,464,3487,25,5178,0,0,476,7677,13,414,476,8091,California
Mendocino,2021-01-19,337,9002,151,3638,186,5364,0,0,152,7644,185,599,152,8243,California
Mendocino,2021-01-20,560,9562,410,4048,150,5514,0,0,452,7992,106,705,454,8697,California
Mendocino,2021-01-21,539,10101,230,4278,309,5823,0,0,350,8154,188,893,350,9047,California
Mendocino,2021-01-22,156,10257,61,4339,95,5918,0,0,117,8232,39,932,117,9164,California
Mendocino,2021-01-23,156,10413,85,4424,71,5989,0,0,150,8376,6,938,150,9314,California
Mendocino,2021-01-24,4,10417,2,4426,2,5991,0,0,4,8380,0,938,4,9318,California
Mendocino,2021-01-25,275,10692,18,4444,257,6248,0,0,205,8515,70,1008,205,9523,California
Mendocino,2021-01-26,162,10854,55,4499,107,6355,0,0,95,8543,67,1075,95,9618,California
Mendocino,2021-01-27,449,11303,371,4870,78,6433,0,0,177,8455,265,1340,177,9795,California
Mendocino,2021-01-28,606,11909,539,5409,67,6500,0,0,508,8866,97,1437,508,10303,California
Mendocino,2021-01-29,417,12326,357,5766,60,6560,0,0,386,9222,31,1468,387,10690,California
Mendocino,2021-01-30,53,12379,34,5800,19,6579,0,0,45,9259,8,1476,45,10735,California
Mendocino,2021-01-31,282,12661,2,5802,280,6859,0,0,4,8985,278,1754,4,10739,California
Mendocino,2021-02-01,386,13047,56,5858,330,7189,0,0,62,8723,324,2078,62,10801,California
Mendocino,2021-02-02,764,13811,536,6394,228,7417,0,0,391,8741,373,2451,391,11192,California
Mendocino,2021-02-03,402,14213,210,6604,192,7609,0,0,225,8791,175,2626,225,11417,California
Mendocino,2021-02-04,633,14846,536,7140,97,7706,0,0,503,9164,130,2756,503,11920,California
Mendocino,2021-02-05,1409,16255,1221,8361,188,7894,0,0,598,8953,809,3565,598,12518,California
Mendocino,2021-02-06,550,16805,151,8512,399,8293,0,0,536,9475,14,3579,536,13054,California
Mendocino,2021-02-07,32,16837,28,8540,4,8297,0,0,32,9507,0,3579,32,13086,California
Mendocino,2021-02-08,749,17586,718,9258,31,8328,0,0,283,9326,464,4043,283,13369,California
Mendocino,2021-02-09,144,17730,62,9320,82,8410,0,0,90,9362,54,4097,90,13459,California
Mendocino,2021-02-10,1498,19228,928,10248,570,8980,0,0,743,9359,746,4843,743,14202,California
Mendocino,2021-02-11,1367,20595,209,10457,1158,10138,0,0,305,8603,1061,5904,305,14507,California
Mendocino,2021-02-12,1470,22065,163,10620,1307,11445,0,0,666,8466,803,6707,666,15173,California
Mendocino,2021-02-13,633,22698,16,10636,617,12062,0,0,227,8293,405,7112,232,15405,California
Mendocino,2021-02-14,704,23402,5,10641,699,12761,0,0,138,7865,566,7678,138,15543,California
Mendocino,2021-02-15,333,23735,41,10682,292,13053,0,0,175,7883,157,7835,175,15718,California
Mendocino,2021-02-16,200,23935,53,10735,147,13200,0,0,129,7941,71,7906,129,15847,California
Mendocino,2021-02-17,1385,25320,1214,11949,171,13371,0,0,891,8340,492,8398,891,16738,California
Mendocino,2021-02-18,1830,27150,693,12642,1137,14508,0,0,1235,8982,593,8991,1235,17973,California
Mendocino,2021-02-19,778,27928,155,12797,623,15131,0,0,630,9466,148,9139,632,18605,California
Mendocino,2021-02-20,709,28637,580,13377,129,15260,0,0,623,10006,83,9222,623,19228,California
Mendocino,2021-02-21,328,28965,9,13386,319,15579,0,0,315,10309,12,9234,315,19543,California
Mendocino,2021-02-22,270,29235,33,13419,237,15816,0,0,137,10314,132,9366,137,19680,California
Mendocino,2021-02-23,887,30122,873,14292,14,15830,0,0,663,10755,222,9588,663,20343,California
Mendocino,2021-02-24,1897,32019,1804,16096,93,15923,0,0,1456,11779,434,10022,1458,21801,California
Mendocino,2021-02-25,1738,33757,556,16652,1182,17105,0,0,1299,12642,436,10458,1299,23100,California
Mendocino,2021-02-26,1461,35218,779,17431,682,17787,0,0,1076,13337,381,10839,1076,24176,California
Mendocino,2021-02-27,203,35421,145,17576,58,17845,0,0,82,13300,119,10958,82,24258,California
Mendocino,2021-02-28,36,35457,14,17590,22,17867,0,0,25,13314,11,10969,25,24283,California
Mendocino,2021-03-01,609,36066,554,18144,54,17921,1,1,558,13826,47,11016,559,24842,California
Mendocino,2021-03-02,79,36145,29,18173,50,17971,0,1,42,13831,37,11053,42,24884,California
Mendocino,2021-03-03,2050,38195,1341,19514,709,18680,0,1,1387,14559,659,11712,1387,26271,California
Mendocino,2021-03-04,1882,40077,156,19670,1726,20406,0,1,1657,15996,222,11934,1659,27930,California
Mendocino,2021-03-05,485,40562,420,20090,56,20462,9,10,378,16280,103,12037,387,28317,California
Mendocino,2021-03-06,251,40813,28,20118,194,20656,29,39,204,16467,46,12083,233,28550,California
Mendocino,2021-03-07,532,41345,29,20147,482,21138,21,60,140,16236,391,12474,160,28710,California
Mendocino,2021-03-08,127,41472,29,20176,59,21197,39,99,66,16282,59,12533,105,28815,California
Mendocino,2021-03-09,933,42405,599,20775,294,21491,40,139,824,17038,108,12641,864,29679,California
Mendocino,2021-03-10,1156,43561,989,21764,102,21593,65,204,268,16491,882,13523,335,30014,California
Mendocino,2021-03-11,860,44421,636,22400,170,21763,54,258,399,16485,457,13980,451,30465,California
Mendocino,2021-03-12,2248,46669,1062,23462,1072,22835,114,372,1319,17004,915,14895,1434,31899,California
Mendocino,2021-03-13,816,47485,575,24037,182,23017,59,431,142,16537,668,15563,201,32100,California
Mendocino,2021-03-14,108,47593,4,24041,97,23114,7,438,12,16464,92,15655,19,32119,California
Mendocino,2021-03-15,612,48205,52,24093,502,23616,58,496,218,16348,391,16046,275,32394,California
Mendocino,2021-03-16,584,48789,389,24482,149,23765,46,542,113,16038,469,16515,159,32553,California
Mendocino,2021-03-17,1597,50386,1394,25876,58,23823,145,687,205,15010,1383,17898,355,32908,California
Mendocino,2021-03-18,1305,51691,248,26124,1020,24843,37,724,271,14289,1026,18924,305,33213,California
Mendocino,2021-03-19,1937,53628,856,26980,1022,25865,59,783,361,13142,1568,20492,421,33634,California
Mendocino,2021-03-20,74,53702,11,26991,41,25906,22,805,14,13119,60,20552,37,33671,California
Mendocino,2021-03-21,10,53712,2,26993,3,25909,5,810,4,13122,6,20558,9,33680,California
Mendocino,2021-03-22,663,54375,618,27611,16,25925,29,839,142,12776,516,21074,170,33850,California
Mendocino,2021-03-23,167,54542,36,27647,101,26026,30,869,115,12869,51,21125,144,33994,California
Mendocino,2021-03-24,919,55461,845,28492,23,26049,51,920,104,12212,812,21937,155,34149,California
Mendocino,2021-03-25,2032,57493,54,28546,1958,28007,20,940,165,10536,1859,23796,183,34332,California
Mendocino,2021-03-26,551,58044,398,28944,128,28135,25,965,110,10232,439,24235,135,34467,California
Mendocino,2021-03-27,170,58214,36,28980,123,28258,11,976,83,10239,86,24321,93,34560,California
Mendocino,2021-03-28,25,58239,5,28985,16,28274,4,980,3,10225,21,24342,7,34567,California
Mendocino,2021-03-29,194,58433,101,29086,49,28323,44,1024,96,10268,97,24439,140,34707,California
Mendocino,2021-03-30,721,59154,635,29721,48,28371,38,1062,104,9797,613,25052,142,34849,California
Mendocino,2021-03-31,924,60078,285,30006,578,28949,61,1123,154,9245,767,25819,215,35064,California
Mendocino,2021-04-01,1759,61837,428,30434,1250,30199,81,1204,379,8334,1368,27187,457,35521,California
Mendocino,2021-04-02,1319,63156,1083,31517,161,30360,75,1279,154,7402,1161,28348,229,35750,California
Mendocino,2021-04-03,711,63867,12,31529,678,31038,21,1300,70,6857,636,28984,91,35841,California
Mendocino,2021-04-04,72,63939,36,31565,30,31068,6,1306,52,6895,20,29004,58,35899,California
Mendocino,2021-04-05,209,64148,140,31705,45,31113,24,1330,123,6953,86,29090,144,36043,California
Mendocino,2021-04-06,398,64546,126,31831,177,31290,95,1425,111,6871,287,29377,205,36248,California
Mendocino,2021-04-07,493,65039,181,32012,65,31355,247,1672,119,6861,371,29748,361,36609,California
Mendocino,2021-04-08,1504,66543,923,32935,467,31822,114,1786,1012,7502,484,30232,1125,37734,California
Mendocino,2021-04-09,770,67313,433,33368,173,31995,164,1950,402,7699,368,30600,565,38299,California
Mendocino,2021-04-10,574,67887,94,33462,433,32428,47,1997,153,7480,419,31019,200,38499,California
Mendocino,2021-04-11,119,68006,47,33509,19,32447,53,2050,59,7532,60,31079,112,38611,California
Mendocino,2021-04-12,631,68637,523,34032,48,32495,60,2110,412,7786,218,31297,472,39083,California
Mendocino,2021-04-13,297,68934,234,34266,63,32558,0,2110,226,7941,71,31368,226,39309,California
Mendocino,2021-04-14,525,69459,437,34703,88,32646,0,2110,427,8270,98,31466,427,39736,California
Mendocino,2021-04-15,671,70130,333,35036,337,32983,1,2111,391,8387,274,31740,391,40127,California
Mendocino,2021-04-16,198,70328,54,35090,143,33126,1,2112,91,8373,105,31845,91,40218,California
Mendocino,2021-04-17,198,70526,12,35102,186,33312,0,2112,65,8307,131,31976,65,40283,California
Mendocino,2021-04-18,16,70542,6,35108,10,33322,0,2112,7,8307,7,31983,7,40290,California
Mendocino,2021-04-19,545,71087,518,35626,26,33348,1,2113,428,8621,115,32098,429,40719,California
Mendocino,2021-04-20,426,71513,293,35919,133,33481,0,2113,264,8725,160,32258,264,40983,California
Mendocino,2021-04-21,200,71713,141,36060,58,33539,1,2114,120,8768,77,32335,120,41103,California
Mendocino,2021-04-22,486,72199,317,36377,168,33707,1,2115,313,8913,168,32503,313,41416,California
Mendocino,2021-04-23,870,73069,710,37087,160,33867,0,2115,705,9457,161,32664,705,42121,California
Mendocino,2021-04-24,110,73179,15,37102,95,33962,0,2115,98,9543,12,32676,98,42219,California
Mendocino,2021-04-25,63,73242,38,37140,21,33983,4,2119,22,9530,39,32715,26,42245,California
Mendocino,2021-04-26,318,73560,245,37385,68,34051,5,2124,207,9633,109,32824,212,42457,California
Mendocino,2021-04-27,211,73771,94,37479,91,34142,26,2150,97,9642,113,32937,122,42579,California
Mendocino,2021-04-28,230,74001,152,37631,59,34201,19,2169,131,9695,98,33035,151,42730,California
Mendocino,2021-04-29,1161,75162,855,38486,290,34491,16,2185,102,8760,1052,34087,117,42847,California
Mendocino,2021-04-30,610,75772,385,38871,216,34707,9,2194,227,8615,381,34468,236,43083,California
Mendocino,2021-05-01,495,76267,444,39315,43,34750,8,2202,381,8893,111,34579,389,43472,California
Mendocino,2021-05-02,57,76324,47,39362,7,34757,3,2205,8,8857,47,34626,11,43483,California
Mendocino,2021-05-03,149,76473,88,39450,39,34796,22,2227,42,8817,104,34730,64,43547,California
Mendocino,2021-05-04,387,76860,260,39710,95,34891,32,2259,146,8755,240,34970,178,43725,California
Mendocino,2021-05-05,896,77756,806,40516,75,34966,15,2274,228,8330,666,35636,241,43966,California
Mendocino,2021-05-06,643,78399,390,40906,231,35197,22,2296,159,8028,482,36118,180,44146,California
Mendocino,2021-05-07,186,78585,32,40938,129,35326,25,2321,119,8105,66,36184,143,44289,California
Mendocino,2021-05-08,130,78715,8,40946,121,35447,1,2322,112,8202,16,36200,113,44402,California
Mendocino,2021-05-09,24,78739,8,40954,15,35462,1,2323,6,8192,17,36217,7,44409,California
Mendocino,2021-05-10,240,78979,160,41114,75,35537,5,2328,148,8253,92,36309,153,44562,California
Mendocino,2021-05-11,277,79256,141,41255,119,35656,17,2345,131,8255,144,36453,146,44708,California
Mendocino,2021-05-12,149,79405,86,41341,53,35709,10,2355,47,8213,99,36552,57,44765,California
Mendocino,2021-05-13,1250,80655,1128,42469,105,35814,17,2372,324,7629,925,37477,341,45106,California
Mendocino,2021-05-14,722,81377,492,42961,166,35980,64,2436,246,7468,471,37948,310,45416,California
Mendocino,2021-05-15,157,81534,31,42992,122,36102,4,2440,61,7440,93,38041,65,45481,California
Mendocino,2021-05-16,116,81650,103,43095,11,36113,2,2442,98,7524,17,38058,101,45582,California
Mendocino,2021-05-17,178,81828,87,43182,75,36188,16,2458,102,7566,76,38134,118,45700,California
Mendocino,2021-05-18,253,82081,123,43305,99,36287,31,2489,110,7564,142,38276,140,45840,California
Mendocino,2021-05-19,334,82415,192,43497,120,36407,22,2511,245,7745,86,38362,267,46107,California
Mendocino,2021-05-20,307,82722,123,43620,139,36546,45,2556,111,7710,191,38553,156,46263,California
Mendocino,2021-05-21,658,83380,477,44097,166,36712,15,2571,511,8090,146,38699,526,46789,California
Mendocino,2021-05-22,800,84180,689,44786,103,36815,8,2579,243,7786,555,39254,251,47040,California
Mendocino,2021-05-23,29,84209,12,44798,10,36825,7,2586,15,7794,13,39267,21,47061,California
Mendocino,2021-05-24,130,84339,44,44842,64,36889,22,2608,61,7809,68,39335,83,47144,California
Mendocino,2021-05-25,304,84643,182,45024,89,36978,33,2641,136,7811,166,39501,168,47312,California
Mendocino,2021-05-26,329,84972,248,45272,69,37047,12,2653,133,7761,195,39696,145,47457,California
Mendocino,2021-05-27,259,85231,112,45384,121,37168,26,2679,111,7751,146,39842,136,47593,California
Mendocino,2021-05-28,239,85470,99,45483,126,37294,14,2693,153,7835,84,39926,168,47761,California
Mendocino,2021-05-29,50,85520,16,45499,29,37323,5,2698,25,7841,24,39950,30,47791,California
Mendocino,2021-05-30,18,85538,2,45501,15,37338,1,2699,12,7848,6,39956,13,47804,California
Mendocino,2021-05-31,9,85547,2,45503,6,37344,1,2700,2,7848,3,39959,3,47807,California
Mendocino,2021-06-01,323,85870,107,45610,207,37551,9,2709,88,7711,234,40193,97,47904,California
Mendocino,2021-06-02,161,86031,60,45670,92,37643,9,2718,54,7670,104,40297,63,47967,California
Mendocino,2021-06-03,570,86601,465,46135,92,37735,13,2731,126,7372,437,40734,139,48106,California
Mendocino,2021-06-04,332,86933,194,46329,114,37849,24,2755,97,7259,234,40968,121,48227,California
Mendocino,2021-06-05,232,87165,99,46428,115,37964,18,2773,76,7199,154,41122,94,48321,California
Mendocino,2021-06-06,64,87229,58,46486,3,37967,3,2776,2,7142,62,41184,5,48326,California
Mendocino,2021-06-07,150,87379,74,46560,63,38030,13,2789,58,7121,92,41276,71,48397,California
Mendocino,2021-06-08,244,87623,142,46702,89,38119,13,2802,110,7115,129,41405,123,48520,California
Mendocino,2021-06-09,309,87932,249,46951,50,38169,10,2812,105,7027,203,41608,115,48635,California
Mendocino,2021-06-10,138,88070,74,47025,48,38217,16,2828,59,7023,79,41687,75,48710,California
Mendocino,2021-06-11,780,88850,596,47621,158,38375,26,2854,132,6538,643,42330,158,48868,California
Mendocino,2021-06-12,77,88927,53,47674,18,38393,6,2860,27,6522,49,42379,33,48901,California
Mendocino,2021-06-13,29,88956,16,47690,11,38404,2,2862,15,6526,13,42392,17,48918,California
Mendocino,2021-06-14,131,89087,59,47749,53,38457,19,2881,48,6510,82,42474,66,48984,California
Mendocino,2021-06-15,263,89350,170,47919,73,38530,20,2901,84,6435,179,42653,104,49088,California
Mendocino,2021-06-16,276,89626,176,48095,80,38610,20,2921,73,6327,201,42854,93,49181,California
Mendocino,2021-06-17,171,89797,89,48184,61,38671,21,2942,55,6287,116,42970,76,49257,California
Mendocino,2021-06-18,297,90094,130,48314,137,38808,30,2972,89,6199,206,43176,118,49375,California
Mendocino,2021-06-19,76,90170,43,48357,26,38834,7,2979,17,6164,59,43235,24,49399,California
Mendocino,2021-06-20,13,90183,5,48362,4,38838,4,2983,8,6171,5,43240,12,49411,California
Mendocino,2021-06-21,102,90285,36,48398,56,38894,10,2993,44,6169,56,43296,54,49465,California
Mendocino,2021-06-22,132,90417,84,48482,35,38929,13,3006,55,6162,75,43371,68,49533,California
Mendocino,2021-06-23,227,90644,160,48642,37,38966,30,3036,100,6166,126,43497,130,49663,California
Mendocino,2021-06-24,213,90857,110,48752,87,39053,16,3052,80,6129,133,43630,96,49759,California
Mendocino,2021-06-25,194,91051,102,48854,79,39132,13,3065,76,6102,116,43746,89,49848,California
Mendocino,2021-06-26,77,91128,52,48906,21,39153,4,3069,24,6077,53,43799,28,49876,California
Mendocino,2021-06-27,23,91151,13,48919,9,39162,1,3070,13,6081,10,43809,14,49890,California
Mendocino,2021-06-28,68,91219,45,48964,12,39174,11,3081,21,6069,44,43853,32,49922,California
Mendocino,2021-06-29,175,91394,122,49086,50,39224,3,3084,60,6017,115,43968,63,49985,California
Mendocino,2021-06-30,186,91580,152,49238,27,39251,7,3091,60,5961,124,44092,68,50053,California
Mendocino,2021-07-01,118,91698,68,49306,39,39290,11,3102,65,5987,50,44142,76,50129,California
Mendocino,2021-07-02,103,91801,64,49370,29,39319,10,3112,48,5991,54,44196,58,50187,California
Mendocino,2021-07-03,39,91840,28,49398,9,39328,2,3114,18,5990,21,44217,20,50207,California
Mendocino,2021-07-04,1,91841,0,49398,1,39329,0,3114,1,5991,0,44217,1,50208,California
Mendocino,2021-07-05,38,91879,18,49416,15,39344,5,3119,16,5990,22,44239,21,50229,California
Mendocino,2021-07-06,211,92090,156,49572,41,39385,14,3133,86,5965,125,44364,100,50329,California
Mendocino,2021-07-07,89,92179,58,49630,22,39407,9,3142,38,5964,48,44412,47,50376,California
Mendocino,2021-07-08,117,92296,52,49682,54,39461,11,3153,49,5956,68,44480,60,50436,California
Mendocino,2021-07-09,211,92507,142,49824,44,39505,25,3178,79,5930,129,44609,103,50539,California
Mendocino,2021-07-10,23,92530,11,49835,12,39517,0,3178,13,5933,10,44619,13,50552,California
Mendocino,2021-07-11,20,92550,10,49845,4,39521,6,3184,7,5933,13,44632,13,50565,California
Mendocino,2021-07-12,88,92638,35,49880,51,39572,2,3186,41,5930,46,44678,43,50608,California
Mendocino,2021-07-13,242,92880,143,50023,74,39646,25,3211,135,5985,106,44784,161,50769,California
Mendocino,2021-07-14,84,92964,51,50074,22,39668,11,3222,38,5989,45,44829,49,50818,California
Mendocino,2021-07-15,103,93067,76,50150,26,39694,1,3223,57,6003,44,44873,58,50876,California
Mendocino,2021-07-16,249,93316,167,50317,68,39762,14,3237,130,6028,119,44992,144,51020,California
Mendocino,2021-07-17,47,93363,29,50346,16,39778,2,3239,22,6027,25,45017,24,51044,California
Mendocino,2021-07-18,14,93377,7,50353,6,39784,1,3240,6,6026,7,45024,6,51050,California
Mendocino,2021-07-19,71,93448,44,50397,25,39809,2,3242,50,6057,21,45045,52,51102,California
Mendocino,2021-07-20,196,93644,130,50527,62,39871,4,3246,121,6110,73,45118,126,51228,California
Mendocino,2021-07-21,122,93766,79,50606,41,39912,2,3248,61,6114,59,45177,63,51291,California
Mendocino,2021-07-22,142,93908,75,50681,50,39962,17,3265,76,6142,65,45242,93,51384,California
Mendocino,2021-07-23,292,94200,198,50879,75,40037,19,3284,178,6226,113,45355,197,51581,California
Mendocino,2021-07-24,75,94275,42,50921,30,40067,3,3287,48,6250,27,45382,51,51632,California
Mendocino,2021-07-25,45,94320,32,50953,12,40079,1,3288,38,6282,7,45389,39,51671,California
Mendocino,2021-07-26,93,94413,48,51001,38,40117,7,3295,60,6317,32,45421,67,51738,California
Mendocino,2021-07-27,242,94655,139,51140,71,40188,32,3327,139,6386,101,45522,170,51908,California
Mendocino,2021-07-28,147,94802,83,51223,55,40243,9,3336,108,6467,37,45559,118,52026,California
Mendocino,2021-07-29,158,94960,76,51299,71,40314,11,3347,106,6532,51,45610,116,52142,California
Mendocino,2021-07-30,316,95276,236,51535,76,40390,4,3351,237,6697,76,45686,241,52383,California
Mendocino,2021-07-31,66,95342,47,51582,15,40405,4,3355,54,6743,12,45698,58,52441,California
Mendocino,2021-08-01,43,95385,14,51596,25,40430,4,3359,35,6774,8,45706,39,52480,California
Mendocino,2021-08-02,117,95502,65,51661,48,40478,4,3363,86,6834,30,45736,90,52570,California
Mendocino,2021-08-03,268,95770,175,51836,61,40539,32,3395,164,6932,100,45836,198,52768,California
Mendocino,2021-08-04,189,95959,130,51966,48,40587,11,3406,135,7024,54,45890,146,52914,California
Mendocino,2021-08-05,159,96118,103,52069,54,40641,2,3408,102,7073,55,45945,104,53018,California
Mendocino,2021-08-06,338,96456,227,52296,103,40744,8,3416,227,7198,110,46055,235,53253,California
Mendocino,2021-08-07,51,96507,23,52319,28,40772,0,3416,33,7216,15,46070,33,53286,California
Mendocino,2021-08-08,20,96527,10,52329,10,40782,0,3416,15,7226,5,46075,15,53301,California
Mendocino,2021-08-09,139,96666,82,52411,48,40830,9,3425,85,7268,52,46127,94,53395,California
Mendocino,2021-08-10,310,96976,198,52609,101,40931,11,3436,178,7331,127,46254,190,53585,California
Mendocino,2021-08-11,233,97209,153,52762,78,41009,2,3438,178,7462,49,46303,180,53765,California
Mendocino,2021-08-12,182,97391,109,52871,69,41078,4,3442,115,7515,66,46369,119,53884,California
Mendocino,2021-08-13,458,97849,305,53176,148,41226,5,3447,289,7657,152,46521,294,54178,California
Mendocino,2021-08-14,124,97973,86,53262,37,41263,1,3448,87,7711,34,46555,88,54266,California
Mendocino,2021-08-15,70,98043,50,53312,20,41283,0,3448,38,7719,30,46585,38,54304,California
Mendocino,2021-08-16,193,98236,132,53444,57,41340,4,3452,110,7763,70,46655,114,54418,California
Mendocino,2021-08-17,285,98521,194,53638,83,41423,8,3460,150,7811,110,46765,158,54576,California
Mendocino,2021-08-18,185,98706,117,53755,61,41484,7,3467,97,7854,61,46826,104,54680,California
Mendocino,2021-08-19,183,98889,110,53865,69,41553,4,3471,99,7899,58,46884,103,54783,California
Mendocino,2021-08-20,486,99375,349,54214,120,41673,17,3488,221,7932,205,47089,238,55021,California
Mendocino,2021-08-21,88,99463,45,54259,42,41715,1,3489,32,7925,40,47129,33,55054,California
Mendocino,2021-08-22,47,99510,24,54283,23,41738,0,3489,28,7938,15,47144,28,55082,California
Mendocino,2021-08-23,151,99661,93,54376,56,41794,2,3491,66,7950,56,47200,68,55150,California
Mendocino,2021-08-24,319,99980,211,54587,99,41893,9,3500,151,7972,139,47339,161,55311,California
Mendocino,2021-08-25,234,100214,150,54737,82,41975,2,3502,89,7958,105,47444,91,55402,California
Mendocino,2021-08-26,199,100413,120,54857,73,42048,6,3508,90,7979,75,47519,96,55498,California
Mendocino,2021-08-27,418,100831,311,55168,103,42151,4,3512,149,7922,210,47729,153,55651,California
Mendocino,2021-08-28,78,100909,44,55212,32,42183,2,3514,38,7926,36,47765,40,55691,California
Mendocino,2021-08-29,83,100992,48,55260,34,42217,1,3515,39,7931,35,47800,40,55731,California
Mendocino,2021-08-30,90,101082,39,55299,46,42263,5,3520,35,7935,36,47836,40,55771,California
Merced,2020-12-16,4,4,4,4,0,0,0,0,4,4,0,0,4,4,California
Merced,2020-12-17,9,13,9,13,0,0,0,0,9,13,0,0,9,13,California
Merced,2020-12-18,148,161,148,161,0,0,0,0,148,161,0,0,148,161,California
Merced,2020-12-19,37,198,37,198,0,0,0,0,37,198,0,0,37,198,California
Merced,2020-12-20,19,217,18,216,1,1,0,0,19,217,0,0,19,217,California
Merced,2020-12-21,138,355,135,351,3,4,0,0,138,355,0,0,138,355,California
Merced,2020-12-22,187,542,187,538,0,4,0,0,187,542,0,0,187,542,California
Merced,2020-12-23,283,825,277,815,6,10,0,0,283,825,0,0,283,825,California
Merced,2020-12-24,77,902,77,892,0,10,0,0,77,902,0,0,77,902,California
Merced,2020-12-25,4,906,4,896,0,10,0,0,4,906,0,0,4,906,California
Merced,2020-12-26,7,913,4,900,3,13,0,0,7,913,0,0,7,913,California
Merced,2020-12-27,12,925,11,911,1,14,0,0,12,925,0,0,12,925,California
Merced,2020-12-28,155,1080,127,1038,28,42,0,0,155,1080,0,0,155,1080,California
Merced,2020-12-29,219,1299,151,1189,68,110,0,0,219,1299,0,0,219,1299,California
Merced,2020-12-30,240,1539,111,1300,129,239,0,0,240,1539,0,0,240,1539,California
Merced,2020-12-31,121,1660,50,1350,71,310,0,0,120,1659,0,0,120,1659,California
Merced,2021-01-01,10,1670,3,1353,7,317,0,0,10,1669,0,0,10,1669,California
Merced,2021-01-02,131,1801,119,1472,12,329,0,0,131,1800,0,0,131,1800,California
Merced,2021-01-03,9,1810,5,1477,4,333,0,0,9,1809,0,0,9,1809,California
Merced,2021-01-04,82,1892,42,1519,40,373,0,0,82,1891,0,0,82,1891,California
Merced,2021-01-05,343,2235,237,1756,106,479,0,0,336,2222,7,7,338,2229,California
Merced,2021-01-06,264,2499,104,1860,160,639,0,0,256,2473,8,15,259,2488,California
Merced,2021-01-07,201,2700,84,1944,117,756,0,0,188,2647,14,29,188,2676,California
Merced,2021-01-08,540,3240,392,2336,148,904,0,0,385,2879,154,183,386,3062,California
Merced,2021-01-09,23,3263,10,2346,13,917,0,0,17,2890,6,189,17,3079,California
Merced,2021-01-10,11,3274,7,2353,4,921,0,0,7,2893,4,193,7,3086,California
Merced,2021-01-11,254,3528,195,2548,59,980,0,0,102,2847,152,345,106,3192,California
Merced,2021-01-12,313,3841,174,2722,139,1119,0,0,261,3057,52,397,262,3454,California
Merced,2021-01-13,405,4246,176,2898,229,1348,0,0,251,3158,153,550,254,3708,California
Merced,2021-01-14,392,4638,269,3167,123,1471,0,0,159,3092,232,782,166,3874,California
Merced,2021-01-15,603,5241,131,3298,472,1943,0,0,562,3615,42,824,565,4439,California
Merced,2021-01-16,214,5455,130,3428,84,2027,0,0,196,3794,18,842,197,4636,California
Merced,2021-01-17,51,5506,12,3440,39,2066,0,0,49,3841,2,844,49,4685,California
Merced,2021-01-18,274,5780,132,3572,142,2208,0,0,247,4065,27,871,251,4936,California
Merced,2021-01-19,773,6553,647,4219,126,2334,0,0,545,4391,226,1097,552,5488,California
Merced,2021-01-20,599,7152,471,4690,128,2462,0,0,540,4877,59,1156,545,6033,California
Merced,2021-01-21,1066,8218,690,5380,376,2838,0,0,925,5665,140,1296,928,6961,California
Merced,2021-01-22,1348,9566,699,6079,649,3487,0,0,1315,6961,32,1328,1328,8289,California
Merced,2021-01-23,336,9902,204,6283,132,3619,0,0,225,7075,111,1439,225,8514,California
Merced,2021-01-24,35,9937,14,6297,21,3640,0,0,28,7097,6,1445,28,8542,California
Merced,2021-01-25,755,10692,253,6550,502,4142,0,0,692,7730,61,1506,694,9236,California
Merced,2021-01-26,956,11648,492,7042,464,4606,0,0,692,8191,236,1742,697,9933,California
Merced,2021-01-27,1034,12682,602,7644,432,5038,0,0,807,8827,225,1967,861,10794,California
Merced,2021-01-28,1189,13871,610,8254,579,5617,0,0,1011,9713,177,2144,1063,11857,California
Merced,2021-01-29,892,14763,311,8565,581,6198,0,0,586,10059,294,2438,640,12497,California
Merced,2021-01-30,285,15048,28,8593,257,6455,0,0,192,10232,93,2531,266,12763,California
Merced,2021-01-31,47,15095,10,8603,37,6492,0,0,45,10276,1,2532,45,12808,California
Merced,2021-02-01,397,15492,55,8658,342,6834,0,0,339,10561,55,2587,340,13148,California
Merced,2021-02-02,315,15807,183,8841,132,6966,0,0,187,10624,125,2712,188,13336,California
Merced,2021-02-03,403,16210,81,8922,322,7288,0,0,150,10588,249,2961,213,13549,California
Merced,2021-02-04,420,16630,169,9091,251,7539,0,0,220,10677,198,3159,287,13836,California
Merced,2021-02-05,559,17189,175,9266,384,7923,0,0,242,10661,315,3474,299,14135,California
Merced,2021-02-06,441,17630,242,9508,199,8122,0,0,243,10764,194,3668,297,14432,California
Merced,2021-02-07,19,17649,11,9519,8,8130,0,0,12,10769,7,3675,12,14444,California
Merced,2021-02-08,295,17944,203,9722,92,8222,0,0,186,10850,106,3781,187,14631,California
Merced,2021-02-09,1227,19171,951,10673,276,8498,0,0,751,11165,468,4249,783,15414,California
Merced,2021-02-10,1902,21073,1409,12082,493,8991,0,0,1289,11865,602,4851,1302,16716,California
Merced,2021-02-11,2567,23640,2051,14133,516,9507,0,0,1838,12995,717,5568,1847,18563,California
Merced,2021-02-12,1761,25401,1029,15162,732,10239,0,0,767,12792,973,6541,770,19333,California
Merced,2021-02-13,371,25772,214,15376,157,10396,0,0,270,12968,96,6637,272,19605,California
Merced,2021-02-14,118,25890,26,15402,92,10488,0,0,95,13041,23,6660,96,19701,California
Merced,2021-02-15,283,26173,46,15448,237,10725,0,0,173,13112,103,6763,174,19875,California
Merced,2021-02-16,1239,27412,851,16299,388,11113,0,0,838,13579,378,7141,845,20720,California
Merced,2021-02-17,1926,29338,1674,17973,252,11365,0,0,1336,14355,569,7710,1345,22065,California
Merced,2021-02-18,1290,30628,876,18849,414,11779,0,0,456,14005,810,8520,460,22525,California
Merced,2021-02-19,1289,31917,440,19289,849,12628,0,0,549,13827,729,9249,551,23076,California
Merced,2021-02-20,290,32207,34,19323,256,12884,0,0,140,13820,148,9397,141,23217,California
Merced,2021-02-21,80,32287,65,19388,15,12899,0,0,27,13796,51,9448,27,23244,California
Merced,2021-02-22,857,33144,304,19692,553,13452,0,0,489,13925,363,9811,492,23736,California
Merced,2021-02-23,1119,34263,432,20124,687,14139,0,0,646,14117,459,10270,651,24387,California
Merced,2021-02-24,876,35139,313,20437,563,14702,0,0,460,14224,354,10624,461,24848,California
Merced,2021-02-25,1844,36983,913,21350,931,15633,0,0,1343,15123,450,11074,1349,26197,California
Merced,2021-02-26,2245,39228,1419,22769,826,16459,0,0,1763,16469,421,11495,1767,27964,California
Merced,2021-02-27,2657,41885,1197,23966,1460,17919,0,0,2351,18588,233,11728,2352,30316,California
Merced,2021-02-28,324,42209,76,24042,247,18166,1,1,259,18787,60,11788,259,30575,California
Merced,2021-03-01,1174,43383,295,24337,878,19044,1,2,799,19227,365,12153,805,31380,California
Merced,2021-03-02,1902,45285,1039,25376,862,19906,1,3,1487,20329,404,12557,1506,32886,California
Merced,2021-03-03,2513,47798,1983,27359,529,20435,1,4,1708,21332,725,13282,1728,34614,California
Merced,2021-03-04,3188,50986,2533,29892,653,21088,2,6,2164,22554,945,14227,2167,36781,California
Merced,2021-03-05,2376,53362,1474,31366,878,21966,24,30,1806,23884,507,14734,1837,38618,California
Merced,2021-03-06,1204,54566,677,32043,506,22472,21,51,919,24595,229,14963,940,39558,California
Merced,2021-03-07,249,54815,76,32119,142,22614,31,82,214,24805,35,14998,245,39803,California
Merced,2021-03-08,1586,56401,966,33085,553,23167,67,149,1342,25970,243,15241,1408,41211,California
Merced,2021-03-09,1891,58292,1147,34232,634,23801,110,259,1213,26649,644,15885,1323,42534,California
Merced,2021-03-10,2985,61277,2000,36232,785,24586,200,459,1640,27189,1306,17191,1846,44380,California
Merced,2021-03-11,2231,63508,842,37074,1184,25770,205,664,1240,27696,960,18151,1467,45847,California
Merced,2021-03-12,2568,66076,1113,38187,1170,26940,285,949,1662,28757,897,19048,1958,47805,California
Merced,2021-03-13,1054,67130,318,38505,466,27406,270,1219,711,29400,335,19383,978,48783,California
Merced,2021-03-14,269,67399,155,38660,82,27488,32,1251,149,29466,116,19499,182,48965,California
Merced,2021-03-15,1721,69120,672,39332,789,28277,260,1511,1185,30384,525,20024,1443,50408,California
Merced,2021-03-16,1675,70795,885,40217,564,28841,226,1737,1144,31238,518,20542,1372,51780,California
Merced,2021-03-17,2320,73115,1393,41610,749,29590,178,1915,1839,32788,467,21009,2017,53797,California
Merced,2021-03-18,2268,75383,1384,42994,734,30324,150,2065,1409,33521,840,21849,1573,55370,California
Merced,2021-03-19,2815,78198,1590,44584,1027,31351,198,2263,1407,33735,1391,23240,1605,56975,California
Merced,2021-03-20,2482,80680,1539,46123,545,31896,398,2661,978,33622,1495,24735,1382,58357,California
Merced,2021-03-21,573,81253,349,46472,211,32107,13,2674,450,33966,120,24855,464,58821,California
Merced,2021-03-22,1292,82545,649,47121,567,32674,76,2750,896,34553,387,25242,974,59795,California
Merced,2021-03-23,2016,84561,1265,48386,685,33359,66,2816,1409,35432,596,25838,1475,61270,California
Merced,2021-03-24,1737,86298,1178,49564,523,33882,36,2852,1010,35765,713,26551,1046,62316,California
Merced,2021-03-25,3630,89928,2557,52121,1048,34930,25,2877,2124,36440,1480,28031,2155,64471,California
Merced,2021-03-26,2212,92140,1343,53464,833,35763,36,2913,904,36109,1272,29303,941,65412,California
Merced,2021-03-27,3621,95761,1941,55405,1259,37022,421,3334,1578,36080,2026,31329,1997,67409,California
Merced,2021-03-28,532,96293,218,55623,305,37327,9,3343,214,35989,315,31644,224,67633,California
Merced,2021-03-29,1989,98282,915,56538,904,38231,170,3513,688,35563,1285,32929,859,68492,California
Merced,2021-03-30,2309,100591,930,57468,1320,39551,59,3572,1013,35347,1289,34218,1073,69565,California
Merced,2021-03-31,2408,102999,1501,58969,726,40277,181,3753,995,35138,1385,35603,1176,70741,California
Merced,2021-04-01,2629,105628,1071,60040,1199,41476,359,4112,1071,35031,1537,37140,1430,72171,California
Merced,2021-04-02,2495,108123,756,60796,1310,42786,429,4541,800,34606,1645,38785,1220,73391,California
Merced,2021-04-03,1121,109244,626,61422,476,43262,19,4560,686,34885,426,39211,705,74096,California
Merced,2021-04-04,367,109611,143,61565,223,43485,1,4561,138,34797,228,39439,140,74236,California
Merced,2021-04-05,1523,111134,831,62396,478,43963,214,4775,413,34325,1100,40539,628,74864,California
Merced,2021-04-06,2608,113742,1064,63460,711,44674,833,5608,891,34340,1708,42247,1723,76587,California
Merced,2021-04-07,1931,115673,1141,64601,682,45356,108,5716,595,33751,1295,43542,706,77293,California
Merced,2021-04-08,2531,118204,1366,65967,945,46301,220,5936,1010,33507,1470,45012,1226,78519,California
Merced,2021-04-09,1746,119950,493,66460,667,46968,586,6522,569,33508,1154,46166,1155,79674,California
Merced,2021-04-10,990,120940,377,66837,426,47394,187,6709,181,33073,801,46967,366,80040,California
Merced,2021-04-11,492,121432,286,67123,71,47465,135,6844,150,33020,339,47306,286,80326,California
Merced,2021-04-12,1562,122994,1021,68144,413,47878,128,6972,885,33397,636,47942,1013,81339,California
Merced,2021-04-13,2075,125069,1485,69629,588,48466,2,6974,939,33309,1033,48975,945,82284,California
Merced,2021-04-14,2293,127362,1429,71058,864,49330,0,6974,1060,33276,1096,50071,1063,83347,California
Merced,2021-04-15,3068,130430,1999,73057,1069,50399,0,6974,953,32358,1875,51946,957,84304,California
Merced,2021-04-16,2441,132871,1191,74248,1250,51649,0,6974,978,31986,1351,53297,979,85283,California
Merced,2021-04-17,2193,135064,1518,75766,674,52323,1,6975,693,31194,1490,54787,698,85981,California
Merced,2021-04-18,578,135642,351,76117,227,52550,0,6975,206,31056,344,55131,206,86187,California
Merced,2021-04-19,1375,137017,764,76881,611,53161,0,6975,701,31185,572,55703,701,86888,California
Merced,2021-04-20,1582,138599,797,77678,785,53946,0,6975,810,31296,699,56402,810,87698,California
Merced,2021-04-21,1671,140270,1056,78734,615,54561,0,6975,804,31354,748,57150,806,88504,California
Merced,2021-04-22,1745,142015,805,79539,940,55501,0,6975,796,31297,854,58004,797,89301,California
Merced,2021-04-23,1731,143746,739,80278,992,56493,0,6975,924,31468,754,58758,925,90226,California
Merced,2021-04-24,902,144648,719,80997,183,56676,0,6975,550,31674,345,59103,551,90777,California
Merced,2021-04-25,334,144982,190,81187,144,56820,0,6975,191,31729,137,59240,192,90969,California
Merced,2021-04-26,1301,146283,566,81753,735,57555,0,6975,656,31781,606,59846,658,91627,California
Merced,2021-04-27,1844,148127,935,82688,897,58452,12,6987,745,31513,1026,60872,758,92385,California
Merced,2021-04-28,1450,149577,728,83416,713,59165,9,6996,822,31743,601,61473,831,93216,California
Merced,2021-04-29,1526,151103,687,84103,814,59979,25,7021,717,31692,794,62267,743,93959,California
Merced,2021-04-30,1528,152631,660,84763,823,60802,45,7066,793,31803,727,62994,838,94797,California
Merced,2021-05-01,587,153218,249,85012,333,61135,5,7071,273,31775,305,63299,277,95074,California
Merced,2021-05-02,303,153521,126,85138,162,61297,15,7086,124,31737,178,63477,140,95214,California
Merced,2021-05-03,897,154418,598,85736,226,61523,73,7159,322,31562,571,64048,396,95610,California
Merced,2021-05-04,1086,155504,597,86333,438,61961,51,7210,392,31319,686,64734,443,96053,California
Merced,2021-05-05,1477,156981,969,87302,434,62395,74,7284,644,31219,819,65553,719,96772,California
Merced,2021-05-06,976,157957,529,87831,397,62792,50,7334,323,30949,643,66196,373,97145,California
Merced,2021-05-07,1218,159175,555,88386,621,63413,42,7376,474,30733,737,66933,521,97666,California
Merced,2021-05-08,457,159632,258,88644,161,63574,38,7414,217,30751,237,67170,255,97921,California
Merced,2021-05-09,223,159855,115,88759,101,63675,7,7421,99,30734,123,67293,106,98027,California
Merced,2021-05-10,736,160591,391,89150,308,63983,37,7458,204,30447,528,67821,241,98268,California
Merced,2021-05-11,1227,161818,739,89889,427,64410,61,7519,480,30248,740,68561,541,98809,California
Merced,2021-05-12,1129,162947,642,90531,445,64855,42,7561,384,29934,739,69300,425,99234,California
Merced,2021-05-13,983,163930,567,91098,373,65228,43,7604,448,29896,529,69829,491,99725,California
Merced,2021-05-14,1105,165035,685,91783,380,65608,40,7644,584,30014,510,70339,628,100353,California
Merced,2021-05-15,772,165807,585,92368,169,65777,18,7662,456,30185,305,70644,476,100829,California
Merced,2021-05-16,371,166178,253,92621,109,65886,9,7671,215,30258,152,70796,225,101054,California
Merced,2021-05-17,1114,167292,727,93348,354,66240,33,7704,548,30282,558,71354,582,101636,California
Merced,2021-05-18,1285,168577,855,94203,399,66639,31,7735,707,30451,569,71923,738,102374,California
Merced,2021-05-19,1157,169734,765,94968,385,67024,7,7742,648,30607,504,72427,660,103034,California
Merced,2021-05-20,1110,170844,601,95569,452,67476,57,7799,431,30421,677,73104,491,103525,California
Merced,2021-05-21,1225,172069,711,96280,485,67961,29,7828,500,30242,710,73814,531,104056,California
Merced,2021-05-22,795,172864,575,96855,206,68167,14,7842,477,30421,315,74129,494,104550,California
Merced,2021-05-23,362,173226,261,97116,88,68255,13,7855,238,30549,123,74252,251,104801,California
Merced,2021-05-24,641,173867,275,97391,335,68590,31,7886,232,30411,402,74654,264,105065,California
Merced,2021-05-25,788,174655,445,97836,310,68900,33,7919,403,30467,380,75034,436,105501,California
Merced,2021-05-26,1019,175674,566,98402,420,69320,33,7952,405,30297,610,75644,440,105941,California
Merced,2021-05-27,939,176613,657,99059,245,69565,37,7989,551,30502,385,76029,590,106531,California
Merced,2021-05-28,794,177407,366,99425,381,69946,47,8036,332,30430,452,76481,380,106911,California
Merced,2021-05-29,390,177797,269,99694,113,70059,8,8044,157,30367,230,76711,167,107078,California
Merced,2021-05-30,214,178011,147,99841,56,70115,11,8055,119,30402,95,76806,130,107208,California
Merced,2021-05-31,113,178124,25,99866,80,70195,8,8063,30,30360,81,76887,39,107247,California
Merced,2021-06-01,881,179005,550,100416,296,70491,35,8098,323,30165,551,77438,356,107603,California
Merced,2021-06-02,770,179775,497,100913,246,70737,27,8125,354,30138,408,77846,381,107984,California
Merced,2021-06-03,782,180557,499,101412,249,70986,34,8159,303,30008,470,78316,340,108324,California
Merced,2021-06-04,844,181401,456,101868,366,71352,22,8181,311,29817,526,78842,335,108659,California
Merced,2021-06-05,521,181922,410,102278,97,71449,14,8195,194,29704,321,79163,208,108867,California
Merced,2021-06-06,235,182157,194,102472,32,71481,9,8204,83,29644,151,79314,91,108958,California
Merced,2021-06-07,670,182827,535,103007,119,71600,16,8220,196,29387,472,79786,215,109173,California
Merced,2021-06-08,868,183695,639,103646,204,71804,25,8245,275,29098,589,80375,300,109473,California
Merced,2021-06-09,892,184587,654,104300,222,72026,16,8261,263,28761,617,80992,280,109753,California
Merced,2021-06-10,662,185249,456,104756,182,72208,24,8285,256,28642,398,81390,279,110032,California
Merced,2021-06-11,581,185830,370,105126,194,72402,17,8302,238,28559,340,81730,257,110289,California
Merced,2021-06-12,602,186432,490,105616,88,72490,24,8326,181,28344,419,82149,204,110493,California
Merced,2021-06-13,259,186691,135,105751,117,72607,7,8333,63,28218,196,82345,70,110563,California
Merced,2021-06-14,560,187251,368,106119,158,72765,34,8367,258,28212,299,82644,293,110856,California
Merced,2021-06-15,806,188057,575,106694,203,72968,28,8395,272,27988,525,83169,301,111157,California
Merced,2021-06-16,735,188792,505,107199,203,73171,27,8422,332,27955,393,83562,360,111517,California
Merced,2021-06-17,748,189540,569,107768,149,73320,30,8452,245,27734,496,84058,275,111792,California
Merced,2021-06-18,788,190328,516,108284,241,73561,31,8483,396,27776,385,84443,427,112219,California
Merced,2021-06-19,367,190695,252,108536,88,73649,27,8510,200,27837,165,84608,226,112445,California
Merced,2021-06-20,246,190941,190,108726,47,73696,9,8519,141,27883,104,84712,150,112595,California
Merced,2021-06-21,328,191269,202,108928,113,73809,13,8532,203,27976,123,84835,216,112811,California
Merced,2021-06-22,538,191807,368,109296,149,73958,21,8553,266,27993,271,85106,288,113099,California
Merced,2021-06-23,590,192397,368,109664,211,74169,11,8564,294,28010,288,85394,305,113404,California
Merced,2021-06-24,552,192949,389,110053,131,74300,32,8596,260,28015,287,85681,292,113696,California
Merced,2021-06-25,491,193440,345,110398,122,74422,24,8620,258,28070,227,85908,282,113978,California
Merced,2021-06-26,302,193742,221,110619,63,74485,18,8638,137,28063,163,86071,156,114134,California
Merced,2021-06-27,229,193971,167,110786,39,74524,23,8661,130,28118,98,86169,153,114287,California
Merced,2021-06-28,380,194351,257,111043,106,74630,17,8678,194,28149,181,86350,212,114499,California
Merced,2021-06-29,485,194836,333,111376,124,74754,28,8706,238,28171,244,86594,266,114765,California
Merced,2021-06-30,565,195401,358,111734,182,74936,25,8731,312,28261,248,86842,338,115103,California
Merced,2021-07-01,509,195910,372,112106,120,75056,17,8748,294,28357,215,87057,311,115414,California
Merced,2021-07-02,515,196425,379,112485,117,75173,19,8767,298,28462,213,87270,318,115732,California
Merced,2021-07-03,298,196723,201,112686,76,75249,21,8788,152,28494,141,87411,173,115905,California
Merced,2021-07-04,18,196741,6,112692,11,75260,1,8789,8,28493,10,87421,9,115914,California
Merced,2021-07-05,294,197035,203,112895,86,75346,5,8794,158,28521,136,87557,164,116078,California
Merced,2021-07-06,489,197524,333,113228,130,75476,26,8820,212,28489,271,87828,239,116317,California
Merced,2021-07-07,480,198004,297,113525,164,75640,19,8839,222,28474,256,88084,241,116558,California
Merced,2021-07-08,502,198506,387,113912,108,75748,7,8846,234,28449,266,88350,241,116799,California
Merced,2021-07-09,622,199128,458,114370,139,75887,25,8871,282,28417,339,88689,307,117106,California
Merced,2021-07-10,276,199404,222,114592,43,75930,11,8882,141,28435,134,88823,152,117258,California
Merced,2021-07-11,222,199626,186,114778,32,75962,4,8886,84,28389,134,88957,88,117346,California
Merced,2021-07-12,377,200003,255,115033,109,76071,13,8899,167,28361,210,89167,182,117528,California
Merced,2021-07-13,440,200443,327,115360,96,76167,17,8916,206,28352,233,89400,224,117752,California
Merced,2021-07-14,473,200916,303,115663,157,76324,13,8929,231,28358,239,89639,245,117997,California
Merced,2021-07-15,455,201371,362,116025,85,76409,8,8937,246,28405,207,89846,254,118251,California
Merced,2021-07-16,521,201892,346,116371,156,76565,19,8956,283,28471,236,90082,302,118553,California
Merced,2021-07-17,265,202157,195,116566,61,76626,9,8965,160,28536,104,90186,169,118722,California
Merced,2021-07-18,136,202293,92,116658,32,76658,12,8977,72,28558,62,90248,84,118806,California
Merced,2021-07-19,385,202678,281,116939,92,76750,12,8989,202,28593,179,90427,214,119020,California
Merced,2021-07-20,524,203202,412,117351,104,76854,8,8997,258,28593,266,90693,266,119286,California
Merced,2021-07-21,601,203803,396,117747,188,77042,17,9014,316,28645,281,90974,333,119619,California
Merced,2021-07-22,536,204339,390,118137,129,77171,17,9031,300,28730,234,91208,319,119938,California
Merced,2021-07-23,624,204963,456,118593,142,77313,26,9057,368,28871,251,91459,392,120330,California
Merced,2021-07-24,326,205289,225,118818,91,77404,10,9067,189,28935,135,91594,199,120529,California
Merced,2021-07-25,185,205474,133,118951,41,77445,11,9078,136,29034,48,91642,147,120676,California
Merced,2021-07-26,472,205946,311,119262,143,77588,18,9096,309,29203,159,91801,328,121004,California
Merced,2021-07-27,582,206528,454,119716,116,77704,12,9108,375,29386,203,92004,386,121390,California
Merced,2021-07-28,619,207147,414,120130,186,77890,19,9127,381,29551,235,92239,400,121790,California
Merced,2021-07-29,525,207672,401,120531,107,77997,17,9144,335,29716,187,92426,352,122142,California
Merced,2021-07-30,645,208317,440,120971,178,78175,27,9171,428,29955,216,92642,455,122597,California
Merced,2021-07-31,356,208673,247,121218,91,78266,18,9189,228,30074,127,92769,246,122843,California
Merced,2021-08-01,204,208877,151,121369,50,78316,3,9192,150,30175,52,92821,153,122996,California
Merced,2021-08-02,544,209421,422,121791,117,78433,5,9197,393,30423,151,92972,399,123395,California
Merced,2021-08-03,707,210128,548,122339,148,78581,11,9208,519,30768,183,93155,528,123923,California
Merced,2021-08-04,614,210742,410,122749,185,78766,19,9227,401,30976,211,93366,419,124342,California
Merced,2021-08-05,786,211528,631,123380,129,78895,26,9253,563,31343,220,93586,587,124929,California
Merced,2021-08-06,808,212336,595,123975,185,79080,28,9281,589,31746,216,93802,619,125548,California
Merced,2021-08-07,517,212853,398,124373,109,79189,10,9291,378,31997,138,93940,389,125937,California
Merced,2021-08-08,274,213127,217,124590,49,79238,8,9299,206,32145,66,94006,214,126151,California
Merced,2021-08-09,705,213832,543,125133,136,79374,26,9325,477,32421,227,94233,503,126654,California
Merced,2021-08-10,651,214483,491,125624,141,79515,19,9344,411,32622,231,94464,432,127086,California
Merced,2021-08-11,626,215109,397,126021,209,79724,20,9364,405,32833,215,94679,426,127512,California
Merced,2021-08-12,643,215752,473,126494,153,79877,17,9381,434,33083,201,94880,451,127963,California
Merced,2021-08-13,889,216641,626,127120,245,80122,18,9399,561,33346,316,95196,579,128542,California
Merced,2021-08-14,427,217068,330,127450,90,80212,7,9406,267,33467,153,95349,274,128816,California
Merced,2021-08-15,349,217417,262,127712,82,80294,5,9411,241,33609,106,95455,248,129064,California
Merced,2021-08-16,639,218056,435,128147,190,80484,14,9425,384,33771,236,95691,398,129462,California
Merced,2021-08-17,708,218764,551,128698,143,80627,14,9439,401,33899,288,95979,416,129878,California
Merced,2021-08-18,739,219503,496,129194,225,80852,18,9457,418,34042,293,96272,436,130314,California
Merced,2021-08-19,701,220204,514,129708,171,81023,16,9473,404,34191,273,96545,422,130736,California
Merced,2021-08-20,875,221079,646,130354,219,81242,10,9483,509,34384,327,96872,520,131256,California
Merced,2021-08-21,435,221514,333,130687,95,81337,7,9490,259,34484,165,97037,265,131521,California
Merced,2021-08-22,269,221783,171,130858,93,81430,5,9495,162,34551,100,97137,167,131688,California
Merced,2021-08-23,776,222559,592,131450,171,81601,13,9508,417,34638,343,97480,430,132118,California
Merced,2021-08-24,685,223244,539,131989,137,81738,9,9517,372,34724,295,97775,381,132499,California
Merced,2021-08-25,684,223928,520,132509,153,81891,11,9528,372,34814,292,98067,382,132881,California
Merced,2021-08-26,850,224778,676,133185,154,82045,20,9548,385,34803,418,98485,407,133288,California
Merced,2021-08-27,1067,225845,881,134066,177,82222,9,9557,557,34888,486,98971,571,133859,California
Merced,2021-08-28,536,226381,431,134497,104,82326,1,9558,253,34866,277,99248,255,134114,California
Merced,2021-08-29,243,226624,179,134676,64,82390,0,9558,115,34857,124,99372,115,134229,California
Merced,2021-08-30,200,226824,103,134779,94,82484,3,9561,99,34870,90,99462,103,134332,California
Modoc,2020-12-16,2,2,2,2,0,0,0,0,2,2,0,0,2,2,California
Modoc,2020-12-21,99,101,99,101,0,0,0,0,99,101,0,0,99,101,California
Modoc,2020-12-22,14,115,14,115,0,0,0,0,14,115,0,0,14,115,California
Modoc,2020-12-23,4,119,4,119,0,0,0,0,4,119,0,0,4,119,California
Modoc,2020-12-24,1,120,1,120,0,0,0,0,1,120,0,0,1,120,California
Modoc,2020-12-28,2,122,2,122,0,0,0,0,2,122,0,0,2,122,California
Modoc,2020-12-29,9,131,1,123,8,8,0,0,9,131,0,0,9,131,California
Modoc,2020-12-30,9,140,2,125,7,15,0,0,9,140,0,0,9,140,California
Modoc,2021-01-02,3,143,1,126,2,17,0,0,3,143,0,0,3,143,California
Modoc,2021-01-04,8,151,0,126,8,25,0,0,8,151,0,0,8,151,California
Modoc,2021-01-05,3,154,2,128,1,26,0,0,3,154,0,0,3,154,California
Modoc,2021-01-06,5,159,4,132,1,27,0,0,3,155,2,2,3,157,California
Modoc,2021-01-07,71,230,0,132,71,98,0,0,71,226,0,2,71,228,California
Modoc,2021-01-08,108,338,0,132,108,206,0,0,108,334,0,2,108,336,California
Modoc,2021-01-10,2,340,2,134,0,206,0,0,1,334,1,3,1,337,California
Modoc,2021-01-11,90,430,81,215,9,215,0,0,19,282,71,74,19,356,California
Modoc,2021-01-12,95,525,26,241,69,284,0,0,69,325,26,100,69,425,California
Modoc,2021-01-13,24,549,4,245,20,304,0,0,22,345,2,102,22,447,California
Modoc,2021-01-14,128,677,6,251,122,426,0,0,123,463,5,107,123,570,California
Modoc,2021-01-15,6,683,1,252,5,431,0,0,6,469,0,107,6,576,California
Modoc,2021-01-16,2,685,1,253,1,432,0,0,2,471,0,107,2,578,California
Modoc,2021-01-18,3,688,1,254,2,434,0,0,3,474,0,107,3,581,California
Modoc,2021-01-19,5,693,3,257,2,436,0,0,3,475,2,109,3,584,California
Modoc,2021-01-20,15,708,4,261,11,447,0,0,13,486,2,111,13,597,California
Modoc,2021-01-21,160,868,2,263,158,605,0,0,160,646,0,111,160,757,California
Modoc,2021-01-22,5,873,3,266,2,607,0,0,5,651,0,111,5,762,California
Modoc,2021-01-25,12,885,0,266,12,619,0,0,12,663,0,111,12,774,California
Modoc,2021-01-26,118,1003,2,268,116,735,0,0,118,781,0,111,118,892,California
Modoc,2021-01-27,47,1050,3,271,44,779,0,0,32,798,15,126,32,924,California
Modoc,2021-01-28,147,1197,4,275,143,922,0,0,146,943,1,127,146,1070,California
Modoc,2021-01-29,4,1201,1,276,3,925,0,0,4,947,0,127,4,1074,California
Modoc,2021-02-01,26,1227,12,288,14,939,0,0,12,945,14,141,12,1086,California
Modoc,2021-02-02,176,1403,2,290,174,1113,0,0,173,1115,3,144,173,1259,California
Modoc,2021-02-03,18,1421,13,303,5,1118,0,0,11,1119,7,151,11,1270,California
Modoc,2021-02-04,160,1581,4,307,156,1274,0,0,32,1023,128,279,32,1302,California
Modoc,2021-02-05,4,1585,2,309,2,1276,0,0,2,1023,2,281,2,1304,California
Modoc,2021-02-08,11,1596,1,310,10,1286,0,0,10,1032,1,282,10,1314,California
Modoc,2021-02-09,199,1795,11,321,188,1474,0,0,66,965,133,415,66,1380,California
Modoc,2021-02-10,7,1802,4,325,3,1477,0,0,5,968,2,417,5,1385,California
Modoc,2021-02-11,200,2002,2,327,198,1675,0,0,83,934,117,534,83,1468,California
Modoc,2021-02-12,11,2013,4,331,7,1682,0,0,4,931,7,541,4,1472,California
Modoc,2021-02-13,2,2015,0,331,2,1684,0,0,1,931,1,542,1,1473,California
Modoc,2021-02-16,147,2162,6,337,141,1825,0,0,140,1064,7,549,140,1613,California
Modoc,2021-02-17,24,2186,2,339,22,1847,0,0,10,1060,14,563,10,1623,California
Modoc,2021-02-18,191,2377,4,343,187,2034,0,0,22,916,168,731,24,1647,California
Modoc,2021-02-19,4,2381,4,347,0,2034,0,0,2,916,2,733,2,1649,California
Modoc,2021-02-20,1,2382,1,348,0,2034,0,0,0,915,1,734,0,1649,California
Modoc,2021-02-22,18,2400,8,356,10,2044,0,0,3,903,15,749,3,1652,California
Modoc,2021-02-23,87,2487,2,358,85,2129,0,0,14,844,73,822,14,1666,California
Modoc,2021-02-24,95,2582,3,361,92,2221,0,0,32,813,63,885,32,1698,California
Modoc,2021-02-25,173,2755,2,363,171,2392,0,0,14,668,159,1044,14,1712,California
Modoc,2021-02-26,2,2757,0,363,2,2394,0,0,1,668,1,1045,1,1713,California
Modoc,2021-02-27,2,2759,2,365,0,2394,0,0,2,670,0,1045,2,1715,California
Modoc,2021-03-01,7,2766,0,365,7,2401,0,0,1,666,5,1050,1,1716,California
Modoc,2021-03-02,198,2964,11,376,187,2588,0,0,26,520,172,1222,26,1742,California
Modoc,2021-03-03,13,2977,7,383,6,2594,0,0,2,511,11,1233,2,1744,California
Modoc,2021-03-04,173,3150,0,383,173,2767,0,0,145,628,28,1261,145,1889,California
Modoc,2021-03-05,2,3152,1,384,1,2768,0,0,1,628,1,1262,1,1890,California
Modoc,2021-03-06,11,3163,0,384,1,2769,10,10,1,629,10,1272,11,1901,California
Modoc,2021-03-07,8,3171,2,386,0,2769,6,16,2,631,6,1278,8,1909,California
Modoc,2021-03-08,8,3179,1,387,3,2772,4,20,1,630,6,1284,5,1914,California
Modoc,2021-03-09,127,3306,10,397,108,2880,9,29,61,634,66,1350,70,1984,California
Modoc,2021-03-10,9,3315,3,400,2,2882,4,33,4,637,5,1355,8,1992,California
Modoc,2021-03-11,209,3524,1,401,99,2981,109,142,23,583,186,1541,132,2124,California
Modoc,2021-03-12,10,3534,1,402,4,2985,5,147,4,586,6,1547,9,2133,California
Modoc,2021-03-13,6,3540,0,402,3,2988,3,150,1,585,5,1552,4,2137,California
Modoc,2021-03-15,13,3553,0,402,12,3000,1,151,12,597,1,1553,13,2150,California
Modoc,2021-03-16,174,3727,2,404,168,3168,4,155,42,510,132,1685,45,2195,California
Modoc,2021-03-17,11,3738,1,405,5,3173,5,160,2,508,9,1694,7,2202,California
Modoc,2021-03-18,67,3805,2,407,58,3231,7,167,34,516,33,1727,41,2243,California
Modoc,2021-03-19,5,3810,0,407,0,3231,5,172,0,516,5,1732,5,2248,California
Modoc,2021-03-20,5,3815,2,409,0,3231,3,175,0,514,5,1737,3,2251,California
Modoc,2021-03-21,3,3818,1,410,0,3231,2,177,1,515,2,1739,3,2254,California
Modoc,2021-03-22,17,3835,1,411,11,3242,5,182,12,527,5,1744,17,2271,California
Modoc,2021-03-23,65,3900,6,417,56,3298,3,185,43,551,22,1766,46,2317,California
Modoc,2021-03-24,29,3929,1,418,18,3316,10,195,1,534,28,1794,11,2328,California
Modoc,2021-03-25,78,4007,3,421,73,3389,2,197,46,550,32,1826,48,2376,California
Modoc,2021-03-26,7,4014,3,424,1,3390,3,200,2,550,5,1831,5,2381,California
Modoc,2021-03-27,2,4016,0,424,1,3391,1,201,1,551,1,1832,2,2383,California
Modoc,2021-03-29,15,4031,1,425,6,3397,8,209,6,556,9,1841,14,2397,California
Modoc,2021-03-30,56,4087,9,434,41,3438,6,215,23,552,33,1874,29,2426,California
Modoc,2021-03-31,10,4097,2,436,4,3442,4,219,4,554,6,1880,8,2434,California
Modoc,2021-04-01,168,4265,3,439,160,3602,5,224,34,459,134,2014,39,2473,California
Modoc,2021-04-02,5,4270,0,439,2,3604,3,227,1,460,3,2017,4,2477,California
Modoc,2021-04-03,3,4273,0,439,0,3604,3,230,0,460,2,2019,2,2479,California
Modoc,2021-04-05,10,4283,0,439,9,3613,1,231,9,469,1,2020,10,2489,California
Modoc,2021-04-06,24,4307,6,445,8,3621,10,241,6,467,18,2038,16,2505,California
Modoc,2021-04-07,11,4318,0,445,4,3625,7,248,3,469,8,2046,10,2515,California
Modoc,2021-04-08,94,4412,1,446,92,3717,1,249,26,428,68,2114,27,2542,California
Modoc,2021-04-09,11,4423,2,448,6,3723,3,252,2,423,9,2123,4,2546,California
Modoc,2021-04-10,5,4428,0,448,1,3724,4,256,0,422,5,2128,4,2550,California
Modoc,2021-04-11,1,4429,1,449,0,3724,0,256,0,421,1,2129,0,2550,California
Modoc,2021-04-12,13,4442,0,449,9,3733,4,260,1,415,11,2140,5,2555,California
Modoc,2021-04-13,33,4475,29,478,4,3737,0,260,22,426,11,2151,22,2577,California
Modoc,2021-04-14,4,4479,3,481,1,3738,0,260,2,426,2,2153,2,2579,California
Modoc,2021-04-15,101,4580,0,481,101,3839,0,260,28,382,72,2225,28,2607,California
Modoc,2021-04-16,7,4587,5,486,2,3841,0,260,6,387,1,2226,6,2613,California
Modoc,2021-04-17,2,4589,2,488,0,3841,0,260,2,389,0,2226,2,2615,California
Modoc,2021-04-18,1,4590,0,488,1,3842,0,260,1,390,0,2226,1,2616,California
Modoc,2021-04-19,7,4597,0,488,7,3849,0,260,2,387,5,2231,2,2618,California
Modoc,2021-04-20,48,4645,2,490,46,3895,0,260,12,363,36,2267,12,2630,California
Modoc,2021-04-21,2,4647,2,492,0,3895,0,260,1,363,1,2268,1,2631,California
Modoc,2021-04-22,96,4743,3,495,93,3988,0,260,38,343,58,2326,38,2669,California
Modoc,2021-04-23,4,4747,0,495,4,3992,0,260,4,347,0,2326,4,2673,California
Modoc,2021-04-24,2,4749,0,495,1,3993,1,261,1,348,1,2327,2,2675,California
Modoc,2021-04-25,1,4750,1,496,0,3993,0,261,1,349,0,2327,1,2676,California
Modoc,2021-04-26,8,4758,0,496,8,4001,0,261,2,345,6,2333,2,2678,California
Modoc,2021-04-27,8,4766,6,502,1,4002,1,262,1,340,7,2340,2,2680,California
Modoc,2021-04-28,8,4774,2,504,5,4007,1,263,3,339,5,2345,4,2684,California
Modoc,2021-04-29,66,4840,0,504,66,4073,0,263,20,313,46,2391,20,2704,California
Modoc,2021-04-30,4,4844,3,507,1,4074,0,263,2,313,2,2393,2,2706,California
Modoc,2021-05-02,2,4846,2,509,0,4074,0,263,2,315,0,2393,2,2708,California
Modoc,2021-05-03,15,4861,0,509,15,4089,0,263,6,312,9,2402,6,2714,California
Modoc,2021-05-04,8,4869,2,511,4,4093,2,265,3,312,5,2407,5,2719,California
Modoc,2021-05-05,29,4898,26,537,2,4095,1,266,8,300,21,2428,9,2728,California
Modoc,2021-05-06,55,4953,3,540,50,4145,2,268,21,289,34,2462,23,2751,California
Modoc,2021-05-07,8,4961,3,543,3,4148,2,270,2,287,6,2468,4,2755,California
Modoc,2021-05-08,3,4964,2,545,0,4148,1,271,1,287,2,2470,2,2757,California
Modoc,2021-05-09,1,4965,1,546,0,4148,0,271,0,286,1,2471,0,2757,California
Modoc,2021-05-10,2,4967,0,546,1,4149,1,272,1,287,1,2472,2,2759,California
Modoc,2021-05-11,3,4970,2,548,0,4149,1,273,0,285,3,2475,1,2760,California
Modoc,2021-05-12,3,4973,0,548,0,4149,3,276,0,285,3,2478,3,2763,California
Modoc,2021-05-13,43,5016,0,548,39,4188,4,280,14,274,29,2507,18,2781,California
Modoc,2021-05-14,8,5024,3,551,0,4188,5,285,3,277,5,2512,8,2789,California
Modoc,2021-05-15,1,5025,0,551,1,4189,0,285,1,278,0,2512,1,2790,California
Modoc,2021-05-16,2,5027,1,552,1,4190,0,285,0,276,2,2514,0,2790,California
Modoc,2021-05-17,6,5033,2,554,4,4194,0,285,3,276,3,2517,3,2793,California
Modoc,2021-05-18,28,5061,12,566,14,4208,2,287,13,276,15,2532,15,2808,California
Modoc,2021-05-19,9,5070,2,568,3,4211,4,291,4,279,5,2537,8,2816,California
Modoc,2021-05-20,57,5127,2,570,46,4257,9,300,8,247,49,2586,17,2833,California
Modoc,2021-05-21,4,5131,2,572,1,4258,1,301,0,244,4,2590,1,2834,California
Modoc,2021-05-22,3,5134,2,574,1,4259,0,301,1,243,2,2592,1,2835,California
Modoc,2021-05-23,2,5136,2,576,0,4259,0,301,0,241,2,2594,0,2835,California
Modoc,2021-05-24,4,5140,1,577,1,4260,2,303,2,243,2,2596,4,2839,California
Modoc,2021-05-25,1,5141,0,577,1,4261,0,303,1,244,0,2596,1,2840,California
Modoc,2021-05-26,35,5176,32,609,3,4264,0,303,26,261,9,2605,26,2866,California
Modoc,2021-05-27,32,5208,4,613,22,4286,6,309,9,253,23,2628,15,2881,California
Modoc,2021-05-28,8,5216,1,614,4,4290,3,312,3,254,5,2633,6,2887,California
Modoc,2021-05-29,1,5217,1,615,0,4290,0,312,0,253,1,2634,0,2887,California
Modoc,2021-05-31,1,5218,0,615,0,4290,1,313,0,253,0,2634,0,2887,California
Modoc,2021-06-01,7,5225,1,616,5,4295,1,314,3,253,4,2638,4,2891,California
Modoc,2021-06-02,12,5237,0,616,10,4305,2,316,4,251,8,2646,6,2897,California
Modoc,2021-06-03,24,5261,1,617,21,4326,2,318,4,237,20,2666,6,2903,California
Modoc,2021-06-04,5,5266,3,620,1,4327,1,319,0,233,5,2671,1,2904,California
Modoc,2021-06-07,3,5269,3,623,0,4327,0,319,1,232,2,2673,1,2905,California
Modoc,2021-06-08,27,5296,9,632,17,4344,1,320,18,241,9,2682,18,2923,California
Modoc,2021-06-09,3,5299,2,634,1,4345,0,320,2,242,1,2683,2,2925,California
Modoc,2021-06-10,21,5320,1,635,19,4364,1,321,7,236,14,2697,8,2933,California
Modoc,2021-06-11,2,5322,1,636,1,4365,0,321,2,238,0,2697,2,2935,California
Modoc,2021-06-12,1,5323,1,637,0,4365,0,321,0,237,1,2698,0,2935,California
Modoc,2021-06-14,4,5327,0,637,2,4367,2,323,0,235,4,2702,2,2937,California
Modoc,2021-06-15,7,5334,1,638,4,4371,2,325,4,238,3,2705,6,2943,California
Modoc,2021-06-16,41,5375,25,663,11,4382,5,330,22,248,19,2724,29,2972,California
Modoc,2021-06-17,48,5423,22,685,25,4407,1,331,27,255,21,2745,28,3000,California
Modoc,2021-06-18,5,5428,0,685,3,4410,2,333,3,258,2,2747,5,3005,California
Modoc,2021-06-19,3,5431,0,685,1,4411,2,335,1,259,2,2749,3,3008,California
Modoc,2021-06-21,2,5433,1,686,1,4412,0,335,2,261,0,2749,2,3010,California
Modoc,2021-06-22,10,5443,4,690,6,4418,0,335,7,265,3,2752,7,3017,California
Modoc,2021-06-23,6,5449,0,690,3,4421,3,338,1,264,5,2757,4,3021,California
Modoc,2021-06-24,33,5482,14,704,15,4436,4,342,23,281,10,2767,27,3048,California
Modoc,2021-06-25,8,5490,0,704,5,4441,3,345,2,280,6,2773,5,3053,California
Modoc,2021-06-28,4,5494,1,705,3,4444,0,345,3,282,1,2774,3,3056,California
Modoc,2021-06-29,11,5505,2,707,8,4452,1,346,8,288,3,2777,9,3065,California
Modoc,2021-06-30,8,5513,1,708,7,4459,0,346,5,290,3,2780,5,3070,California
Modoc,2021-07-01,23,5536,11,719,1,4460,11,357,9,296,14,2794,20,3090,California
Modoc,2021-07-02,2,5538,2,721,0,4460,0,357,0,294,2,2796,0,3090,California
Modoc,2021-07-03,3,5541,0,721,3,4463,0,357,3,297,0,2796,3,3093,California
Modoc,2021-07-06,11,5552,4,725,7,4470,0,357,6,298,5,2801,6,3099,California
Modoc,2021-07-07,6,5558,1,726,4,4474,1,358,3,299,3,2804,4,3103,California
Modoc,2021-07-08,73,5631,36,762,31,4505,6,364,20,272,53,2857,26,3129,California
Modoc,2021-07-09,1,5632,0,762,0,4505,1,365,0,272,1,2858,1,3130,California
Modoc,2021-07-10,1,5633,0,762,1,4506,0,365,1,273,0,2858,1,3131,California
Modoc,2021-07-11,1,5634,0,762,1,4507,0,365,1,274,0,2858,1,3132,California
Modoc,2021-07-13,7,5641,2,764,5,4512,0,365,3,273,4,2862,3,3135,California
Modoc,2021-07-14,4,5645,0,764,4,4516,0,365,1,271,3,2865,1,3136,California
Modoc,2021-07-15,45,5690,19,783,23,4539,3,368,12,253,33,2898,15,3151,California
Modoc,2021-07-16,4,5694,0,783,4,4543,0,368,1,251,3,2901,1,3152,California
Modoc,2021-07-19,4,5698,2,785,2,4545,0,368,4,255,0,2901,4,3156,California
Modoc,2021-07-20,23,5721,12,797,9,4554,2,370,11,258,12,2913,15,3171,California
Modoc,2021-07-21,2,5723,0,797,2,4556,0,370,0,256,2,2915,0,3171,California
Modoc,2021-07-22,23,5746,9,806,12,4568,2,372,4,243,19,2934,6,3177,California
Modoc,2021-07-23,7,5753,2,808,5,4573,0,372,5,246,2,2936,5,3182,California
Modoc,2021-07-24,1,5754,0,808,1,4574,0,372,1,247,0,2936,1,3183,California
Modoc,2021-07-26,7,5761,3,811,3,4577,1,373,4,249,3,2939,5,3188,California
Modoc,2021-07-27,13,5774,5,816,6,4583,2,375,3,244,10,2949,5,3193,California
Modoc,2021-07-28,14,5788,2,818,10,4593,2,377,6,244,8,2957,8,3201,California
Modoc,2021-07-29,34,5822,30,848,4,4597,0,377,20,250,14,2971,20,3221,California
Modoc,2021-07-30,8,5830,0,848,7,4604,1,378,6,255,2,2973,7,3228,California
Modoc,2021-07-31,5,5835,1,849,4,4608,0,378,2,254,3,2976,2,3230,California
Modoc,2021-08-02,2,5837,0,849,2,4610,0,378,2,256,0,2976,2,3232,California
Modoc,2021-08-03,24,5861,10,859,7,4617,7,385,12,263,12,2988,19,3251,California
Modoc,2021-08-04,8,5869,3,862,5,4622,0,385,3,261,5,2993,3,3254,California
Modoc,2021-08-05,28,5897,10,872,16,4638,2,387,21,277,7,3000,23,3277,California
Modoc,2021-08-06,3,5900,0,872,3,4641,0,387,1,277,1,3001,1,3278,California
Modoc,2021-08-07,3,5903,0,872,3,4644,0,387,2,278,1,3002,2,3280,California
Modoc,2021-08-08,1,5904,0,872,1,4645,0,387,0,277,1,3003,0,3280,California
Modoc,2021-08-09,12,5916,8,880,3,4648,1,388,8,282,4,3007,9,3289,California
Modoc,2021-08-10,23,5939,7,887,11,4659,5,393,11,286,12,3019,16,3305,California
Modoc,2021-08-11,2,5941,1,888,1,4660,0,393,2,288,0,3019,2,3307,California
Modoc,2021-08-12,35,5976,15,903,19,4679,1,394,24,302,11,3030,25,3332,California
Modoc,2021-08-13,13,5989,3,906,10,4689,0,394,8,306,4,3034,8,3340,California
Modoc,2021-08-14,3,5992,1,907,2,4691,0,394,2,307,1,3035,2,3342,California
Modoc,2021-08-16,5,5997,3,910,2,4693,0,394,3,309,1,3036,3,3345,California
Modoc,2021-08-17,18,6015,8,918,8,4701,2,396,8,311,8,3044,10,3355,California
Modoc,2021-08-18,9,6024,4,922,5,4706,0,396,6,314,3,3047,6,3361,California
Modoc,2021-08-19,25,6049,14,936,10,4716,1,397,9,308,16,3063,10,3371,California
Modoc,2021-08-20,13,6062,3,939,10,4726,0,397,8,313,3,3066,8,3379,California
Modoc,2021-08-21,3,6065,2,941,1,4727,0,397,2,314,1,3067,2,3381,California
Modoc,2021-08-22,1,6066,0,941,1,4728,0,397,1,315,0,3067,1,3382,California
Modoc,2021-08-23,4,6070,1,942,3,4731,0,397,3,318,0,3067,3,3385,California
Modoc,2021-08-24,14,6084,5,947,5,4736,4,401,6,322,6,3073,10,3395,California
Modoc,2021-08-25,16,6100,3,950,9,4745,4,405,4,319,11,3084,8,3403,California
Modoc,2021-08-26,30,6130,13,963,17,4762,0,405,10,316,13,3097,10,3413,California
Modoc,2021-08-27,13,6143,4,967,7,4769,2,407,7,323,2,3099,9,3422,California
Modoc,2021-08-28,6,6149,2,969,3,4772,1,408,4,326,2,3101,5,3427,California
Modoc,2021-08-30,9,6158,6,975,3,4775,0,408,2,321,7,3108,2,3429,California
Mono,2020-12-18,2,2,2,2,0,0,0,0,2,2,0,0,2,2,California
Mono,2020-12-19,5,7,5,7,0,0,0,0,5,7,0,0,5,7,California
Mono,2020-12-20,7,14,7,14,0,0,0,0,7,14,0,0,7,14,California
Mono,2020-12-21,24,38,17,31,7,7,0,0,24,38,0,0,24,38,California
Mono,2020-12-22,69,107,67,98,2,9,0,0,69,107,0,0,69,107,California
Mono,2020-12-23,73,180,46,144,27,36,0,0,73,180,0,0,73,180,California
Mono,2020-12-24,3,183,1,145,2,38,0,0,3,183,0,0,3,183,California
Mono,2020-12-26,4,187,4,149,0,38,0,0,4,187,0,0,4,187,California
Mono,2020-12-27,1,188,0,149,1,39,0,0,1,188,0,0,1,188,California
Mono,2020-12-28,93,281,62,211,31,70,0,0,93,281,0,0,93,281,California
Mono,2020-12-29,31,312,30,241,1,71,0,0,31,312,0,0,31,312,California
Mono,2020-12-30,77,389,36,277,41,112,0,0,77,389,0,0,77,389,California
Mono,2020-12-31,4,393,1,278,3,115,0,0,4,393,0,0,4,393,California
Mono,2021-01-01,4,397,4,282,0,115,0,0,4,397,0,0,4,397,California
Mono,2021-01-02,2,399,2,284,0,115,0,0,2,399,0,0,2,399,California
Mono,2021-01-04,4,403,0,284,4,119,0,0,4,403,0,0,4,403,California
Mono,2021-01-05,45,448,2,286,43,162,0,0,44,446,1,1,44,447,California
Mono,2021-01-06,50,498,0,286,50,212,0,0,50,496,0,1,50,497,California
Mono,2021-01-07,55,553,3,289,52,264,0,0,53,548,2,3,54,551,California
Mono,2021-01-08,5,558,2,291,3,267,0,0,3,549,2,5,3,554,California
Mono,2021-01-09,4,562,4,295,0,267,0,0,0,545,4,9,0,554,California
Mono,2021-01-10,5,567,5,300,0,267,0,0,0,540,5,14,0,554,California
Mono,2021-01-11,7,574,5,305,2,269,0,0,3,539,4,18,3,557,California
Mono,2021-01-12,288,862,79,384,209,478,0,0,222,696,65,83,222,779,California
Mono,2021-01-13,238,1100,75,459,163,641,0,0,181,820,57,140,181,960,California
Mono,2021-01-14,75,1175,72,531,3,644,0,0,74,893,1,141,74,1034,California
Mono,2021-01-15,70,1245,3,534,67,711,0,0,70,963,0,141,70,1104,California
Mono,2021-01-16,5,1250,4,538,1,712,0,0,1,960,4,145,1,1105,California
Mono,2021-01-18,64,1314,54,592,10,722,0,0,3,902,61,206,3,1108,California
Mono,2021-01-19,208,1522,205,797,3,725,0,0,169,1033,39,245,170,1278,California
Mono,2021-01-20,234,1756,200,997,34,759,0,0,173,1145,61,306,173,1451,California
Mono,2021-01-21,8,1764,4,1001,4,763,0,0,8,1153,0,306,8,1459,California
Mono,2021-01-22,6,1770,0,1001,6,769,0,0,6,1159,0,306,6,1465,California
Mono,2021-01-23,594,2364,594,1595,0,769,0,0,593,1751,1,307,593,2058,California
Mono,2021-01-24,1,2365,0,1595,1,770,0,0,0,1750,1,308,0,2058,California
Mono,2021-01-25,193,2558,156,1751,37,807,0,0,155,1867,38,346,155,2213,California
Mono,2021-01-26,491,3049,489,2240,2,809,0,0,485,2346,6,352,485,2698,California
Mono,2021-01-27,5,3054,0,2240,5,814,0,0,5,2351,0,352,5,2703,California
Mono,2021-01-28,8,3062,3,2243,5,819,0,0,4,2351,4,356,4,2707,California
Mono,2021-01-29,1,3063,1,2244,0,819,0,0,1,2352,0,356,1,2708,California
Mono,2021-01-30,194,3257,192,2436,2,821,0,0,193,2544,1,357,193,2901,California
Mono,2021-01-31,249,3506,138,2574,111,932,0,0,138,2571,111,468,138,3039,California
Mono,2021-02-01,27,3533,27,2601,0,932,0,0,0,2544,27,495,0,3039,California
Mono,2021-02-02,6,3539,1,2602,5,937,0,0,2,2542,4,499,2,3041,California
Mono,2021-02-03,9,3548,2,2604,7,944,0,0,4,2541,5,504,4,3045,California
Mono,2021-02-04,218,3766,159,2763,59,1003,0,0,93,2511,123,627,93,3138,California
Mono,2021-02-05,608,4374,602,3365,6,1009,0,0,604,3111,4,631,604,3742,California
Mono,2021-02-06,134,4508,133,3498,1,1010,0,0,133,3243,1,632,133,3875,California
Mono,2021-02-07,3,4511,0,3498,3,1013,0,0,3,3246,0,632,3,3878,California
Mono,2021-02-08,169,4680,168,3666,1,1014,0,0,16,3110,152,784,16,3894,California
Mono,2021-02-09,232,4912,8,3674,224,1238,0,0,14,2906,218,1002,14,3908,California
Mono,2021-02-10,541,5453,188,3862,353,1591,0,0,195,2756,346,1348,196,4104,California
Mono,2021-02-11,10,5463,5,3867,5,1596,0,0,4,2754,6,1354,4,4108,California
Mono,2021-02-12,95,5558,22,3889,73,1669,0,0,28,2715,67,1421,28,4136,California
Mono,2021-02-13,592,6150,590,4479,2,1671,0,0,27,2178,564,1985,27,4163,California
Mono,2021-02-15,162,6312,160,4639,2,1673,0,0,3,2024,157,2142,3,4166,California
Mono,2021-02-16,512,6824,506,5145,6,1679,0,0,46,1609,463,2605,48,4214,California
Mono,2021-02-17,5,6829,1,5146,4,1683,0,0,2,1608,3,2608,2,4216,California
Mono,2021-02-18,7,6836,2,5148,5,1688,0,0,2,1605,5,2613,2,4218,California
Mono,2021-02-19,55,6891,54,5202,1,1689,0,0,55,1660,0,2613,55,4273,California
Mono,2021-02-20,8,6899,8,5210,0,1689,0,0,8,1668,0,2613,8,4281,California
Mono,2021-02-21,11,6910,11,5221,0,1689,0,0,9,1675,2,2615,9,4290,California
Mono,2021-02-22,297,7207,296,5517,1,1690,0,0,27,1433,269,2884,27,4317,California
Mono,2021-02-23,161,7368,135,5652,26,1716,0,0,28,1328,133,3017,28,4345,California
Mono,2021-02-24,12,7380,2,5654,10,1726,0,0,3,1322,9,3026,3,4348,California
Mono,2021-02-25,7,7387,2,5656,5,1731,0,0,3,1322,3,3029,3,4351,California
Mono,2021-02-26,606,7993,604,6260,2,1733,0,0,23,765,581,3610,24,4375,California
Mono,2021-02-27,139,8132,135,6395,4,1737,0,0,5,638,132,3742,5,4380,California
Mono,2021-02-28,1,8133,0,6395,0,1737,1,1,0,638,1,3743,1,4381,California
Mono,2021-03-01,4,8137,2,6397,2,1739,0,1,3,641,0,3743,3,4384,California
Mono,2021-03-02,8,8145,4,6401,4,1743,0,1,6,645,2,3745,6,4390,California
Mono,2021-03-03,114,8259,3,6404,111,1854,0,1,110,752,3,3748,110,4500,California
Mono,2021-03-04,8,8267,2,6406,6,1860,0,1,3,750,5,3753,3,4503,California
Mono,2021-03-05,42,8309,32,6438,10,1870,0,1,13,734,29,3782,13,4516,California
Mono,2021-03-06,513,8822,17,6455,496,2366,0,1,504,1232,7,3789,505,5021,California
Mono,2021-03-07,1,8823,0,6455,1,2367,0,1,0,1231,1,3790,0,5021,California
Mono,2021-03-08,540,9363,11,6466,526,2893,3,4,530,1754,10,3800,533,5554,California
Mono,2021-03-09,8,9371,3,6469,3,2896,2,6,3,1755,4,3804,5,5559,California
Mono,2021-03-10,287,9658,92,6561,192,3088,3,9,8,1490,276,4080,11,5570,California
Mono,2021-03-11,11,9669,0,6561,2,3090,9,18,0,1488,11,4091,9,5579,California
Mono,2021-03-12,9,9678,1,6562,2,3092,6,24,2,1487,7,4098,6,5585,California
Mono,2021-03-13,834,10512,393,6955,440,3532,1,25,818,2290,16,4114,819,6404,California
Mono,2021-03-14,8,10520,8,6963,0,3532,0,25,1,2284,7,4121,1,6405,California
Mono,2021-03-15,30,10550,23,6986,2,3534,5,30,14,2288,15,4136,19,6424,California
Mono,2021-03-16,17,10567,6,6992,5,3539,6,36,7,2291,10,4146,13,6437,California
Mono,2021-03-17,31,10598,4,6996,19,3558,8,44,19,2306,12,4158,27,6464,California
Mono,2021-03-18,22,10620,2,6998,11,3569,9,53,9,2311,13,4171,18,6482,California
Mono,2021-03-19,18,10638,1,6999,14,3583,3,56,14,2325,3,4174,17,6499,California
Mono,2021-03-20,5,10643,3,7002,1,3584,1,57,3,2327,2,4176,4,6503,California
Mono,2021-03-22,12,10655,1,7003,6,3590,5,62,6,2332,6,4182,11,6514,California
Mono,2021-03-23,47,10702,6,7009,36,3626,5,67,18,2327,28,4210,23,6537,California
Mono,2021-03-24,14,10716,1,7010,8,3634,5,72,5,2329,9,4219,11,6548,California
Mono,2021-03-25,20,10736,3,7013,13,3647,4,76,14,2341,6,4225,18,6566,California
Mono,2021-03-26,20,10756,4,7017,11,3658,5,81,10,2348,8,4233,15,6581,California
Mono,2021-03-27,363,11119,360,7377,3,3661,0,81,336,2657,27,4260,336,6917,California
Mono,2021-03-29,12,11131,2,7379,9,3670,1,82,9,2664,3,4263,10,6927,California
Mono,2021-03-30,15,11146,0,7379,11,3681,4,86,8,2669,7,4270,12,6939,California
Mono,2021-03-31,136,11282,8,7387,127,3808,1,87,25,2585,110,4380,26,6965,California
Mono,2021-04-01,10,11292,0,7387,10,3818,0,87,6,2587,4,4384,6,6971,California
Mono,2021-04-02,19,11311,4,7391,15,3833,0,87,10,2588,9,4393,10,6981,California
Mono,2021-04-03,873,12184,377,7768,496,4329,0,87,47,1813,823,5216,48,7029,California
Mono,2021-04-04,2,12186,1,7769,1,4330,0,87,0,1811,2,5218,0,7029,California
Mono,2021-04-05,547,12733,18,7787,528,4858,1,88,35,1336,511,5729,36,7065,California
Mono,2021-04-06,19,12752,0,7787,6,4864,13,101,2,1334,17,5746,15,7080,California
Mono,2021-04-07,23,12775,2,7789,2,4866,19,120,2,1334,21,5767,21,7101,California
Mono,2021-04-08,26,12801,4,7793,3,4869,19,139,6,1339,20,5787,25,7126,California
Mono,2021-04-09,39,12840,6,7799,4,4873,29,168,9,1347,30,5817,38,7164,California
Mono,2021-04-10,459,13299,2,7801,450,5323,7,175,32,959,427,6244,39,7203,California
Mono,2021-04-12,6,13305,0,7801,3,5326,3,178,3,962,3,6247,6,7209,California
Mono,2021-04-13,19,13324,2,7803,16,5342,1,179,13,970,6,6253,14,7223,California
Mono,2021-04-14,26,13350,2,7805,24,5366,0,179,9,962,17,6270,9,7232,California
Mono,2021-04-15,20,13370,5,7810,15,5381,0,179,10,962,10,6280,10,7242,California
Mono,2021-04-16,18,13388,2,7812,16,5397,0,179,7,958,11,6291,7,7249,California
Mono,2021-04-17,53,13441,2,7814,51,5448,0,179,46,997,7,6298,46,7295,California
Mono,2021-04-18,2,13443,1,7815,1,5449,0,179,2,999,0,6298,2,7297,California
Mono,2021-04-19,553,13996,339,8154,214,5663,0,179,208,866,341,6639,208,7505,California
Mono,2021-04-20,14,14010,2,8156,12,5675,0,179,9,870,5,6644,9,7514,California
Mono,2021-04-21,8,14018,1,8157,7,5682,0,179,2,866,6,6650,2,7516,California
Mono,2021-04-22,25,14043,11,8168,14,5696,0,179,11,863,14,6664,11,7527,California
Mono,2021-04-23,24,14067,4,8172,20,5716,0,179,12,863,12,6676,12,7539,California
Mono,2021-04-24,36,14103,21,8193,15,5731,0,179,21,869,15,6691,21,7560,California
Mono,2021-04-25,5,14108,4,8197,1,5732,0,179,5,874,0,6691,5,7565,California
Mono,2021-04-26,16,14124,4,8201,12,5744,0,179,3,864,13,6704,3,7568,California
Mono,2021-04-27,67,14191,41,8242,18,5762,8,187,51,907,16,6720,59,7627,California
Mono,2021-04-28,65,14256,42,8284,18,5780,5,192,49,947,14,6734,54,7681,California
Mono,2021-04-29,13,14269,4,8288,6,5786,3,195,4,945,9,6743,7,7688,California
Mono,2021-04-30,19,14288,4,8292,11,5797,4,199,8,946,11,6754,12,7700,California
Mono,2021-05-01,117,14405,5,8297,112,5909,0,199,102,1035,13,6767,102,7802,California
Mono,2021-05-02,1,14406,1,8298,0,5909,0,199,0,1034,1,6768,0,7802,California
Mono,2021-05-03,2,14408,1,8299,1,5910,0,199,1,1034,1,6769,1,7803,California
Mono,2021-05-04,19,14427,0,8299,14,5924,5,204,10,1040,9,6778,15,7818,California
Mono,2021-05-05,53,14480,8,8307,41,5965,4,208,45,1081,8,6786,49,7867,California
Mono,2021-05-06,15,14495,3,8310,11,5976,1,209,9,1085,6,6792,10,7877,California
Mono,2021-05-07,29,14524,22,8332,7,5983,0,209,25,1106,4,6796,25,7902,California
Mono,2021-05-08,53,14577,7,8339,46,6029,0,209,23,1099,30,6826,23,7925,California
Mono,2021-05-09,1,14578,1,8340,0,6029,0,209,0,1099,0,6826,0,7925,California
Mono,2021-05-10,20,14598,3,8343,13,6042,4,213,9,1101,11,6837,13,7938,California
Mono,2021-05-11,17,14615,2,8345,12,6054,3,216,6,1099,11,6848,9,7947,California
Mono,2021-05-12,12,14627,0,8345,11,6065,1,217,4,1096,8,6856,5,7952,California
Mono,2021-05-13,54,14681,36,8381,17,6082,1,218,43,1129,11,6867,44,7996,California
Mono,2021-05-14,11,14692,2,8383,8,6090,1,219,6,1131,5,6872,7,8003,California
Mono,2021-05-15,70,14762,28,8411,36,6126,6,225,20,1107,50,6922,26,8029,California
Mono,2021-05-16,6,14768,4,8415,1,6127,1,226,2,1106,4,6926,3,8032,California
Mono,2021-05-17,256,15024,35,8450,214,6341,7,233,57,973,198,7124,65,8097,California
Mono,2021-05-18,137,15161,114,8564,22,6363,1,234,89,1016,48,7172,91,8188,California
Mono,2021-05-19,125,15286,118,8682,2,6365,5,239,81,1058,44,7216,86,8274,California
Mono,2021-05-20,74,15360,59,8741,10,6375,5,244,56,1101,18,7234,61,8335,California
Mono,2021-05-21,24,15384,4,8745,17,6392,3,247,10,1100,14,7248,13,8348,California
Mono,2021-05-22,23,15407,12,8757,8,6400,3,250,16,1112,7,7255,19,8367,California
Mono,2021-05-23,3,15410,1,8758,2,6402,0,250,2,1113,1,7256,2,8369,California
Mono,2021-05-24,15,15425,1,8759,13,6415,1,251,9,1118,6,7262,11,8380,California
Mono,2021-05-25,15,15440,5,8764,10,6425,0,251,8,1120,7,7269,9,8389,California
Mono,2021-05-26,18,15458,2,8766,15,6440,1,252,7,1117,11,7280,8,8397,California
Mono,2021-05-27,8,15466,0,8766,8,6448,0,252,5,1120,2,7282,5,8402,California
Mono,2021-05-28,43,15509,29,8795,14,6462,0,252,12,1101,31,7313,12,8414,California
Mono,2021-05-29,134,15643,26,8821,105,6567,3,255,31,1032,103,7416,34,8448,California
Mono,2021-06-01,16,15659,7,8828,9,6576,0,255,9,1034,7,7423,9,8457,California
Mono,2021-06-02,47,15706,4,8832,43,6619,0,255,10,1007,37,7460,10,8467,California
Mono,2021-06-03,11,15717,2,8834,7,6626,2,257,1,1000,10,7470,3,8470,California
Mono,2021-06-04,12,15729,1,8835,10,6636,1,258,3,995,9,7479,4,8474,California
Mono,2021-06-05,46,15775,26,8861,20,6656,0,258,5,959,41,7520,5,8479,California
Mono,2021-06-06,1,15776,0,8861,1,6657,0,258,0,958,1,7521,0,8479,California
Mono,2021-06-07,99,15875,87,8948,8,6665,4,262,11,885,88,7609,15,8494,California
Mono,2021-06-08,113,15988,103,9051,8,6673,2,264,11,796,102,7711,13,8507,California
Mono,2021-06-09,7,15995,2,9053,5,6678,0,264,1,791,6,7717,1,8508,California
Mono,2021-06-10,6,16001,0,9053,4,6682,2,266,2,791,4,7721,4,8512,California
Mono,2021-06-11,80,16081,68,9121,7,6689,5,271,8,732,72,7793,13,8525,California
Mono,2021-06-12,1,16082,1,9122,0,6689,0,271,0,731,1,7794,0,8525,California
Mono,2021-06-13,1,16083,0,9122,1,6690,0,271,1,732,0,7794,1,8526,California
Mono,2021-06-14,68,16151,31,9153,31,6721,6,277,20,710,48,7842,26,8552,California
Mono,2021-06-15,8,16159,5,9158,3,6724,0,277,4,710,4,7846,4,8556,California
Mono,2021-06-16,15,16174,6,9164,9,6733,0,277,7,709,8,7854,7,8563,California
Mono,2021-06-17,8,16182,1,9165,5,6738,2,279,4,711,4,7858,6,8569,California
Mono,2021-06-18,6,16188,3,9168,2,6740,1,280,2,711,3,7861,3,8572,California
Mono,2021-06-19,3,16191,2,9170,1,6741,0,280,3,714,0,7861,3,8575,California
Mono,2021-06-20,1,16192,0,9170,1,6742,0,280,0,713,1,7862,0,8575,California
Mono,2021-06-21,14,16206,2,9172,10,6752,2,282,3,708,10,7872,5,8580,California
Mono,2021-06-22,13,16219,2,9174,10,6762,1,283,4,705,8,7880,5,8585,California
Mono,2021-06-23,14,16233,1,9175,7,6769,6,289,3,704,11,7891,10,8595,California
Mono,2021-06-24,8,16241,0,9175,6,6775,2,291,3,704,5,7896,5,8600,California
Mono,2021-06-25,36,16277,25,9200,11,6786,0,291,10,688,26,7922,10,8610,California
Mono,2021-06-26,1,16278,1,9201,0,6786,0,291,0,687,1,7923,0,8610,California
Mono,2021-06-27,1,16279,0,9201,1,6787,0,291,1,688,0,7923,1,8611,California
Mono,2021-06-28,11,16290,6,9207,2,6789,3,294,3,686,8,7931,6,8617,California
Mono,2021-06-29,5,16295,4,9211,0,6789,1,295,4,690,1,7932,5,8622,California
Mono,2021-06-30,6,16301,1,9212,2,6791,3,298,2,691,4,7936,5,8627,California
Mono,2021-07-01,8,16309,1,9213,4,6795,3,301,2,690,6,7942,5,8632,California
Mono,2021-07-02,38,16347,34,9247,2,6797,2,303,13,680,25,7967,15,8647,California
Mono,2021-07-05,5,16352,0,9247,4,6801,1,304,4,684,1,7968,5,8652,California
Mono,2021-07-06,11,16363,1,9248,6,6807,4,308,4,685,7,7975,8,8660,California
Mono,2021-07-07,8,16371,5,9253,3,6810,0,308,3,683,5,7980,3,8663,California
Mono,2021-07-08,11,16382,9,9262,1,6811,1,309,4,682,6,7986,5,8668,California
Mono,2021-07-09,5,16387,1,9263,4,6815,0,309,2,681,3,7989,2,8670,California
Mono,2021-07-10,3,16390,3,9266,0,6815,0,309,2,682,1,7990,2,8672,California
Mono,2021-07-12,17,16407,10,9276,7,6822,0,309,11,687,6,7996,11,8683,California
Mono,2021-07-13,3,16410,3,9279,0,6822,0,309,3,690,0,7996,3,8686,California
Mono,2021-07-14,14,16424,11,9290,3,6825,0,309,7,691,6,8002,7,8693,California
Mono,2021-07-15,12,16436,6,9296,6,6831,0,309,7,693,5,8007,7,8700,California
Mono,2021-07-16,7,16443,1,9297,6,6837,0,309,3,693,3,8010,3,8703,California
Mono,2021-07-17,5,16448,0,9297,5,6842,0,309,5,698,0,8010,5,8708,California
Mono,2021-07-19,60,16508,38,9335,18,6860,4,313,45,733,14,8024,49,8757,California
Mono,2021-07-20,13,16521,4,9339,8,6868,1,314,4,729,9,8033,5,8762,California
Mono,2021-07-21,4,16525,2,9341,2,6870,0,314,3,731,1,8034,3,8765,California
Mono,2021-07-22,16,16541,5,9346,10,6880,1,315,11,738,5,8039,12,8777,California
Mono,2021-07-23,25,16566,16,9362,7,6887,2,317,18,751,7,8046,20,8797,California
Mono,2021-07-24,4,16570,2,9364,2,6889,0,317,2,752,1,8047,2,8799,California
Mono,2021-07-26,6,16576,5,9369,0,6889,1,318,5,757,1,8048,6,8805,California
Mono,2021-07-27,11,16587,2,9371,9,6898,0,318,8,762,3,8051,8,8813,California
Mono,2021-07-28,19,16606,3,9374,16,6914,0,318,15,774,3,8054,15,8828,California
Mono,2021-07-29,6,16612,1,9375,5,6919,0,318,4,776,2,8056,4,8832,California
Mono,2021-07-30,4,16616,0,9375,4,6923,0,318,4,780,0,8056,4,8836,California
Mono,2021-07-31,7,16623,4,9379,3,6926,0,318,7,787,0,8056,7,8843,California
Mono,2021-08-02,17,16640,7,9386,10,6936,0,318,12,794,5,8061,12,8855,California
Mono,2021-08-03,10,16650,9,9395,1,6937,0,318,5,794,5,8066,5,8860,California
Mono,2021-08-04,16,16666,7,9402,9,6946,0,318,11,801,4,8070,11,8871,California
Mono,2021-08-05,10,16676,3,9405,7,6953,0,318,8,807,2,8072,8,8879,California
Mono,2021-08-06,111,16787,90,9495,13,6966,8,326,57,821,51,8123,65,8944,California
Mono,2021-08-07,4,16791,1,9496,3,6969,0,326,4,825,0,8123,4,8948,California
Mono,2021-08-08,2,16793,0,9496,1,6970,1,327,1,826,1,8124,2,8950,California
Mono,2021-08-09,23,16816,10,9506,13,6983,0,327,15,833,8,8132,15,8965,California
Mono,2021-08-10,16,16832,5,9511,11,6994,0,327,10,838,5,8137,10,8975,California
Mono,2021-08-11,13,16845,6,9517,7,7001,0,327,7,839,6,8143,7,8982,California
Mono,2021-08-12,25,16870,12,9529,13,7014,0,327,17,848,8,8151,17,8999,California
Mono,2021-08-13,14,16884,7,9536,6,7020,1,328,8,853,4,8155,9,9008,California
Mono,2021-08-14,9,16893,2,9538,7,7027,0,328,4,852,5,8160,4,9012,California
Mono,2021-08-16,23,16916,8,9546,15,7042,0,328,9,850,11,8171,9,9021,California
Mono,2021-08-17,15,16931,6,9552,9,7051,0,328,10,856,4,8175,10,9031,California
Mono,2021-08-18,20,16951,11,9563,9,7060,0,328,14,866,4,8179,14,9045,California
Mono,2021-08-19,15,16966,9,9572,6,7066,0,328,9,871,4,8183,9,9054,California
Mono,2021-08-20,9,16975,6,9578,2,7068,1,329,1,871,2,8185,2,9056,California
Mono,2021-08-21,13,16988,7,9585,6,7074,0,329,8,875,4,8189,8,9064,California
Mono,2021-08-23,13,17001,7,9592,5,7079,1,330,7,878,5,8194,8,9072,California
Mono,2021-08-24,21,17022,8,9600,13,7092,0,330,9,878,9,8203,9,9081,California
Mono,2021-08-25,14,17036,9,9609,5,7097,0,330,5,878,5,8208,5,9086,California
Mono,2021-08-26,12,17048,6,9615,6,7103,0,330,5,878,5,8213,5,9091,California
Mono,2021-08-27,76,17124,63,9678,12,7115,1,331,41,897,23,8236,42,9133,California
Mono,2021-08-28,5,17129,5,9683,0,7115,0,331,3,898,2,8238,3,9136,California
Mono,2021-08-30,21,17150,12,9695,9,7124,0,331,6,892,12,8250,6,9142,California
Monterey,2020-12-16,6,6,6,6,0,0,0,0,6,6,0,0,6,6,California
Monterey,2020-12-17,89,95,89,95,0,0,0,0,89,95,0,0,89,95,California
Monterey,2020-12-18,500,595,500,595,0,0,0,0,500,595,0,0,500,595,California
Monterey,2020-12-19,582,1177,581,1176,1,1,0,0,581,1176,0,0,581,1176,California
Monterey,2020-12-20,417,1594,416,1592,1,2,0,0,417,1593,0,0,417,1593,California
Monterey,2020-12-21,724,2318,724,2316,0,2,0,0,724,2317,0,0,724,2317,California
Monterey,2020-12-22,556,2874,543,2859,13,15,0,0,556,2873,0,0,556,2873,California
Monterey,2020-12-23,449,3323,270,3129,179,194,0,0,449,3322,0,0,449,3322,California
Monterey,2020-12-24,85,3408,9,3138,76,270,0,0,85,3407,0,0,85,3407,California
Monterey,2020-12-25,8,3416,1,3139,7,277,0,0,7,3413,1,1,7,3414,California
Monterey,2020-12-26,94,3510,6,3145,88,365,0,0,94,3507,0,1,94,3508,California
Monterey,2020-12-27,7,3517,4,3149,3,368,0,0,7,3514,0,1,7,3515,California
Monterey,2020-12-28,494,4011,26,3175,468,836,0,0,494,4008,0,1,494,4009,California
Monterey,2020-12-29,923,4934,177,3352,746,1582,0,0,923,4931,0,1,923,4932,California
Monterey,2020-12-30,573,5507,101,3453,472,2054,0,0,573,5504,0,1,573,5505,California
Monterey,2020-12-31,35,5542,10,3463,25,2079,0,0,35,5539,0,1,35,5540,California
Monterey,2021-01-01,14,5556,3,3466,11,2090,0,0,14,5553,0,1,14,5554,California
Monterey,2021-01-02,141,5697,136,3602,5,2095,0,0,141,5694,0,1,141,5695,California
Monterey,2021-01-03,33,5730,31,3633,2,2097,0,0,33,5727,0,1,33,5728,California
Monterey,2021-01-04,415,6145,20,3653,395,2492,0,0,415,6142,0,1,415,6143,California
Monterey,2021-01-05,770,6915,334,3987,436,2928,0,0,755,6883,14,15,755,6898,California
Monterey,2021-01-06,685,7600,186,4173,499,3427,0,0,659,7516,26,41,659,7557,California
Monterey,2021-01-07,769,8369,585,4758,184,3611,0,0,436,7621,331,372,436,7993,California
Monterey,2021-01-08,1130,9499,763,5521,367,3978,0,0,413,7317,717,1089,413,8406,California
Monterey,2021-01-09,979,10478,939,6460,40,4018,0,0,327,6994,650,1739,327,8733,California
Monterey,2021-01-10,271,10749,268,6728,3,4021,0,0,9,6742,261,2000,9,8742,California
Monterey,2021-01-11,1083,11832,992,7720,91,4112,0,0,377,6413,706,2706,377,9119,California
Monterey,2021-01-12,523,12355,434,8154,89,4201,0,0,253,6398,269,2975,254,9373,California
Monterey,2021-01-13,1247,13602,611,8765,636,4837,0,0,1200,7551,47,3022,1200,10573,California
Monterey,2021-01-14,1213,14815,247,9012,966,5803,0,0,1191,8724,22,3044,1195,11768,California
Monterey,2021-01-15,1086,15901,44,9056,1042,6845,0,0,1075,9788,11,3055,1075,12843,California
Monterey,2021-01-16,368,16269,302,9358,66,6911,0,0,364,10148,4,3059,364,13207,California
Monterey,2021-01-17,313,16582,295,9653,18,6929,0,0,300,10435,13,3072,300,13507,California
Monterey,2021-01-18,412,16994,52,9705,360,7289,0,0,388,10799,24,3096,388,13895,California
Monterey,2021-01-19,612,17606,417,10122,195,7484,0,0,435,11059,175,3271,435,14330,California
Monterey,2021-01-20,561,18167,275,10397,286,7770,0,0,345,11189,215,3486,345,14675,California
Monterey,2021-01-21,937,19104,120,10517,817,8587,0,0,823,11902,114,3600,827,15502,California
Monterey,2021-01-22,1116,20220,214,10731,902,9489,0,0,1074,12935,41,3641,1074,16576,California
Monterey,2021-01-23,264,20484,180,10911,84,9573,0,0,139,12952,124,3765,141,16717,California
Monterey,2021-01-24,66,20550,39,10950,27,9600,0,0,31,12948,35,3800,31,16748,California
Monterey,2021-01-25,851,21401,184,11134,667,10267,0,0,210,12524,634,4434,210,16958,California
Monterey,2021-01-26,1152,22553,385,11519,767,11034,0,0,361,12094,791,5225,361,17319,California
Monterey,2021-01-27,963,23516,355,11874,608,11642,0,0,465,12061,498,5723,465,17784,California
Monterey,2021-01-28,2089,25605,751,12625,1338,12980,0,0,1734,13444,354,6077,1737,19521,California
Monterey,2021-01-29,1328,26933,726,13351,602,13582,0,0,1206,14530,121,6198,1207,20728,California
Monterey,2021-01-30,517,27450,311,13662,206,13788,0,0,249,14511,268,6466,249,20977,California
Monterey,2021-01-31,525,27975,82,13744,443,14231,0,0,514,15015,11,6477,515,21492,California
Monterey,2021-02-01,1675,29650,1149,14893,526,14757,0,0,1093,15527,581,7058,1093,22585,California
Monterey,2021-02-02,2241,31891,498,15391,1743,16500,0,0,1593,16474,646,7704,1593,24178,California
Monterey,2021-02-03,2404,34295,1086,16477,1318,17818,0,0,1600,17273,801,8505,1600,25778,California
Monterey,2021-02-04,2885,37180,2123,18600,762,18580,0,0,2518,19429,362,8867,2518,28296,California
Monterey,2021-02-05,3750,40930,2864,21464,886,19466,0,0,3289,22263,455,9322,3289,31585,California
Monterey,2021-02-06,1156,42086,386,21850,770,20236,0,0,798,22706,355,9677,798,32383,California
Monterey,2021-02-07,330,42416,268,22118,62,20298,0,0,107,22591,222,9899,107,32490,California
Monterey,2021-02-08,552,42968,295,22413,257,20555,0,0,439,22917,113,10012,439,32929,California
Monterey,2021-02-09,944,43912,722,23135,222,20777,0,0,623,23220,320,10332,623,33552,California
Monterey,2021-02-10,2165,46077,1121,24256,1044,21821,0,0,1290,23638,874,11206,1292,34844,California
Monterey,2021-02-11,2577,48654,983,25239,1594,23415,0,0,1575,24216,999,12205,1577,36421,California
Monterey,2021-02-12,2715,51369,456,25695,2259,25674,0,0,1577,24657,1137,13342,1578,37999,California
Monterey,2021-02-13,1126,52495,53,25748,1073,26747,0,0,1029,25590,96,13438,1029,39028,California
Monterey,2021-02-14,633,53128,77,25825,556,27303,0,0,563,26083,70,13508,563,39591,California
Monterey,2021-02-15,1429,54557,177,26002,1252,28555,0,0,998,26653,429,13937,999,40590,California
Monterey,2021-02-16,1137,55694,254,26256,883,29438,0,0,901,27318,236,14173,901,41491,California
Monterey,2021-02-17,2057,57751,1215,27471,842,30280,0,0,1696,28658,358,14531,1698,43189,California
Monterey,2021-02-18,2325,60076,1190,28661,1135,31415,0,0,940,28230,1370,15901,942,44131,California
Monterey,2021-02-19,3055,63131,1578,30239,1477,32892,0,0,1401,27981,1652,17553,1403,45534,California
Monterey,2021-02-20,1145,64276,704,30943,441,33333,0,0,1064,28966,80,17633,1065,46599,California
Monterey,2021-02-21,1385,65661,1342,32285,43,33376,0,0,1290,30169,88,17721,1291,47890,California
Monterey,2021-02-22,1152,66813,976,33261,176,33552,0,0,712,30445,436,18157,712,48602,California
Monterey,2021-02-23,1106,67919,678,33939,428,33980,0,0,360,30064,742,18899,361,48963,California
Monterey,2021-02-24,2707,70626,1407,35346,1300,35280,0,0,1950,31263,752,19651,1951,50914,California
Monterey,2021-02-25,4765,75391,2594,37940,2171,37451,0,0,1614,29740,3139,22790,1616,52530,California
Monterey,2021-02-26,5629,81020,3271,41211,2358,39809,0,0,2804,29727,2819,25609,2806,55336,California
Monterey,2021-02-27,1147,82167,217,41428,930,40739,0,0,887,30360,254,25863,887,56223,California
Monterey,2021-02-28,1660,83827,93,41521,1566,42305,1,1,1138,30991,509,26372,1140,57363,California
Monterey,2021-03-01,1433,85260,194,41715,1236,43541,3,4,829,31225,598,26970,832,58195,California
Monterey,2021-03-02,3029,88289,1845,43560,1184,44725,0,4,2088,32377,936,27906,2088,60283,California
Monterey,2021-03-03,3360,91649,1273,44833,2085,46810,2,6,1350,31723,2007,29913,1353,61636,California
Monterey,2021-03-04,4845,96494,1541,46374,3304,50114,0,6,3132,33152,1705,31618,3134,64770,California
Monterey,2021-03-05,3798,100292,1656,48030,1860,51974,282,288,3101,35836,695,32313,3379,68149,California
Monterey,2021-03-06,5296,105588,1182,49212,3801,55775,313,601,4350,39547,944,33257,4655,72804,California
Monterey,2021-03-07,636,106224,113,49325,209,55984,314,915,262,39747,373,33630,573,73377,California
Monterey,2021-03-08,1707,107931,331,49656,977,56961,399,1314,1138,40712,568,34198,1533,74910,California
Monterey,2021-03-09,2074,110005,704,50360,1090,58051,280,1594,1549,42011,522,34720,1821,76731,California
Monterey,2021-03-10,3317,113322,1059,51419,1767,59818,491,2085,1543,42270,1768,36488,2027,78758,California
Monterey,2021-03-11,4271,117593,1445,52864,2446,62264,380,2465,2440,43265,1821,38309,2816,81574,California
Monterey,2021-03-12,4562,122155,2092,54956,2312,64576,158,2623,2787,44436,1769,40078,2940,84514,California
Monterey,2021-03-13,5483,127638,1040,55996,4090,68666,353,2976,4065,47436,1415,41493,4415,88929,California
Monterey,2021-03-14,2206,129844,1357,57353,825,69491,24,3000,522,46311,1670,43163,545,89474,California
Monterey,2021-03-15,4075,133919,1295,58648,2473,71964,307,3307,2284,47115,1787,44950,2591,92065,California
Monterey,2021-03-16,3639,137558,626,59274,2622,74586,391,3698,2172,48209,1465,46415,2559,94624,California
Monterey,2021-03-17,6055,143613,2494,61768,3302,77888,259,3957,4379,51185,1667,48082,4643,99267,California
Monterey,2021-03-18,4604,148217,2252,64020,2178,80066,174,4131,3181,53158,1418,49500,3391,102658,California
Monterey,2021-03-19,5631,153848,2624,66644,2842,82908,165,4296,4251,56202,1371,50871,4415,107073,California
Monterey,2021-03-20,3441,157289,467,67111,2279,85187,695,4991,2325,58108,1112,51983,3018,110091,California
Monterey,2021-03-21,668,157957,230,67341,427,85614,11,5002,586,58625,79,52062,596,110687,California
Monterey,2021-03-22,2557,160514,1489,68830,1005,86619,63,5065,2318,60769,235,52297,2379,113066,California
Monterey,2021-03-23,4170,164684,2451,71281,1676,88295,43,5108,2591,61830,1573,53870,2634,115700,California
Monterey,2021-03-24,5361,170045,2268,73549,2769,91064,324,5432,3903,64602,1451,55321,4223,119923,California
Monterey,2021-03-25,5459,175504,1269,74818,3825,94889,365,5797,2683,64886,2764,58085,3048,122971,California
Monterey,2021-03-26,5638,181142,2712,77530,2839,97728,87,5884,2828,65005,2795,60880,2914,125885,California
Monterey,2021-03-27,5112,186254,1603,79133,3248,100976,261,6145,3232,66624,1876,62756,3495,129380,California
Monterey,2021-03-28,1163,187417,373,79506,781,101757,9,6154,635,66751,517,63273,644,130024,California
Monterey,2021-03-29,3309,190726,1450,80956,1845,103602,14,6168,2004,67478,1296,64569,2023,132047,California
Monterey,2021-03-30,4675,195401,2188,83144,2430,106032,57,6225,2809,68493,1853,66422,2868,134915,California
Monterey,2021-03-31,5517,200918,2430,85574,2284,108316,803,7028,3426,70623,2086,68508,4216,139131,California
Monterey,2021-04-01,6309,207227,2120,87694,3780,112096,409,7437,3129,70988,3164,71672,3529,142660,California
Monterey,2021-04-02,4837,212064,2245,89939,2517,114613,75,7512,3209,72651,1623,73295,3286,145946,California
Monterey,2021-04-03,6036,218100,1148,91087,3824,118437,1064,8576,1228,70133,4801,78096,2283,148229,California
Monterey,2021-04-04,799,218899,179,91266,606,119043,14,8590,499,70350,298,78394,515,148744,California
Monterey,2021-04-05,4083,222982,2518,93784,1323,120366,242,8832,1505,69521,2573,80967,1744,150488,California
Monterey,2021-04-06,3586,226568,1408,95192,1692,122058,486,9318,1236,68893,2345,83312,1717,152205,California
Monterey,2021-04-07,5829,232397,1454,96646,3851,125909,524,9842,2701,68995,3116,86428,3218,155423,California
Monterey,2021-04-08,6888,239285,3616,100262,2429,128338,843,10685,3416,69786,3465,89893,4256,159679,California
Monterey,2021-04-09,5861,245146,3465,103727,1735,130073,661,11346,2303,69192,3554,93447,2960,162639,California
Monterey,2021-04-10,10357,255503,4944,108671,3174,133247,2239,13585,4966,71010,5375,98822,7193,169832,California
Monterey,2021-04-11,5558,261061,4347,113018,588,133835,623,14208,4478,75030,1074,99896,5094,174926,California
Monterey,2021-04-12,4251,265312,1913,114931,1991,135826,347,14555,988,73236,3123,103019,1329,176255,California
Monterey,2021-04-13,3244,268556,797,115728,2441,138267,6,14561,1499,73016,1726,104745,1506,177761,California
Monterey,2021-04-14,7124,275680,3335,119063,3786,142053,3,14564,1907,69738,5189,109934,1911,179672,California
Monterey,2021-04-15,6038,281718,3978,123041,2058,144111,2,14566,3898,71531,2107,112041,3900,183572,California
Monterey,2021-04-16,4995,286713,2510,125551,2474,146585,11,14577,2237,71039,2741,114782,2249,185821,California
Monterey,2021-04-17,5942,292655,1426,126977,4516,151101,0,14577,3838,72793,2085,116867,3839,189660,California
Monterey,2021-04-18,915,293570,311,127288,604,151705,0,14577,268,72418,643,117510,268,189928,California
Monterey,2021-04-19,3653,297223,1179,128467,2474,154179,0,14577,1640,72062,1997,119507,1641,191569,California
Monterey,2021-04-20,3978,301201,1650,130117,2328,156507,0,14577,1551,71220,2394,121901,1552,193121,California
Monterey,2021-04-21,6554,307755,3669,133786,2885,159392,0,14577,3121,70975,3368,125269,3123,196244,California
Monterey,2021-04-22,5047,312802,1160,134946,3887,163279,0,14577,2061,70104,2932,128201,2061,198305,California
Monterey,2021-04-23,5941,318743,2793,137739,3147,166426,1,14578,2368,68929,3549,131750,2374,200679,California
Monterey,2021-04-24,4619,323362,772,138511,3846,170272,1,14579,1738,67809,2860,134610,1740,202419,California
Monterey,2021-04-25,1304,324666,654,139165,650,170922,0,14579,820,68162,467,135077,820,203239,California
Monterey,2021-04-26,3943,328609,2361,141526,1565,172487,17,14596,1027,66320,2886,137963,1044,204283,California
Monterey,2021-04-27,3042,331651,1020,142546,1882,174369,140,14736,1298,66021,1736,139699,1437,205720,California
Monterey,2021-04-28,3906,335557,1556,144102,2193,176562,157,14893,2367,67018,1521,141220,2518,208238,California
Monterey,2021-04-29,4817,340374,2631,146733,2104,178666,82,14975,1770,65842,3029,144249,1853,210091,California
Monterey,2021-04-30,3345,343719,1743,148476,1528,180194,74,15049,869,64320,2463,146712,941,211032,California
Monterey,2021-05-01,5862,349581,4421,152897,1399,181593,42,15091,709,59940,5130,151842,750,211782,California
Monterey,2021-05-02,4520,354101,4076,156973,417,182010,27,15118,320,56102,4185,156027,347,212129,California
Monterey,2021-05-03,2607,356708,1615,158588,874,182884,118,15236,602,54828,1994,158021,720,212849,California
Monterey,2021-05-04,1944,358652,705,159293,1143,184027,96,15332,686,54369,1242,159263,783,213632,California
Monterey,2021-05-05,3570,362222,1346,160639,2138,186165,86,15418,1132,53167,2421,161684,1219,214851,California
Monterey,2021-05-06,4507,366729,3011,163650,1273,187438,223,15641,1187,51274,3304,164988,1411,216262,California
Monterey,2021-05-07,2274,369003,1215,164865,956,188394,103,15744,738,50594,1520,166508,840,217102,California
Monterey,2021-05-08,2798,371801,1536,166401,937,189331,325,16069,996,50126,1788,168296,1320,218422,California
Monterey,2021-05-09,416,372217,130,166531,259,189590,27,16096,138,50014,277,168573,165,218587,California
Monterey,2021-05-10,2914,375131,2140,168671,722,190312,52,16148,552,48271,2348,170921,605,219192,California
Monterey,2021-05-11,1985,377116,1036,169707,865,191177,84,16232,800,47985,1171,172092,885,220077,California
Monterey,2021-05-12,4189,381305,2188,171895,1913,193090,88,16320,910,45722,3260,175352,997,221074,California
Monterey,2021-05-13,2799,384104,1681,173576,1060,194150,58,16378,1589,46173,1194,176546,1645,222719,California
Monterey,2021-05-14,1968,386072,632,174208,1235,195385,101,16479,760,45836,1198,177744,861,223580,California
Monterey,2021-05-15,3470,389542,862,175070,2342,197727,266,16745,964,44570,2492,180236,1226,224806,California
Monterey,2021-05-16,1031,390573,663,175733,293,198020,75,16820,293,44207,731,180967,368,225174,California
Monterey,2021-05-17,2304,392877,1368,177101,852,198872,84,16904,1081,44164,1208,182175,1165,226339,California
Monterey,2021-05-18,1926,394803,844,177945,1034,199906,48,16952,852,44003,1063,183238,902,227241,California
Monterey,2021-05-19,3833,398636,2512,180457,1231,201137,90,17042,1965,44200,1861,185099,2058,229299,California
Monterey,2021-05-20,2983,401619,1132,181589,1733,202870,118,17160,1019,43391,1948,187047,1139,230438,California
Monterey,2021-05-21,3503,405122,1490,183079,1913,204783,100,17260,1135,42273,2353,189400,1235,231673,California
Monterey,2021-05-22,2254,407376,819,183898,1150,205933,285,17545,876,42064,1368,190768,1159,232832,California
Monterey,2021-05-23,896,408272,535,184433,345,206278,16,17561,510,42211,379,191147,526,233358,California
Monterey,2021-05-24,1788,410060,589,185022,1136,207414,63,17624,584,41661,1198,192345,648,234006,California
Monterey,2021-05-25,1574,411634,636,185658,866,208280,72,17696,599,41376,957,193302,672,234678,California
Monterey,2021-05-26,2798,414432,1100,186758,1639,209919,59,17755,1028,40712,1750,195052,1086,235764,California
Monterey,2021-05-27,2573,417005,1411,188169,1101,211020,61,17816,896,40009,1660,196712,957,236721,California
Monterey,2021-05-28,1812,418817,630,188799,1121,212141,61,17877,771,39811,1030,197742,832,237553,California
Monterey,2021-05-29,1023,419840,664,189463,327,212468,32,17909,407,39641,610,198352,440,237993,California
Monterey,2021-05-30,391,420231,170,189633,206,212674,15,17924,146,39559,244,198596,162,238155,California
Monterey,2021-05-31,190,420421,35,189668,146,212820,9,17933,52,39483,137,198733,61,238216,California
Monterey,2021-06-01,1818,422239,991,190659,690,213510,137,18070,561,38940,1237,199970,694,238910,California
Monterey,2021-06-02,1789,424028,1047,191706,691,214201,51,18121,746,38702,1035,201005,797,239707,California
Monterey,2021-06-03,2308,426336,1458,193164,811,215012,39,18160,550,37542,1748,202753,588,240295,California
Monterey,2021-06-04,1437,427773,772,193936,630,215642,35,18195,600,37348,828,203581,634,240929,California
Monterey,2021-06-05,2252,430025,895,194831,728,216370,629,18824,486,36707,1748,205329,1107,242036,California
Monterey,2021-06-06,536,430561,439,195270,86,216456,11,18835,280,36742,255,205584,290,242326,California
Monterey,2021-06-07,987,431548,524,195794,418,216874,45,18880,386,36583,588,206172,429,242755,California
Monterey,2021-06-08,1263,432811,819,196613,421,217295,23,18903,437,36227,816,206988,460,243215,California
Monterey,2021-06-09,2987,435798,2254,198867,607,217902,126,19029,637,34643,2346,209334,762,243977,California
Monterey,2021-06-10,1586,437384,988,199855,534,218436,64,19093,557,34240,1022,210356,619,244596,California
Monterey,2021-06-11,1473,438857,812,200667,568,219004,93,19186,532,33928,935,211291,623,245219,California
Monterey,2021-06-12,783,439640,537,201204,232,219236,14,19200,360,33883,419,211710,374,245593,California
Monterey,2021-06-13,609,440249,470,201674,126,219362,13,19213,121,33532,484,212194,133,245726,California
Monterey,2021-06-14,1437,441686,1030,202704,371,219733,36,19249,378,32894,1052,213246,414,246140,California
Monterey,2021-06-15,1225,442911,636,203340,462,220195,127,19376,425,32657,788,214034,551,246691,California
Monterey,2021-06-16,1656,444567,1182,204522,439,220634,35,19411,449,31947,1194,215228,484,247175,California
Monterey,2021-06-17,1224,445791,710,205232,350,220984,164,19575,444,31782,772,216000,607,247782,California
Monterey,2021-06-18,1246,447037,755,205987,458,221442,33,19608,550,31677,687,216687,582,248364,California
Monterey,2021-06-19,1326,448363,1028,207015,267,221709,31,19639,492,31374,826,217513,523,248887,California
Monterey,2021-06-20,246,448609,167,207182,70,221779,9,19648,84,31306,162,217675,94,248981,California
Monterey,2021-06-21,686,449295,378,207560,273,222052,35,19683,392,31444,288,217963,426,249407,California
Monterey,2021-06-22,1563,450858,1000,208560,361,222413,202,19885,511,31113,1038,219001,707,250114,California
Monterey,2021-06-23,1107,451965,742,209302,331,222744,34,19919,456,30960,642,219643,489,250603,California
Monterey,2021-06-24,922,452887,547,209849,346,223090,29,19948,445,30963,471,220114,474,251077,California
Monterey,2021-06-25,1053,453940,653,210502,384,223474,16,19964,498,30927,549,220663,513,251590,California
Monterey,2021-06-26,627,454567,451,210953,158,223632,18,19982,341,31002,281,220944,356,251946,California
Monterey,2021-06-27,394,454961,312,211265,68,223700,14,19996,113,30850,279,221223,127,252073,California
Monterey,2021-06-28,607,455568,398,211663,178,223878,31,20027,264,30807,338,221561,295,252368,California
Monterey,2021-06-29,935,456503,583,212246,267,224145,85,20112,363,30689,565,222126,447,252815,California
Monterey,2021-06-30,1074,457577,722,212968,329,224474,23,20135,449,30542,619,222745,472,253287,California
Monterey,2021-07-01,812,458389,555,213523,234,224708,23,20158,374,30508,430,223175,396,253683,California
Monterey,2021-07-02,1008,459397,596,214119,371,225079,41,20199,526,30599,475,223650,566,254249,California
Monterey,2021-07-03,601,459998,460,214579,136,225215,5,20204,279,30564,318,223968,283,254532,California
Monterey,2021-07-04,35,460033,24,214603,10,225225,1,20205,23,30576,12,223980,24,254556,California
Monterey,2021-07-05,399,460432,245,214848,147,225372,7,20212,179,30544,218,224198,186,254742,California
Monterey,2021-07-06,919,461351,651,215499,243,225615,25,20237,388,30430,526,224724,412,255154,California
Monterey,2021-07-07,835,462186,560,216059,251,225866,24,20261,405,30437,422,225146,429,255583,California
Monterey,2021-07-08,864,463050,469,216528,361,226227,34,20295,318,30256,531,225677,350,255933,California
Monterey,2021-07-09,1033,464083,643,217171,350,226577,40,20335,446,30164,578,226255,486,256419,California
Monterey,2021-07-10,856,464939,520,217691,197,226774,139,20474,377,30203,471,226726,510,256929,California
Monterey,2021-07-11,207,465146,139,217830,60,226834,8,20482,104,30216,99,226825,112,257041,California
Monterey,2021-07-12,620,465766,433,218263,168,227002,19,20501,263,30145,352,227177,281,257322,California
Monterey,2021-07-13,812,466578,606,218869,189,227191,17,20518,276,29906,531,227708,292,257614,California
Monterey,2021-07-14,827,467405,566,219435,239,227430,22,20540,427,29966,389,228097,449,258063,California
Monterey,2021-07-15,869,468274,589,220024,271,227701,9,20549,399,29910,463,228560,407,258470,California
Monterey,2021-07-16,946,469220,603,220627,311,228012,32,20581,441,29880,504,229064,474,258944,California
Monterey,2021-07-17,682,469902,487,221114,185,228197,10,20591,336,29886,340,229404,346,259290,California
Monterey,2021-07-18,214,470116,154,221268,58,228255,2,20593,114,29903,100,229504,117,259407,California
Monterey,2021-07-19,601,470717,403,221671,171,228426,27,20620,306,29950,286,229790,333,259740,California
Monterey,2021-07-20,781,471498,512,222183,234,228660,35,20655,389,29987,387,230177,424,260164,California
Monterey,2021-07-21,910,472408,657,222840,234,228894,19,20674,489,30081,415,230592,509,260673,California
Monterey,2021-07-22,936,473344,628,223468,297,229191,11,20685,528,30218,402,230994,539,261212,California
Monterey,2021-07-23,1161,474505,699,224167,393,229584,69,20754,591,30314,564,231558,660,261872,California
Monterey,2021-07-24,586,475091,439,224606,142,229726,5,20759,323,30382,260,231818,328,262200,California
Monterey,2021-07-25,235,475326,157,224763,73,229799,5,20764,173,30498,62,231880,178,262378,California
Monterey,2021-07-26,642,475968,419,225182,204,230003,19,20783,405,30691,231,232111,424,262802,California
Monterey,2021-07-27,901,476869,604,225786,260,230263,37,20820,462,30758,432,232543,499,263301,California
Monterey,2021-07-28,1049,477918,802,226588,241,230504,6,20826,700,31120,343,232886,705,264006,California
Monterey,2021-07-29,887,478805,562,227150,288,230792,37,20863,550,31381,325,233211,586,264592,California
Monterey,2021-07-30,1119,479924,659,227809,425,231217,35,20898,598,31516,497,233708,632,265224,California
Monterey,2021-07-31,797,480721,598,228407,181,231398,18,20916,477,31697,314,234022,495,265719,California
Monterey,2021-08-01,263,480984,187,228594,75,231473,1,20917,171,31780,89,234111,172,265891,California
Monterey,2021-08-02,737,481721,520,229114,190,231663,27,20944,453,31983,277,234388,480,266371,California
Monterey,2021-08-03,915,482636,621,229735,248,231911,46,20990,580,32281,327,234715,625,266996,California
Monterey,2021-08-04,1162,483798,859,230594,247,232158,56,21046,721,32630,428,235143,777,267773,California
Monterey,2021-08-05,880,484678,503,231097,322,232480,55,21101,490,32808,366,235509,544,268317,California
Monterey,2021-08-06,1093,485771,658,231755,411,232891,24,21125,638,33029,441,235950,662,268979,California
Monterey,2021-08-07,725,486496,523,232278,175,233066,27,21152,400,33133,322,236272,426,269405,California
Monterey,2021-08-08,306,486802,196,232474,93,233159,17,21169,182,33208,124,236396,199,269604,California
Monterey,2021-08-09,883,487685,608,233082,250,233409,25,21194,514,33389,357,236753,538,270142,California
Monterey,2021-08-10,813,488498,551,233633,240,233649,22,21216,480,33579,312,237065,502,270644,California
Monterey,2021-08-11,1221,489719,925,234558,280,233929,16,21232,749,33894,449,237514,764,271408,California
Monterey,2021-08-12,927,490646,595,235153,283,234212,49,21281,490,34016,416,237930,538,271946,California
Monterey,2021-08-13,1140,491786,705,235858,395,234607,40,21321,651,34247,459,238389,690,272636,California
Monterey,2021-08-14,919,492705,681,236539,233,234840,5,21326,550,34455,347,238736,555,273191,California
Monterey,2021-08-15,367,493072,229,236768,137,234977,1,21327,210,34534,133,238869,212,273403,California
Monterey,2021-08-16,928,494000,593,237361,315,235292,20,21347,493,34696,353,239222,515,273918,California
Monterey,2021-08-17,1012,495012,583,237944,376,235668,53,21400,468,34761,454,239676,519,274437,California
Monterey,2021-08-18,1468,496480,1055,238999,386,236054,27,21427,686,34789,684,240360,712,275149,California
Monterey,2021-08-19,1043,497523,621,239620,376,236430,46,21473,502,34881,457,240817,549,275698,California
Monterey,2021-08-20,1263,498786,806,240426,427,236857,30,21503,621,34987,544,241361,650,276348,California
Monterey,2021-08-21,917,499703,730,241156,182,237039,5,21508,458,35022,428,241789,463,276811,California
Monterey,2021-08-22,358,500061,240,241396,117,237156,1,21509,194,35080,137,241926,195,277006,California
Monterey,2021-08-23,923,500984,555,241951,330,237486,38,21547,430,35138,409,242335,467,277473,California
Monterey,2021-08-24,989,501973,656,242607,304,237790,29,21576,433,35134,469,242804,465,277938,California
Monterey,2021-08-25,1501,503474,1111,243718,362,238152,28,21604,716,35196,682,243486,744,278682,California
Monterey,2021-08-26,1099,504573,620,244338,459,238611,20,21624,497,35248,465,243951,517,279199,California
Monterey,2021-08-27,1269,505842,811,245149,434,239045,24,21648,615,35326,563,244514,641,279840,California
Monterey,2021-08-28,832,506674,629,245778,195,239240,8,21656,431,35394,370,244884,438,280278,California
Monterey,2021-08-29,383,507057,254,246032,125,239365,4,21660,166,35378,186,245070,170,280448,California
Monterey,2021-08-30,568,507625,376,246408,169,239534,23,21683,221,35346,276,245346,244,280692,California
Napa,2020-12-16,12,12,12,12,0,0,0,0,12,12,0,0,12,12,California
Napa,2020-12-17,50,62,50,62,0,0,0,0,50,62,0,0,50,62,California
Napa,2020-12-18,108,170,108,170,0,0,0,0,108,170,0,0,108,170,California
Napa,2020-12-19,226,396,226,396,0,0,0,0,226,396,0,0,226,396,California
Napa,2020-12-20,190,586,190,586,0,0,0,0,190,586,0,0,190,586,California
Napa,2020-12-21,331,917,331,917,0,0,0,0,332,918,0,0,332,918,California
Napa,2020-12-22,334,1251,326,1243,8,8,0,0,334,1252,0,0,334,1252,California
Napa,2020-12-23,448,1699,333,1576,115,123,0,0,449,1701,0,0,449,1701,California
Napa,2020-12-24,140,1839,79,1655,61,184,0,0,140,1841,0,0,140,1841,California
Napa,2020-12-26,39,1878,11,1666,28,212,0,0,39,1880,0,0,39,1880,California
Napa,2020-12-27,33,1911,17,1683,16,228,0,0,33,1913,0,0,33,1913,California
Napa,2020-12-28,252,2163,186,1869,66,294,0,0,276,2189,0,0,276,2189,California
Napa,2020-12-29,277,2440,220,2089,57,351,0,0,310,2499,0,0,310,2499,California
Napa,2020-12-30,643,3083,490,2579,153,504,0,0,651,3150,0,0,651,3150,California
Napa,2020-12-31,454,3537,367,2946,87,591,0,0,454,3604,0,0,454,3604,California
Napa,2021-01-01,5,3542,3,2949,2,593,0,0,5,3609,0,0,5,3609,California
Napa,2021-01-02,90,3632,85,3034,5,598,0,0,90,3699,0,0,90,3699,California
Napa,2021-01-03,13,3645,11,3045,2,600,0,0,9,3708,0,0,9,3708,California
Napa,2021-01-04,107,3752,63,3108,44,644,0,0,107,3815,0,0,107,3815,California
Napa,2021-01-05,169,3921,91,3199,78,722,0,0,151,3942,24,24,151,3966,California
Napa,2021-01-06,470,4391,121,3320,349,1071,0,0,398,4270,70,94,398,4364,California
Napa,2021-01-07,511,4902,251,3571,260,1331,0,0,396,4552,114,208,396,4760,California
Napa,2021-01-08,439,5341,224,3795,215,1546,0,0,260,4634,178,386,260,5020,California
Napa,2021-01-09,329,5670,304,4099,25,1571,0,0,188,4681,141,527,188,5208,California
Napa,2021-01-10,190,5860,107,4206,83,1654,0,0,109,4710,81,608,110,5318,California
Napa,2021-01-11,894,6754,441,4647,453,2107,0,0,505,4827,390,998,507,5825,California
Napa,2021-01-12,1343,8097,385,5032,958,3065,0,0,1016,5517,326,1324,1016,6841,California
Napa,2021-01-13,1320,9417,273,5305,1047,4112,0,0,1152,6503,167,1491,1153,7994,California
Napa,2021-01-14,1058,10475,168,5473,890,5002,0,0,942,7331,114,1605,942,8936,California
Napa,2021-01-15,1486,11961,391,5864,1095,6097,0,0,1340,8519,153,1758,1341,10277,California
Napa,2021-01-16,370,12331,139,6003,231,6328,0,0,352,8853,18,1776,352,10629,California
Napa,2021-01-17,343,12674,177,6180,166,6494,0,0,332,9174,11,1787,332,10961,California
Napa,2021-01-18,1090,13764,198,6378,892,7386,0,0,996,10076,94,1881,996,11957,California
Napa,2021-01-19,1010,14774,411,6789,599,7985,0,0,762,10591,247,2128,762,12719,California
Napa,2021-01-20,842,15616,193,6982,649,8634,0,0,652,11055,189,2317,653,13372,California
Napa,2021-01-21,1542,17158,585,7567,957,9591,0,0,1098,11711,443,2760,1099,14471,California
Napa,2021-01-22,1576,18734,438,8005,1138,10729,0,0,1233,12604,341,3101,1234,15705,California
Napa,2021-01-23,400,19134,318,8323,82,10811,0,0,339,12882,61,3162,339,16044,California
Napa,2021-01-24,270,19404,186,8509,84,10895,0,0,212,13036,58,3220,212,16256,California
Napa,2021-01-25,1531,20935,230,8739,1301,12196,0,0,1441,14387,90,3310,1441,17697,California
Napa,2021-01-26,882,21817,289,9028,593,12789,0,0,781,15068,101,3411,782,18479,California
Napa,2021-01-27,636,22453,222,9250,414,13203,0,0,470,15373,166,3577,471,18950,California
Napa,2021-01-28,399,22852,178,9428,221,13424,0,0,203,15382,194,3771,203,19153,California
Napa,2021-01-29,268,23120,67,9495,201,13625,0,0,172,15458,96,3867,172,19325,California
Napa,2021-01-30,830,23950,716,10211,114,13739,0,0,660,15948,170,4037,660,19985,California
Napa,2021-01-31,699,24649,666,10877,33,13772,0,0,674,16597,25,4062,674,20659,California
Napa,2021-02-01,328,24977,114,10991,214,13986,0,0,168,16605,160,4222,168,20827,California
Napa,2021-02-02,617,25594,283,11274,334,14320,0,0,301,16593,313,4535,301,21128,California
Napa,2021-02-03,748,26342,310,11584,438,14758,0,0,429,16704,318,4853,429,21557,California
Napa,2021-02-04,786,27128,369,11953,417,15175,0,0,441,16802,343,5196,441,21998,California
Napa,2021-02-05,724,27852,314,12267,410,15585,0,0,343,16765,381,5577,344,22342,California
Napa,2021-02-06,442,28294,145,12412,297,15882,0,0,333,16990,108,5685,333,22675,California
Napa,2021-02-07,177,28471,162,12574,15,15897,0,0,67,16947,110,5795,67,22742,California
Napa,2021-02-08,844,29315,194,12768,650,16547,0,0,273,16651,569,6364,273,23015,California
Napa,2021-02-09,1095,30410,450,13218,645,17192,0,0,444,16445,650,7014,444,23459,California
Napa,2021-02-10,1750,32160,193,13411,1557,18749,0,0,451,15601,1296,8310,452,23911,California
Napa,2021-02-11,1503,33663,192,13603,1311,20060,0,0,406,14923,1084,9394,406,24317,California
Napa,2021-02-12,2191,35854,856,14459,1335,21395,0,0,690,14118,1495,10889,690,25007,California
Napa,2021-02-13,528,36382,62,14521,466,21861,0,0,328,14246,200,11089,328,25335,California
Napa,2021-02-14,337,36719,69,14590,268,22129,0,0,173,14256,163,11252,173,25508,California
Napa,2021-02-15,891,37610,183,14773,708,22837,0,0,236,13839,653,11905,236,25744,California
Napa,2021-02-16,1303,38913,605,15378,698,23535,0,0,621,13781,679,12584,621,26365,California
Napa,2021-02-17,1051,39964,528,15906,523,24058,0,0,476,13685,573,13157,477,26842,California
Napa,2021-02-18,1935,41899,492,16398,1443,25501,0,0,670,13094,1261,14418,670,27512,California
Napa,2021-02-19,1520,43419,600,16998,920,26421,0,0,679,12935,838,15256,679,28191,California
Napa,2021-02-20,884,44303,644,17642,240,26661,0,0,284,12619,600,15856,284,28475,California
Napa,2021-02-21,910,45213,833,18475,77,26738,0,0,200,12109,710,16566,200,28675,California
Napa,2021-02-22,485,45698,199,18674,286,27024,0,0,147,11919,337,16903,147,28822,California
Napa,2021-02-23,1173,46871,311,18985,862,27886,0,0,329,11405,843,17746,329,29151,California
Napa,2021-02-24,1197,48068,654,19639,543,28429,0,0,591,11392,604,18350,591,29742,California
Napa,2021-02-25,2698,50766,1310,20949,1388,29817,0,0,1951,12598,745,19095,1951,31693,California
Napa,2021-02-26,1585,52351,563,21512,1022,30839,0,0,627,12270,955,20050,627,32320,California
Napa,2021-02-27,1188,53539,433,21945,755,31594,0,0,921,12927,264,20314,921,33241,California
Napa,2021-02-28,738,54277,616,22561,122,31716,0,0,618,13428,118,20432,619,33860,California
Napa,2021-03-01,1213,55490,898,23459,314,32030,1,1,923,14066,287,20719,925,34785,California
Napa,2021-03-02,1565,57055,1078,24537,487,32517,0,1,1199,14901,364,21083,1199,35984,California
Napa,2021-03-03,1599,58654,703,25240,896,33413,0,1,1405,16114,192,21275,1405,37389,California
Napa,2021-03-04,1757,60411,809,26049,948,34361,0,1,1504,17368,250,21525,1504,38893,California
Napa,2021-03-05,1938,62349,793,26842,1140,35501,5,6,1507,18452,427,21952,1511,40404,California
Napa,2021-03-06,672,63021,301,27143,341,35842,30,36,550,18912,120,22072,580,40984,California
Napa,2021-03-07,542,63563,300,27443,202,36044,40,76,393,19193,148,22220,429,41413,California
Napa,2021-03-08,728,64291,339,27782,335,36379,54,130,551,19620,173,22393,600,42013,California
Napa,2021-03-09,1702,65993,611,28393,1042,37421,49,179,1256,20481,443,22836,1304,43317,California
Napa,2021-03-10,1520,67513,928,29321,493,37914,99,278,811,20685,702,23538,906,44223,California
Napa,2021-03-11,1907,69420,1080,30401,694,38608,133,411,1001,20908,903,24441,1126,45349,California
Napa,2021-03-12,1547,70967,936,31337,518,39126,93,504,837,21127,706,25147,925,46274,California
Napa,2021-03-13,1183,72150,311,31648,849,39975,23,527,833,21635,348,25495,856,47130,California
Napa,2021-03-14,627,72777,340,31988,135,40110,152,679,207,21573,418,25913,356,47486,California
Napa,2021-03-15,980,73757,416,32404,492,40602,72,751,486,21637,492,26405,556,48042,California
Napa,2021-03-16,1883,75640,394,32798,1360,41962,129,880,1404,22695,475,26880,1533,49575,California
Napa,2021-03-17,2518,78158,1839,34637,499,42461,180,1060,1602,23559,915,27795,1779,51354,California
Napa,2021-03-18,2152,80310,957,35594,1181,43642,14,1074,1267,23961,879,28674,1281,52635,California
Napa,2021-03-19,1462,81772,891,36485,546,44188,25,1099,682,23891,777,29451,707,53342,California
Napa,2021-03-20,1028,82800,542,37027,329,44517,157,1256,388,23797,637,30088,543,53885,California
Napa,2021-03-21,731,83531,706,37733,23,44540,2,1258,232,23533,498,30586,234,54119,California
Napa,2021-03-22,1301,84832,1121,38854,170,44710,10,1268,413,23075,881,31467,423,54542,California
Napa,2021-03-23,1919,86751,1222,40076,681,45391,16,1284,1008,23192,907,32374,1024,55566,California
Napa,2021-03-24,1720,88471,945,41021,767,46158,8,1292,816,23115,900,33274,823,56389,California
Napa,2021-03-25,1971,90442,1077,42098,840,46998,54,1346,768,22740,1197,34471,822,57211,California
Napa,2021-03-26,1324,91766,850,42948,469,47467,5,1351,583,22593,735,35206,588,57799,California
Napa,2021-03-27,938,92704,446,43394,465,47932,27,1378,295,22272,643,35849,322,58121,California
Napa,2021-03-28,495,93199,384,43778,104,48036,7,1385,179,22144,314,36163,186,58307,California
Napa,2021-03-29,1216,94415,883,44661,328,48364,5,1390,735,22406,478,36641,740,59047,California
Napa,2021-03-30,2836,97251,946,45607,1885,50249,5,1395,1987,23549,849,37490,1992,61039,California
Napa,2021-03-31,2001,99252,985,46592,947,51196,69,1464,811,23240,1186,38676,877,61916,California
Napa,2021-04-01,1784,101036,856,47448,809,52005,119,1583,489,22556,1287,39963,603,62519,California
Napa,2021-04-02,1895,102931,855,48303,898,52903,142,1725,478,21764,1411,41374,619,63138,California
Napa,2021-04-03,644,103575,373,48676,212,53115,59,1784,213,21604,430,41804,270,63408,California
Napa,2021-04-04,361,103936,147,48823,156,53271,58,1842,125,21552,235,42039,183,63591,California
Napa,2021-04-05,1291,105227,764,49587,306,53577,221,2063,571,21625,717,42756,790,64381,California
Napa,2021-04-06,2276,107503,566,50153,1446,55023,264,2327,505,20623,1768,44524,766,65147,California
Napa,2021-04-07,1777,109280,724,50877,828,55851,225,2552,530,20136,1240,45764,753,65900,California
Napa,2021-04-08,1880,111160,1076,51953,424,56275,380,2932,966,20572,908,46672,1344,67244,California
Napa,2021-04-09,1582,112742,941,52894,333,56608,308,3240,683,20663,896,47568,987,68231,California
Napa,2021-04-10,1048,113790,344,53238,599,57207,105,3345,239,20202,805,48373,344,68575,California
Napa,2021-04-11,389,114179,306,53544,61,57268,22,3367,159,20153,230,48603,181,68756,California
Napa,2021-04-12,798,114977,303,53847,370,57638,125,3492,293,20062,503,49106,412,69168,California
Napa,2021-04-13,2609,117586,875,54722,1734,59372,0,3492,919,19299,1682,50788,919,70087,California
Napa,2021-04-14,2167,119753,1020,55742,1147,60519,0,3492,1045,19230,1114,51902,1045,71132,California
Napa,2021-04-15,2084,121837,537,56279,1547,62066,0,3492,881,18917,1194,53096,881,72013,California
Napa,2021-04-16,3050,124887,1677,57956,1373,63439,0,3492,2313,20498,732,53828,2313,74326,California
Napa,2021-04-17,1176,126063,288,58244,888,64327,0,3492,862,21048,312,54140,862,75188,California
Napa,2021-04-18,287,126350,195,58439,92,64419,0,3492,120,21001,167,54307,120,75308,California
Napa,2021-04-19,624,126974,339,58778,285,64704,0,3492,269,20916,354,54661,269,75577,California
Napa,2021-04-20,3105,130079,2117,60895,988,65692,0,3492,2110,22036,991,55652,2111,77688,California
Napa,2021-04-21,3036,133115,2244,63139,792,66484,0,3492,1919,22845,1111,56763,1920,79608,California
Napa,2021-04-22,1876,134991,1309,64448,566,67050,1,3493,869,22714,1000,57763,869,80477,California
Napa,2021-04-23,1693,136684,1298,65746,393,67443,2,3495,1193,23411,496,58259,1193,81670,California
Napa,2021-04-24,582,137266,323,66069,259,67702,0,3495,290,23412,289,58548,290,81960,California
Napa,2021-04-25,259,137525,196,66265,63,67765,0,3495,131,23418,125,58673,131,82091,California
Napa,2021-04-26,555,138080,289,66554,266,68031,0,3495,283,23435,266,58939,283,82374,California
Napa,2021-04-27,1817,139897,476,67030,1328,69359,13,3508,602,22837,1212,60151,614,82988,California
Napa,2021-04-28,1054,140951,489,67519,548,69907,17,3525,356,22515,695,60846,373,83361,California
Napa,2021-04-29,749,141700,375,67894,355,70262,19,3544,263,22320,476,61322,281,83642,California
Napa,2021-04-30,635,142335,317,68211,254,70516,64,3608,260,22270,373,61695,323,83965,California
Napa,2021-05-01,337,142672,270,68481,56,70572,11,3619,129,22203,207,61902,140,84105,California
Napa,2021-05-02,238,142910,195,68676,37,70609,6,3625,100,22172,137,62039,106,84211,California
Napa,2021-05-03,641,143551,497,69173,108,70717,36,3661,111,21794,526,62565,148,84359,California
Napa,2021-05-04,1164,144715,743,69916,311,71028,110,3771,318,21379,841,63406,426,84785,California
Napa,2021-05-05,1046,145761,705,70621,302,71330,39,3810,260,20895,783,64189,299,85084,California
Napa,2021-05-06,731,146492,318,70939,389,71719,24,3834,376,20950,345,64534,400,85484,California
Napa,2021-05-07,1627,148119,1394,72333,169,71888,64,3898,336,20083,1266,65800,399,85883,California
Napa,2021-05-08,263,148382,167,72500,85,71973,11,3909,88,20010,172,65972,99,85982,California
Napa,2021-05-09,120,148502,87,72587,33,72006,0,3909,58,20008,60,66032,58,86040,California
Napa,2021-05-10,435,148937,151,72738,264,72270,20,3929,110,19814,324,66356,130,86170,California
Napa,2021-05-11,2243,151180,1848,74586,369,72639,26,3955,387,18376,1851,68207,413,86583,California
Napa,2021-05-12,2289,153469,1436,76022,796,73435,57,4012,315,16782,1967,70174,373,86956,California
Napa,2021-05-13,1989,155458,1286,77308,662,74097,41,4053,887,16617,1094,71268,929,87885,California
Napa,2021-05-14,2004,157462,1214,78522,705,74802,85,4138,530,15765,1468,72736,616,88501,California
Napa,2021-05-15,1090,158552,370,78892,708,75510,12,4150,258,15211,826,73562,272,88773,California
Napa,2021-05-16,252,158804,170,79062,80,75590,2,4152,71,15103,181,73743,73,88846,California
Napa,2021-05-17,907,159711,356,79418,521,76111,30,4182,306,14904,536,74279,337,89183,California
Napa,2021-05-18,1092,160803,566,79984,468,76579,58,4240,521,14918,565,74844,579,89762,California
Napa,2021-05-19,1008,161811,602,80586,376,76955,30,4270,521,14986,483,75327,551,90313,California
Napa,2021-05-20,675,162486,444,81030,200,77155,31,4301,397,15138,275,75602,427,90740,California
Napa,2021-05-21,540,163026,271,81301,237,77392,32,4333,225,15082,313,75915,257,90997,California
Napa,2021-05-22,470,163496,284,81585,177,77569,9,4342,194,15011,275,76190,204,91201,California
Napa,2021-05-23,407,163903,361,81946,35,77604,11,4353,303,15221,104,76294,314,91515,California
Napa,2021-05-24,382,164285,189,82135,173,77777,20,4373,154,15170,225,76519,174,91689,California
Napa,2021-05-25,431,164716,174,82309,184,77961,73,4446,144,15101,285,76804,216,91905,California
Napa,2021-05-26,556,165272,359,82668,170,78131,27,4473,314,15205,237,77041,341,92246,California
Napa,2021-05-27,388,165660,172,82840,188,78319,28,4501,153,15151,235,77276,181,92427,California
Napa,2021-05-28,416,166076,213,83053,178,78497,25,4526,170,15102,242,77518,193,92620,California
Napa,2021-05-29,132,166208,80,83133,48,78545,4,4530,76,15127,55,77573,80,92700,California
Napa,2021-05-30,102,166310,64,83197,33,78578,5,4535,29,15093,68,77641,34,92734,California
Napa,2021-05-31,52,166362,18,83215,28,78606,6,4541,9,15065,43,77684,15,92749,California
Napa,2021-06-01,623,166985,318,83533,281,78887,24,4565,272,15015,345,78029,295,93044,California
Napa,2021-06-02,428,167413,258,83791,147,79034,23,4588,201,15013,225,78254,223,93267,California
Napa,2021-06-03,766,168179,464,84255,277,79311,25,4613,131,14537,630,78884,154,93421,California
Napa,2021-06-04,799,168978,616,84871,145,79456,38,4651,146,14071,649,79533,183,93604,California
Napa,2021-06-05,318,169296,259,85130,48,79504,11,4662,78,13922,238,79771,89,93693,California
Napa,2021-06-06,146,169442,126,85256,19,79523,1,4663,44,13866,101,79872,45,93738,California
Napa,2021-06-07,413,169855,301,85557,85,79608,27,4690,105,13691,307,80179,132,93870,California
Napa,2021-06-08,636,170491,504,86061,115,79723,17,4707,280,13636,352,80531,297,94167,California
Napa,2021-06-09,572,171063,462,86523,95,79818,15,4722,94,13272,473,81004,109,94276,California
Napa,2021-06-10,523,171586,422,86945,68,79886,33,4755,107,12996,416,81420,140,94416,California
Napa,2021-06-11,413,171999,270,87215,120,80006,23,4778,116,12839,296,81716,139,94555,California
Napa,2021-06-12,208,172207,174,87389,29,80035,5,4783,43,12724,164,81880,49,94604,California
Napa,2021-06-13,291,172498,278,87667,8,80043,5,4788,24,12486,267,82147,29,94633,California
Napa,2021-06-14,498,172996,355,88022,116,80159,27,4815,96,12209,397,82544,120,94753,California
Napa,2021-06-15,383,173379,285,88307,85,80244,13,4828,193,12226,189,82733,206,94959,California
Napa,2021-06-16,263,173642,166,88473,81,80325,16,4844,86,12154,174,82907,102,95061,California
Napa,2021-06-17,400,174042,325,88798,66,80391,9,4853,76,11915,324,83231,85,95146,California
Napa,2021-06-18,280,174322,185,88983,84,80475,11,4864,95,11839,183,83414,107,95253,California
Napa,2021-06-19,107,174429,74,89057,23,80498,10,4874,45,11833,61,83475,55,95308,California
Napa,2021-06-20,54,174483,42,89099,9,80507,3,4877,19,11820,35,83510,22,95330,California
Napa,2021-06-21,161,174644,73,89172,67,80574,21,4898,74,11829,86,83596,95,95425,California
Napa,2021-06-22,376,175020,299,89471,63,80637,14,4912,108,11684,267,83863,122,95547,California
Napa,2021-06-23,342,175362,266,89737,54,80691,22,4934,107,11581,231,84094,128,95675,California
Napa,2021-06-24,172,175534,117,89854,49,80740,6,4940,74,11565,96,84190,80,95755,California
Napa,2021-06-25,251,175785,166,90020,72,80812,13,4953,122,11577,122,84312,134,95889,California
Napa,2021-06-26,96,175881,82,90102,10,80822,4,4957,50,11585,46,84358,54,95943,California
Napa,2021-06-27,72,175953,62,90164,10,80832,0,4957,34,11581,38,84396,34,95977,California
Napa,2021-06-28,197,176150,150,90314,35,80867,12,4969,82,11561,113,84509,93,96070,California
Napa,2021-06-29,417,176567,341,90655,57,80924,19,4988,112,11389,303,84812,131,96201,California
Napa,2021-06-30,184,176751,125,90780,49,80973,10,4998,79,11374,104,84916,89,96290,California
Napa,2021-07-01,172,176923,116,90896,46,81019,10,5008,78,11368,93,85009,87,96377,California
Napa,2021-07-02,171,177094,129,91025,36,81055,6,5014,69,11342,101,85110,75,96452,California
Napa,2021-07-03,75,177169,61,91086,8,81063,6,5020,42,11358,32,85142,48,96500,California
Napa,2021-07-04,7,177176,0,91086,6,81069,1,5021,0,11352,7,85149,1,96501,California
Napa,2021-07-05,92,177268,72,91158,15,81084,5,5026,50,11365,42,85191,55,96556,California
Napa,2021-07-06,341,177609,294,91452,35,81119,12,5038,125,11288,213,85404,136,96692,California
Napa,2021-07-07,164,177773,114,91566,38,81157,12,5050,69,11274,95,85499,81,96773,California
Napa,2021-07-08,173,177946,126,91692,30,81187,17,5067,70,11259,100,85599,85,96858,California
Napa,2021-07-09,205,178151,128,91820,60,81247,17,5084,90,11254,112,85711,107,96965,California
Napa,2021-07-10,81,178232,49,91869,28,81275,4,5088,43,11264,37,85748,47,97012,California
Napa,2021-07-11,62,178294,57,91926,5,81280,0,5088,23,11252,35,85783,23,97035,California
Napa,2021-07-12,163,178457,121,92047,32,81312,10,5098,70,11240,92,85875,80,97115,California
Napa,2021-07-13,305,178762,256,92303,31,81343,18,5116,187,11328,115,85990,203,97318,California
Napa,2021-07-14,171,178933,123,92426,34,81377,14,5130,75,11321,96,86086,89,97407,California
Napa,2021-07-15,196,179129,147,92573,43,81420,6,5136,92,11320,98,86184,97,97504,California
Napa,2021-07-16,205,179334,157,92730,40,81460,8,5144,86,11296,118,86302,94,97598,California
Napa,2021-07-17,90,179424,69,92799,13,81473,8,5152,35,11285,54,86356,43,97641,California
Napa,2021-07-18,50,179474,40,92839,6,81479,4,5156,18,11275,32,86388,22,97663,California
Napa,2021-07-19,177,179651,124,92963,41,81520,12,5168,81,11272,96,86484,93,97756,California
Napa,2021-07-20,371,180022,301,93264,52,81572,18,5186,232,11387,135,86619,250,98006,California
Napa,2021-07-21,149,180171,110,93374,31,81603,8,5194,77,11402,70,86689,85,98091,California
Napa,2021-07-22,171,180342,137,93511,21,81624,13,5207,93,11431,76,86765,105,98196,California
Napa,2021-07-23,213,180555,154,93665,48,81672,11,5218,140,11511,71,86836,151,98347,California
Napa,2021-07-24,103,180658,92,93757,8,81680,3,5221,58,11528,44,86880,61,98408,California
Napa,2021-07-25,53,180711,46,93803,7,81687,0,5221,41,11559,10,86890,41,98449,California
Napa,2021-07-26,209,180920,143,93946,56,81743,10,5231,123,11609,83,86973,133,98582,California
Napa,2021-07-27,378,181298,313,94259,52,81795,13,5244,235,11719,138,87111,248,98830,California
Napa,2021-07-28,187,181485,140,94399,35,81830,12,5256,98,11741,86,87197,108,98938,California
Napa,2021-07-29,153,181638,108,94507,32,81862,13,5269,74,11751,76,87273,86,99024,California
Napa,2021-07-30,188,181826,139,94646,33,81895,16,5285,112,11804,75,87348,128,99152,California
Napa,2021-07-31,114,181940,88,94734,19,81914,7,5292,75,11849,37,87385,82,99234,California
Napa,2021-08-01,60,182000,56,94790,4,81918,0,5292,41,11871,19,87404,41,99275,California
Napa,2021-08-02,196,182196,142,94932,38,81956,16,5308,111,11914,84,87488,127,99402,California
Napa,2021-08-03,457,182653,391,95323,43,81999,23,5331,268,12016,183,87671,285,99687,California
Napa,2021-08-04,185,182838,145,95468,31,82030,9,5340,114,12070,69,87740,123,99810,California
Napa,2021-08-05,215,183053,150,95618,56,82086,9,5349,145,12160,65,87805,155,99965,California
Napa,2021-08-06,255,183308,183,95801,56,82142,16,5365,139,12204,110,87915,154,100119,California
Napa,2021-08-07,137,183445,92,95893,38,82180,7,5372,68,12216,63,87978,75,100194,California
Napa,2021-08-08,54,183499,45,95938,8,82188,1,5373,36,12236,18,87996,38,100232,California
Napa,2021-08-09,222,183721,159,96097,46,82234,17,5390,112,12261,104,88100,129,100361,California
Napa,2021-08-10,536,184257,458,96555,56,82290,22,5412,334,12418,199,88299,356,100717,California
Napa,2021-08-11,215,184472,150,96705,44,82334,21,5433,131,12491,78,88377,151,100868,California
Napa,2021-08-12,275,184747,193,96898,65,82399,17,5450,154,12546,116,88493,171,101039,California
Napa,2021-08-13,215,184962,168,97066,32,82431,15,5465,112,12578,95,88588,127,101166,California
Napa,2021-08-14,146,185108,113,97179,29,82460,4,5469,73,12593,62,88650,77,101243,California
Napa,2021-08-15,101,185209,73,97252,26,82486,2,5471,56,12617,34,88684,58,101301,California
Napa,2021-08-16,228,185437,158,97410,59,82545,11,5482,98,12628,97,88781,108,101409,California
Napa,2021-08-17,517,185954,423,97833,77,82622,17,5499,260,12675,229,89010,276,101685,California
Napa,2021-08-18,251,186205,181,98014,66,82688,4,5503,117,12703,93,89103,121,101806,California
Napa,2021-08-19,255,186460,152,98166,92,82780,11,5514,117,12759,72,89175,128,101934,California
Napa,2021-08-20,294,186754,175,98341,114,82894,5,5519,100,12734,130,89305,105,102039,California
Napa,2021-08-21,173,186927,123,98464,47,82941,3,5522,72,12747,62,89367,75,102114,California
Napa,2021-08-22,102,187029,71,98535,29,82970,2,5524,42,12754,37,89404,44,102158,California
Napa,2021-08-23,269,187298,132,98667,126,83096,11,5535,72,12722,115,89519,83,102241,California
Napa,2021-08-24,622,187920,471,99138,132,83228,19,5554,218,12684,275,89794,237,102478,California
Napa,2021-08-25,282,188202,202,99340,69,83297,11,5565,115,12703,107,89901,126,102604,California
Napa,2021-08-26,337,188539,254,99594,76,83373,7,5572,126,12714,122,90023,133,102737,California
Napa,2021-08-27,259,188798,197,99791,59,83432,3,5575,75,12664,128,90151,78,102815,California
Napa,2021-08-28,160,188958,121,99912,36,83468,3,5578,57,12656,68,90219,60,102875,California
Napa,2021-08-29,81,189039,61,99973,18,83486,2,5580,33,12653,38,90257,35,102910,California
Napa,2021-08-30,140,189179,101,100074,37,83523,2,5582,44,12632,67,90324,46,102956,California
Nevada,2020-12-16,3,3,3,3,0,0,0,0,3,3,0,0,3,3,California
Nevada,2020-12-17,6,9,6,9,0,0,0,0,6,9,0,0,6,9,California
Nevada,2020-12-18,60,69,60,69,0,0,0,0,60,69,0,0,60,69,California
Nevada,2020-12-19,52,121,52,121,0,0,0,0,52,121,0,0,52,121,California
Nevada,2020-12-20,16,137,16,137,0,0,0,0,16,137,0,0,16,137,California
Nevada,2020-12-21,69,206,69,206,0,0,0,0,69,206,0,0,69,206,California
Nevada,2020-12-22,93,299,91,297,2,2,0,0,93,299,0,0,93,299,California
Nevada,2020-12-23,245,544,214,511,31,33,0,0,245,544,0,0,245,544,California
Nevada,2020-12-24,15,559,12,523,3,36,0,0,15,559,0,0,15,559,California
Nevada,2020-12-25,3,562,3,526,0,36,0,0,3,562,0,0,3,562,California
Nevada,2020-12-26,7,569,5,531,2,38,0,0,7,569,0,0,7,569,California
Nevada,2020-12-27,91,660,90,621,1,39,0,0,91,660,0,0,91,660,California
Nevada,2020-12-28,173,833,93,714,80,119,0,0,173,833,0,0,173,833,California
Nevada,2020-12-29,101,934,70,784,31,150,0,0,101,934,0,0,101,934,California
Nevada,2020-12-30,91,1025,67,851,24,174,0,0,91,1025,0,0,91,1025,California
Nevada,2020-12-31,45,1070,9,860,36,210,0,0,45,1070,0,0,45,1070,California
Nevada,2021-01-01,4,1074,1,861,3,213,0,0,4,1074,0,0,4,1074,California
Nevada,2021-01-02,2,1076,1,862,1,214,0,0,2,1076,0,0,2,1076,California
Nevada,2021-01-03,132,1208,127,989,5,219,0,0,132,1208,0,0,132,1208,California
Nevada,2021-01-04,76,1284,43,1032,33,252,0,0,76,1284,0,0,76,1284,California
Nevada,2021-01-05,288,1572,131,1163,157,409,0,0,287,1570,1,1,287,1571,California
Nevada,2021-01-06,96,1668,45,1208,51,460,0,0,88,1650,8,9,88,1659,California
Nevada,2021-01-07,227,1895,45,1253,182,642,0,0,217,1860,8,17,218,1877,California
Nevada,2021-01-08,240,2135,133,1386,107,749,0,0,180,1981,60,77,181,2058,California
Nevada,2021-01-09,63,2198,55,1441,8,757,0,0,15,1948,48,125,15,2073,California
Nevada,2021-01-10,22,2220,11,1452,11,768,0,0,12,1950,10,135,12,2085,California
Nevada,2021-01-11,198,2418,134,1586,64,832,0,0,70,1892,128,263,70,2155,California
Nevada,2021-01-12,609,3027,459,2045,150,982,0,0,537,2357,72,335,537,2692,California
Nevada,2021-01-13,281,3308,160,2205,121,1103,0,0,138,2352,143,478,138,2830,California
Nevada,2021-01-14,254,3562,127,2332,127,1230,0,0,236,2571,17,495,236,3066,California
Nevada,2021-01-15,419,3981,173,2505,246,1476,0,0,319,2790,100,595,319,3385,California
Nevada,2021-01-16,343,4324,21,2526,322,1798,0,0,337,3121,6,601,337,3722,California
Nevada,2021-01-17,45,4369,39,2565,6,1804,0,0,42,3160,3,604,42,3764,California
Nevada,2021-01-18,162,4531,48,2613,114,1918,0,0,146,3290,16,620,146,3910,California
Nevada,2021-01-19,268,4799,101,2714,167,2085,0,0,243,3508,25,645,243,4153,California
Nevada,2021-01-20,285,5084,169,2883,116,2201,0,0,269,3761,16,661,269,4422,California
Nevada,2021-01-21,356,5440,208,3091,148,2349,0,0,340,4085,16,677,340,4762,California
Nevada,2021-01-22,388,5828,236,3327,152,2501,0,0,356,4409,32,709,356,5118,California
Nevada,2021-01-23,197,6025,112,3439,85,2586,0,0,197,4606,0,709,197,5315,California
Nevada,2021-01-24,123,6148,110,3549,13,2599,0,0,81,4645,42,751,81,5396,California
Nevada,2021-01-25,271,6419,130,3679,141,2740,0,0,203,4780,68,819,203,5599,California
Nevada,2021-01-26,449,6868,158,3837,291,3031,0,0,340,5011,109,928,340,5939,California
Nevada,2021-01-27,479,7347,284,4121,195,3226,0,0,448,5428,31,959,448,6387,California
Nevada,2021-01-28,523,7870,349,4470,174,3400,0,0,471,5848,51,1010,471,6858,California
Nevada,2021-01-29,650,8520,412,4882,238,3638,0,0,619,6438,30,1040,620,7478,California
Nevada,2021-01-30,333,8853,131,5013,202,3840,0,0,329,6763,4,1044,329,7807,California
Nevada,2021-01-31,112,8965,95,5108,17,3857,0,0,108,6869,3,1047,109,7916,California
Nevada,2021-02-01,312,9277,81,5189,231,4088,0,0,290,7137,22,1069,290,8206,California
Nevada,2021-02-02,567,9844,201,5390,366,4454,0,0,349,7268,218,1287,349,8555,California
Nevada,2021-02-03,835,10679,563,5953,272,4726,0,0,774,7982,60,1347,774,9329,California
Nevada,2021-02-04,796,11475,407,6360,389,5115,0,0,533,8253,262,1609,533,9862,California
Nevada,2021-02-05,1068,12543,401,6761,667,5782,0,0,857,8902,208,1817,857,10719,California
Nevada,2021-02-06,312,12855,111,6872,201,5983,0,0,271,9132,41,1858,271,10990,California
Nevada,2021-02-07,322,13177,257,7129,65,6048,0,0,259,9329,62,1920,259,11249,California
Nevada,2021-02-08,708,13885,425,7554,283,6331,0,0,590,9804,115,2035,590,11839,California
Nevada,2021-02-09,654,14539,372,7926,282,6613,0,0,506,10163,147,2182,506,12345,California
Nevada,2021-02-10,694,15233,346,8272,348,6961,0,0,460,10390,234,2416,461,12806,California
Nevada,2021-02-11,948,16181,539,8811,409,7370,0,0,592,10627,355,2771,592,13398,California
Nevada,2021-02-12,1342,17523,464,9275,878,8248,0,0,1005,11298,334,3105,1005,14403,California
Nevada,2021-02-13,706,18229,279,9554,427,8675,0,0,426,11449,276,3381,427,14830,California
Nevada,2021-02-14,252,18481,137,9691,115,8790,0,0,213,11623,39,3420,213,15043,California
Nevada,2021-02-15,756,19237,455,10146,301,9091,0,0,579,12026,177,3597,580,15623,California
Nevada,2021-02-16,694,19931,238,10384,456,9547,0,0,509,12351,184,3781,509,16132,California
Nevada,2021-02-17,1268,21199,821,11205,447,9994,0,0,889,12862,379,4160,890,17022,California
Nevada,2021-02-18,1057,22256,586,11791,471,10465,0,0,619,13048,433,4593,619,17641,California
Nevada,2021-02-19,1169,23425,671,12462,498,10963,0,0,774,13431,392,4985,775,18416,California
Nevada,2021-02-20,384,23809,136,12598,248,11211,0,0,227,13502,156,5141,227,18643,California
Nevada,2021-02-21,126,23935,105,12703,21,11232,0,0,20,13419,103,5244,20,18663,California
Nevada,2021-02-22,546,24481,366,13069,180,11412,0,0,379,13632,166,5410,379,19042,California
Nevada,2021-02-23,549,25030,261,13330,288,11700,0,0,227,13541,319,5729,228,19270,California
Nevada,2021-02-24,571,25601,307,13637,264,11964,0,0,265,13507,303,6032,269,19539,California
Nevada,2021-02-25,927,26528,508,14145,419,12383,0,0,452,13488,471,6503,452,19991,California
Nevada,2021-02-26,1356,27884,930,15075,426,12809,0,0,474,13083,879,7382,474,20465,California
Nevada,2021-02-27,494,28378,134,15209,360,13169,0,0,219,13027,275,7657,219,20684,California
Nevada,2021-02-28,373,28751,232,15441,141,13310,0,0,153,12962,218,7875,153,20837,California
Nevada,2021-03-01,906,29657,475,15916,431,13741,0,0,397,12855,504,8379,397,21234,California
Nevada,2021-03-02,831,30488,336,16252,495,14236,0,0,540,13108,287,8666,540,21774,California
Nevada,2021-03-03,1083,31571,548,16800,534,14770,1,1,549,13128,531,9197,551,22325,California
Nevada,2021-03-04,1202,32773,663,17463,539,15309,0,1,491,12912,707,9904,491,22816,California
Nevada,2021-03-05,1276,34049,529,17992,737,16046,10,11,412,12471,862,10766,421,23237,California
Nevada,2021-03-06,401,34450,141,18133,233,16279,27,38,155,12406,246,11012,181,23418,California
Nevada,2021-03-07,235,34685,118,18251,90,16369,27,65,73,12344,162,11174,100,23518,California
Nevada,2021-03-08,909,35594,588,18839,272,16641,49,114,405,12296,502,11676,454,23972,California
Nevada,2021-03-09,845,36439,429,19268,361,17002,55,169,473,12454,369,12045,527,24499,California
Nevada,2021-03-10,1065,37504,674,19942,332,17334,59,228,358,12169,698,12743,413,24912,California
Nevada,2021-03-11,1172,38676,749,20691,396,17730,27,255,566,12165,597,13340,593,25505,California
Nevada,2021-03-12,1593,40269,740,21431,819,18549,34,289,524,11657,1064,14404,556,26061,California
Nevada,2021-03-13,957,41226,64,21495,887,19436,6,295,754,12215,201,14605,759,26820,California
Nevada,2021-03-14,168,41394,27,21522,135,19571,6,301,36,12125,132,14737,42,26862,California
Nevada,2021-03-15,913,42307,488,22010,413,19984,12,313,379,11987,529,15266,391,27253,California
Nevada,2021-03-16,1040,43347,470,22480,508,20492,62,375,662,12334,376,15642,723,27976,California
Nevada,2021-03-17,1043,44390,452,22932,580,21072,11,386,583,12472,457,16099,595,28571,California
Nevada,2021-03-18,1024,45414,549,23481,453,21525,22,408,489,12455,527,16626,510,29081,California
Nevada,2021-03-19,967,46381,459,23940,470,21995,38,446,385,12300,577,17203,422,29503,California
Nevada,2021-03-20,863,47244,98,24038,322,22317,443,889,220,12317,637,17840,654,30157,California
Nevada,2021-03-21,68,47312,35,24073,32,22349,1,890,35,12321,32,17872,36,30193,California
Nevada,2021-03-22,834,48146,534,24607,296,22645,4,894,542,12578,289,18161,546,30739,California
Nevada,2021-03-23,878,49024,399,25006,450,23095,29,923,629,12992,244,18405,658,31397,California
Nevada,2021-03-24,1053,50077,564,25570,482,23577,7,930,653,13259,392,18797,659,32056,California
Nevada,2021-03-25,947,51024,489,26059,429,24006,29,959,507,13355,437,19234,533,32589,California
Nevada,2021-03-26,1253,52277,481,26540,730,24736,42,1001,866,13877,385,19619,907,33496,California
Nevada,2021-03-27,623,52900,77,26617,530,25266,16,1017,411,14093,211,19830,427,33923,California
Nevada,2021-03-28,204,53104,55,26672,136,25402,13,1030,36,13981,161,19991,49,33972,California
Nevada,2021-03-29,881,53985,527,27199,332,25734,22,1052,386,13898,489,20480,406,34378,California
Nevada,2021-03-30,1111,55096,496,27695,581,26315,34,1086,510,13848,594,21074,544,34922,California
Nevada,2021-03-31,1225,56321,679,28374,529,26844,17,1103,685,14019,529,21603,700,35622,California
Nevada,2021-04-01,1300,57621,753,29127,494,27338,53,1156,580,13944,706,22309,631,36253,California
Nevada,2021-04-02,1345,58966,667,29794,644,27982,34,1190,816,14269,525,22834,850,37103,California
Nevada,2021-04-03,304,59270,92,29886,177,28159,35,1225,87,14175,216,23050,122,37225,California
Nevada,2021-04-04,140,59410,48,29934,85,28244,7,1232,81,14204,59,23109,88,37313,California
Nevada,2021-04-05,984,60394,645,30579,316,28560,23,1255,626,14498,353,23462,647,37960,California
Nevada,2021-04-06,1103,61497,679,31258,278,28838,146,1401,458,14460,640,24102,602,38562,California
Nevada,2021-04-07,1193,62690,842,32100,264,29102,87,1488,638,14637,547,24649,724,39286,California
Nevada,2021-04-08,1332,64022,909,33009,331,29433,92,1580,730,14862,596,25245,821,40107,California
Nevada,2021-04-09,1314,65336,866,33875,374,29807,74,1654,867,15358,444,25689,940,41047,California
Nevada,2021-04-10,914,66250,91,33966,747,30554,76,1730,135,14796,773,26462,211,41258,California
Nevada,2021-04-11,114,66364,38,34004,70,30624,6,1736,35,14758,79,26541,41,41299,California
Nevada,2021-04-12,788,67152,565,34569,205,30829,18,1754,326,14645,457,26998,344,41643,California
Nevada,2021-04-13,906,68058,372,34941,534,31363,0,1754,456,14658,443,27441,456,42099,California
Nevada,2021-04-14,1089,69147,603,35544,486,31849,0,1754,539,14654,543,27984,539,42638,California
Nevada,2021-04-15,1142,70289,745,36289,397,32246,0,1754,649,14821,482,28466,649,43287,California
Nevada,2021-04-16,938,71227,709,36998,229,32475,0,1754,518,14921,418,28884,518,43805,California
Nevada,2021-04-17,201,71428,54,37052,147,32622,0,1754,83,14887,117,29001,83,43888,California
Nevada,2021-04-18,206,71634,22,37074,184,32806,0,1754,103,14887,103,29104,103,43991,California
Nevada,2021-04-19,804,72438,510,37584,294,33100,0,1754,313,14720,480,29584,313,44304,California
Nevada,2021-04-20,829,73267,341,37925,488,33588,0,1754,308,14515,513,30097,308,44612,California
Nevada,2021-04-21,970,74237,549,38474,421,34009,0,1754,285,14127,674,30771,286,44898,California
Nevada,2021-04-22,1043,75280,652,39126,391,34400,0,1754,349,13796,681,31452,350,45248,California
Nevada,2021-04-23,1294,76574,573,39699,721,35121,0,1754,409,13331,874,32326,409,45657,California
Nevada,2021-04-24,550,77124,79,39778,471,35592,0,1754,191,13165,357,32683,191,45848,California
Nevada,2021-04-25,137,77261,62,39840,70,35662,5,1759,56,13145,80,32763,60,45908,California
Nevada,2021-04-26,784,78045,594,40434,181,35843,9,1768,222,12824,552,33315,231,46139,California
Nevada,2021-04-27,847,78892,399,40833,443,36286,5,1773,409,12808,430,33745,414,46553,California
Nevada,2021-04-28,1029,79921,610,41443,415,36701,4,1777,391,12572,631,34376,395,46948,California
Nevada,2021-04-29,1070,80991,740,42183,324,37025,6,1783,300,12113,765,35141,306,47254,California
Nevada,2021-04-30,1307,82298,755,42938,541,37566,11,1794,226,11271,1079,36220,237,47491,California
Nevada,2021-05-01,158,82456,70,43008,84,37650,4,1798,66,11251,90,36310,70,47561,California
Nevada,2021-05-02,67,82523,34,43042,29,37679,4,1802,23,11234,44,36354,27,47588,California
Nevada,2021-05-03,633,83156,423,43465,191,37870,19,1821,182,10989,445,36799,200,47788,California
Nevada,2021-05-04,609,83765,177,43642,413,38283,19,1840,332,11067,273,37072,351,48139,California
Nevada,2021-05-05,767,84532,403,44045,349,38632,15,1855,326,10975,433,37505,341,48480,California
Nevada,2021-05-06,837,85369,580,44625,246,38878,11,1866,185,10529,642,38147,196,48676,California
Nevada,2021-05-07,910,86279,498,45123,375,39253,37,1903,184,10032,718,38865,221,48897,California
Nevada,2021-05-08,179,86458,22,45145,138,39391,19,1922,78,10030,99,38964,97,48994,California
Nevada,2021-05-09,44,86502,7,45152,35,39426,2,1924,20,10028,24,38988,22,49016,California
Nevada,2021-05-10,414,86916,262,45414,127,39553,25,1949,78,9796,335,39323,103,49119,California
Nevada,2021-05-11,518,87434,162,45576,336,39889,20,1969,125,9558,383,39706,145,49264,California
Nevada,2021-05-12,549,87983,248,45824,290,40179,11,1980,151,9332,388,40094,162,49426,California
Nevada,2021-05-13,861,88844,565,46389,286,40465,10,1990,432,9355,419,40513,442,49868,California
Nevada,2021-05-14,800,89644,587,46976,196,40661,17,2007,434,9444,362,40875,451,50319,California
Nevada,2021-05-15,185,89829,90,47066,89,40750,6,2013,88,9442,96,40971,94,50413,California
Nevada,2021-05-16,165,89994,55,47121,110,40860,0,2013,56,9389,109,41080,56,50469,California
Nevada,2021-05-17,512,90506,328,47449,153,41013,31,2044,218,9356,282,41362,249,50718,California
Nevada,2021-05-18,436,90942,262,47711,170,41183,4,2048,221,9370,211,41573,225,50943,California
Nevada,2021-05-19,508,91450,357,48068,146,41329,5,2053,257,9392,240,41813,262,51205,California
Nevada,2021-05-20,628,92078,367,48435,248,41577,13,2066,217,9216,406,42219,230,51435,California
Nevada,2021-05-21,525,92603,341,48776,174,41751,10,2076,219,9144,301,42520,229,51664,California
Nevada,2021-05-22,257,92860,39,48815,165,41916,53,2129,81,9104,174,42694,134,51798,California
Nevada,2021-05-23,53,92913,16,48831,37,41953,0,2129,17,9086,35,42729,17,51815,California
Nevada,2021-05-24,324,93237,224,49055,83,42036,17,2146,107,8997,213,42942,124,51939,California
Nevada,2021-05-25,349,93586,83,49138,252,42288,14,2160,81,8833,259,43201,95,52034,California
Nevada,2021-05-26,454,94040,199,49337,244,42532,11,2171,134,8664,313,43514,144,52178,California
Nevada,2021-05-27,447,94487,236,49573,198,42730,13,2184,187,8610,254,43768,200,52378,California
Nevada,2021-05-28,364,94851,222,49795,126,42856,16,2200,202,8670,159,43927,219,52597,California
Nevada,2021-05-29,68,94919,13,49808,55,42911,0,2200,40,8682,28,43955,40,52637,California
Nevada,2021-05-30,43,94962,19,49827,22,42933,2,2202,29,8699,14,43969,31,52668,California
Nevada,2021-05-31,6,94968,4,49831,0,42933,2,2204,2,8699,4,43973,4,52672,California
Nevada,2021-06-01,424,95392,128,49959,276,43209,20,2224,99,8503,315,44288,119,52791,California
Nevada,2021-06-02,403,95795,165,50124,231,43440,7,2231,102,8318,294,44582,109,52900,California
Nevada,2021-06-03,571,96366,408,50532,158,43598,5,2236,100,7956,467,45049,105,53005,California
Nevada,2021-06-04,544,96910,433,50965,107,43705,4,2240,110,7640,430,45479,114,53119,California
Nevada,2021-06-05,173,97083,72,51037,99,43804,2,2242,67,7604,105,45584,69,53188,California
Nevada,2021-06-06,57,97140,41,51078,16,43820,0,2242,15,7577,42,45626,15,53203,California
Nevada,2021-06-07,272,97412,196,51274,45,43865,31,2273,60,7460,208,45834,91,53294,California
Nevada,2021-06-08,288,97700,190,51464,86,43951,12,2285,66,7325,213,46047,78,53372,California
Nevada,2021-06-09,325,98025,217,51681,101,44052,7,2292,79,7169,242,46289,86,53458,California
Nevada,2021-06-10,279,98304,179,51860,90,44142,10,2302,72,7049,201,46490,81,53539,California
Nevada,2021-06-11,326,98630,232,52092,75,44217,19,2321,73,6890,250,46740,91,53630,California
Nevada,2021-06-12,94,98724,54,52146,35,44252,5,2326,29,6859,65,46805,34,53664,California
Nevada,2021-06-13,33,98757,16,52162,16,44268,1,2327,6,6839,27,46832,7,53671,California
Nevada,2021-06-14,193,98950,137,52299,45,44313,11,2338,52,6768,134,46966,63,53734,California
Nevada,2021-06-15,170,99120,95,52394,67,44380,8,2346,64,6737,103,47069,72,53806,California
Nevada,2021-06-16,244,99364,136,52530,99,44479,9,2355,72,6653,165,47234,81,53887,California
Nevada,2021-06-17,229,99593,136,52666,81,44560,12,2367,45,6527,183,47417,57,53944,California
Nevada,2021-06-18,229,99822,155,52821,56,44616,18,2385,74,6467,153,47570,93,54037,California
Nevada,2021-06-19,70,99892,33,52854,31,44647,6,2391,29,6461,41,47611,35,54072,California
Nevada,2021-06-20,29,99921,21,52875,7,44654,1,2392,9,6452,19,47630,10,54082,California
Nevada,2021-06-21,109,100030,49,52924,53,44707,7,2399,48,6453,54,47684,55,54137,California
Nevada,2021-06-22,170,100200,98,53022,60,44767,12,2411,69,6440,94,47778,81,54218,California
Nevada,2021-06-23,212,100412,139,53161,45,44812,28,2439,88,6436,119,47897,115,54333,California
Nevada,2021-06-24,178,100590,111,53272,48,44860,19,2458,59,6401,113,48010,78,54411,California
Nevada,2021-06-25,204,100794,136,53408,46,44906,22,2480,72,6364,131,48141,94,54505,California
Nevada,2021-06-26,88,100882,67,53475,18,44924,3,2483,36,6351,52,48193,39,54544,California
Nevada,2021-06-27,33,100915,15,53490,14,44938,4,2487,8,6338,25,48218,12,54556,California
Nevada,2021-06-28,168,101083,120,53610,28,44966,20,2507,68,6334,92,48310,88,54644,California
Nevada,2021-06-29,137,101220,79,53689,46,45012,12,2519,53,6323,76,48386,65,54709,California
Nevada,2021-06-30,177,101397,130,53819,41,45053,6,2525,57,6268,117,48503,62,54771,California
Nevada,2021-07-01,123,101520,82,53901,29,45082,12,2537,51,6261,70,48573,63,54834,California
Nevada,2021-07-02,150,101670,97,53998,39,45121,14,2551,74,6281,68,48641,88,54922,California
Nevada,2021-07-03,33,101703,15,54013,11,45132,7,2558,16,6287,17,48658,23,54945,California
Nevada,2021-07-05,43,101746,26,54039,11,45143,6,2564,15,6280,28,48686,21,54966,California
Nevada,2021-07-06,153,101899,91,54130,45,45188,17,2581,56,6263,90,48776,73,55039,California
Nevada,2021-07-07,139,102038,93,54223,33,45221,13,2594,45,6236,85,48861,58,55097,California
Nevada,2021-07-08,149,102187,89,54312,45,45266,15,2609,73,6252,71,48932,87,55184,California
Nevada,2021-07-09,140,102327,79,54391,44,45310,17,2626,51,6232,88,49020,68,55252,California
Nevada,2021-07-10,42,102369,31,54422,7,45317,4,2630,20,6233,22,49042,23,55275,California
Nevada,2021-07-11,18,102387,11,54433,7,45324,0,2630,9,6233,9,49051,9,55284,California
Nevada,2021-07-12,87,102474,46,54479,35,45359,6,2636,53,6262,30,49081,59,55343,California
Nevada,2021-07-13,153,102627,113,54592,31,45390,9,2645,60,6244,87,49168,69,55412,California
Nevada,2021-07-14,157,102784,102,54694,38,45428,17,2662,66,6243,84,49252,83,55495,California
Nevada,2021-07-15,128,102912,95,54789,26,45454,7,2669,58,6243,64,49316,64,55559,California
Nevada,2021-07-16,129,103041,80,54869,45,45499,4,2673,58,6235,70,49386,62,55621,California
Nevada,2021-07-17,53,103094,38,54907,11,45510,4,2677,25,6240,28,49414,33,55654,California
Nevada,2021-07-18,31,103125,14,54921,15,45525,2,2679,18,6247,13,49427,20,55674,California
Nevada,2021-07-19,111,103236,73,54994,30,45555,8,2687,54,6256,53,49480,62,55736,California
Nevada,2021-07-20,151,103387,98,55092,44,45599,9,2696,85,6287,64,49544,95,55831,California
Nevada,2021-07-21,133,103520,93,55185,37,45636,3,2699,75,6315,50,49594,78,55909,California
Nevada,2021-07-22,193,103713,134,55319,46,45682,13,2712,106,6352,82,49676,119,56028,California
Nevada,2021-07-23,202,103915,136,55455,50,45732,16,2728,101,6371,98,49774,117,56145,California
Nevada,2021-07-24,61,103976,36,55491,21,45753,4,2732,38,6390,23,49797,42,56187,California
Nevada,2021-07-25,17,103993,9,55500,7,45760,1,2733,13,6400,4,49801,14,56201,California
Nevada,2021-07-26,127,104120,72,55572,46,45806,9,2742,75,6436,48,49849,84,56285,California
Nevada,2021-07-27,157,104277,103,55675,37,45843,17,2759,73,6447,79,49928,90,56375,California
Nevada,2021-07-28,138,104415,86,55761,46,45889,6,2765,82,6485,50,49978,88,56463,California
Nevada,2021-07-29,140,104555,92,55853,40,45929,8,2773,75,6508,60,50038,83,56546,California
Nevada,2021-07-30,192,104747,118,55971,61,45990,13,2786,129,6590,60,50098,142,56688,California
Nevada,2021-07-31,79,104826,46,56017,23,46013,10,2796,46,6612,33,50131,55,56743,California
Nevada,2021-08-01,37,104863,19,56036,18,46031,0,2796,31,6637,6,50137,31,56774,California
Nevada,2021-08-02,162,105025,101,56137,50,46081,11,2807,101,6689,60,50197,112,56886,California
Nevada,2021-08-03,185,105210,119,56256,49,46130,17,2824,120,6761,65,50262,137,57023,California
Nevada,2021-08-04,177,105387,116,56372,51,46181,10,2834,121,6839,53,50315,131,57154,California
Nevada,2021-08-05,149,105536,101,56473,35,46216,13,2847,79,6862,68,50383,91,57245,California
Nevada,2021-08-06,193,105729,119,56592,59,46275,15,2862,121,6930,68,50451,136,57381,California
Nevada,2021-08-07,78,105807,38,56630,35,46310,5,2867,56,6969,22,50473,61,57442,California
Nevada,2021-08-08,34,105841,19,56649,15,46325,0,2867,25,6985,9,50482,25,57467,California
Nevada,2021-08-09,164,106005,86,56735,56,46381,22,2889,94,7036,65,50547,116,57583,California
Nevada,2021-08-10,215,106220,143,56878,46,46427,26,2915,125,7099,88,50635,151,57734,California
Nevada,2021-08-11,158,106378,91,56969,61,46488,6,2921,109,7166,48,50683,115,57849,California
Nevada,2021-08-12,140,106518,93,57062,41,46529,6,2927,84,7203,53,50736,90,57939,California
Nevada,2021-08-13,196,106714,112,57174,71,46600,13,2940,132,7291,57,50793,145,58084,California
Nevada,2021-08-14,128,106842,62,57236,49,46649,17,2957,66,7325,48,50841,82,58166,California
Nevada,2021-08-15,72,106914,34,57270,35,46684,3,2960,46,7357,17,50858,49,58215,California
Nevada,2021-08-16,214,107128,128,57398,69,46753,17,2977,101,7376,99,50957,118,58333,California
Nevada,2021-08-17,192,107320,111,57509,62,46815,19,2996,82,7401,75,51032,100,58433,California
Nevada,2021-08-18,258,107578,148,57657,96,46911,14,3010,131,7451,95,51127,145,58578,California
Nevada,2021-08-19,239,107817,162,57819,70,46981,7,3017,123,7495,86,51213,130,58708,California
Nevada,2021-08-20,281,108098,149,57968,112,47093,20,3037,131,7530,116,51329,151,58859,California
Nevada,2021-08-21,164,108262,108,58076,50,47143,6,3043,89,7572,53,51382,95,58954,California
Nevada,2021-08-22,61,108323,34,58110,27,47170,0,3043,29,7582,19,51401,29,58983,California
Nevada,2021-08-23,250,108573,162,58272,73,47243,15,3058,108,7604,101,51502,123,59106,California
Nevada,2021-08-24,241,108814,161,58433,68,47311,12,3070,102,7620,98,51600,114,59220,California
Nevada,2021-08-25,208,109022,127,58560,68,47379,13,3083,96,7648,81,51681,109,59329,California
Nevada,2021-08-26,230,109252,146,58706,73,47452,11,3094,99,7658,100,51781,110,59439,California
Nevada,2021-08-27,239,109491,153,58859,77,47529,9,3103,99,7662,104,51885,108,59547,California
Nevada,2021-08-28,95,109586,58,58917,34,47563,3,3106,40,7661,44,51929,43,59590,California
Nevada,2021-08-29,64,109650,33,58950,30,47593,1,3107,30,7668,24,51953,31,59621,California
Nevada,2021-08-30,131,109781,77,59027,40,47633,14,3121,39,7648,73,52026,53,59674,California
Orange,2020-12-15,18,18,18,18,0,0,0,0,18,18,0,0,18,18,California
Orange,2020-12-16,409,427,409,427,0,0,0,0,409,427,0,0,409,427,California
Orange,2020-12-17,3844,4271,3844,4271,0,0,0,0,3843,4270,0,0,3843,4270,California
Orange,2020-12-18,5218,9489,5209,9480,9,9,0,0,5212,9481,1,1,5212,9482,California
Orange,2020-12-19,2256,11745,2251,11731,5,14,0,0,2255,11736,0,1,2255,11737,California
Orange,2020-12-20,2008,13753,2005,13736,3,17,0,0,2007,13742,1,2,2007,13744,California
Orange,2020-12-21,4358,18111,4352,18088,6,23,0,0,4358,18100,0,2,4358,18102,California
Orange,2020-12-22,4021,22132,3983,22071,38,61,0,0,4019,22119,0,2,4019,22121,California
Orange,2020-12-23,3628,25760,3257,25328,371,432,0,0,3627,25745,1,3,3627,25748,California
Orange,2020-12-24,1411,27171,1096,26424,315,747,0,0,1410,27154,1,4,1410,27158,California
Orange,2020-12-25,22,27193,17,26441,5,752,0,0,22,27176,0,4,22,27180,California
Orange,2020-12-26,1009,28202,426,26867,583,1335,0,0,1009,28185,0,4,1009,28189,California
Orange,2020-12-27,590,28792,274,27141,316,1651,0,0,590,28775,0,4,590,28779,California
Orange,2020-12-28,3667,32459,2658,29799,1009,2660,0,0,3667,32442,0,4,3667,32446,California
Orange,2020-12-29,3577,36036,2539,32338,1038,3698,0,0,3576,36017,1,5,3576,36022,California
Orange,2020-12-30,5179,41215,3565,35903,1614,5312,0,0,5179,41196,0,5,5179,41201,California
Orange,2020-12-31,1545,42760,822,36725,723,6035,0,0,1542,42735,3,8,1542,42743,California
Orange,2021-01-01,833,43593,464,37189,369,6404,0,0,831,43564,2,10,831,43574,California
Orange,2021-01-02,1387,44980,849,38038,538,6942,0,0,1384,44946,2,12,1384,44958,California
Orange,2021-01-03,598,45578,329,38367,269,7211,0,0,597,45543,0,12,597,45555,California
Orange,2021-01-04,2819,48397,1590,39957,1229,8440,0,0,2821,48363,1,13,2821,48376,California
Orange,2021-01-05,3622,52019,2364,42321,1258,9698,0,0,3179,51110,435,448,3182,51558,California
Orange,2021-01-06,5128,57147,3524,45845,1604,11302,0,0,3712,53422,1400,1848,3712,55270,California
Orange,2021-01-07,9526,66673,5350,51195,4176,15478,0,0,5771,55464,3737,5585,5779,61049,California
Orange,2021-01-08,9740,76413,5523,56718,4217,19695,0,0,5732,57212,3988,9573,5736,66785,California
Orange,2021-01-09,5127,81540,1806,58524,3321,23016,0,0,3804,59699,1318,10891,3805,70590,California
Orange,2021-01-10,4327,85867,1067,59591,3260,26276,0,0,3431,62239,895,11786,3435,74025,California
Orange,2021-01-11,9696,95563,5045,64636,4651,30927,0,0,5966,64479,3730,15516,5970,79995,California
Orange,2021-01-12,9160,104723,4931,69567,4229,35156,0,0,5595,66517,3560,19076,5598,85593,California
Orange,2021-01-13,10437,115160,4995,74562,5442,40598,0,0,7191,70472,3242,22318,7197,92790,California
Orange,2021-01-14,10264,125424,3873,78435,6391,46989,0,0,8628,77473,1633,23951,8634,101424,California
Orange,2021-01-15,10474,135898,2748,81183,7726,54715,0,0,9544,86092,931,24882,9550,110974,California
Orange,2021-01-16,8886,144784,2123,83306,6763,61478,0,0,8474,94165,408,25290,8481,119455,California
Orange,2021-01-17,8305,153089,1531,84837,6774,68252,0,0,8139,102149,166,25456,8150,127605,California
Orange,2021-01-18,9834,162923,4471,89308,5363,73615,0,0,7532,107383,2301,27757,7535,135140,California
Orange,2021-01-19,7698,170621,5522,94830,2176,75791,0,0,5012,109712,2685,30442,5014,140154,California
Orange,2021-01-20,8820,179441,6174,101004,2646,78437,0,0,5696,112298,3121,33563,5707,145861,California
Orange,2021-01-21,11500,190941,5173,106177,6327,84764,0,0,10610,122034,886,34449,10622,156483,California
Orange,2021-01-22,14098,205039,5285,111462,8813,93577,0,0,13170,134293,919,35368,13178,169661,California
Orange,2021-01-23,13360,218399,6238,117700,7122,100699,0,0,12399,145749,956,36324,12412,182073,California
Orange,2021-01-24,10027,228426,4317,122017,5710,106409,0,0,9672,155077,350,36674,9678,191751,California
Orange,2021-01-25,10621,239047,5941,127958,4680,111089,0,0,7840,160150,2772,39446,7845,199596,California
Orange,2021-01-26,12095,251142,7737,135695,4358,115447,0,0,9860,167784,2229,41675,9863,209459,California
Orange,2021-01-27,13736,264878,8057,143752,5679,121126,0,0,10926,175918,2800,44475,10934,220393,California
Orange,2021-01-28,13390,278268,7314,151066,6076,127202,0,0,11409,185373,1964,46439,11419,231812,California
Orange,2021-01-29,13908,292176,8504,159570,5404,132606,0,0,10912,193317,2973,49412,10917,242729,California
Orange,2021-01-30,13290,305466,4517,164087,8773,141379,0,0,12466,204983,805,50217,12471,255200,California
Orange,2021-01-31,13911,319377,4939,169026,8972,150351,0,0,13433,217953,471,50688,13441,268641,California
Orange,2021-02-01,15221,334598,6595,175621,8626,158977,0,0,12621,228015,2569,53257,12631,281272,California
Orange,2021-02-02,15338,349936,8061,183682,7277,166254,0,0,12781,238287,2516,55773,12788,294060,California
Orange,2021-02-03,16952,366888,12528,196210,4424,170678,0,0,13871,249174,2990,58763,13877,307937,California
Orange,2021-02-04,20283,387171,13164,209374,7119,177797,0,0,15027,258999,5214,63977,15039,322976,California
Orange,2021-02-05,21173,408344,12134,221508,9039,186836,0,0,14690,267269,6432,70409,14702,337678,California
Orange,2021-02-06,16661,425005,10920,232428,5741,192577,0,0,11289,273434,5346,75755,11511,349189,California
Orange,2021-02-07,11704,436709,8194,240622,3510,196087,0,0,7635,277189,4051,79806,7806,356995,California
Orange,2021-02-08,15399,452108,8796,249418,6603,202690,0,0,9184,280193,6185,85991,9189,366184,California
Orange,2021-02-09,18145,470253,12269,261687,5876,208566,0,0,10860,283874,7204,93195,10885,377069,California
Orange,2021-02-10,21317,491570,11372,273059,9945,218511,0,0,12905,288493,8312,101507,12931,390000,California
Orange,2021-02-11,22681,514251,11743,284802,10938,229449,0,0,12365,290720,10166,111673,12393,402393,California
Orange,2021-02-12,25439,539690,12211,297013,13228,242677,0,0,14855,295100,10503,122176,14883,417276,California
Orange,2021-02-13,22415,562105,12079,309092,10336,253013,0,0,11309,296132,10937,133113,11969,429245,California
Orange,2021-02-14,16836,578941,6717,315809,10119,263132,0,0,9851,299047,6949,140062,9864,439109,California
Orange,2021-02-15,17775,596716,7608,323417,10167,273299,0,0,9220,299795,8502,148564,9250,448359,California
Orange,2021-02-16,20558,617274,9242,332659,11316,284615,0,0,11086,301526,9409,157973,11140,459499,California
Orange,2021-02-17,18519,635793,9697,342356,8822,293437,0,0,9445,302044,8995,166968,9513,469012,California
Orange,2021-02-18,15467,651260,10121,352477,5346,298783,0,0,6945,300561,8460,175428,6977,475989,California
Orange,2021-02-19,18876,670136,11250,363727,7626,306409,0,0,7177,296144,11620,187048,7203,483192,California
Orange,2021-02-20,7878,678014,5826,369553,2052,308461,0,0,3950,296237,3888,190936,3981,487173,California
Orange,2021-02-21,4894,682908,4153,373706,741,309202,0,0,999,293394,3851,194787,1008,488181,California
Orange,2021-02-22,10570,693478,8609,382315,1961,311163,0,0,4193,291306,6311,201098,4223,492404,California
Orange,2021-02-23,14450,707928,7901,390216,6549,317712,0,0,3795,284591,10559,211657,3844,496248,California
Orange,2021-02-24,22542,730470,13584,403800,8958,326670,0,0,5672,273585,16754,228411,5748,501996,California
Orange,2021-02-25,24496,754966,13218,417018,11278,337948,0,0,8535,266330,15849,244260,8594,510590,California
Orange,2021-02-26,29705,784671,14999,432017,14706,352654,0,0,11962,260804,17558,261818,12032,522622,California
Orange,2021-02-27,26939,811610,10953,442970,15980,368634,6,6,7850,249783,18942,280760,7921,530543,California
Orange,2021-02-28,20444,832054,7949,450919,12495,381129,0,6,5191,239927,15095,295855,5239,535782,California
Orange,2021-03-01,20172,852226,9254,460173,10887,392016,31,37,7905,235799,12111,307966,7983,543765,California
Orange,2021-03-02,22470,874696,10927,471100,11539,403555,4,41,10005,233504,12375,320341,10080,553845,California
Orange,2021-03-03,22275,896971,10603,481703,11665,415220,7,48,11973,235346,10204,330545,12046,565891,California
Orange,2021-03-04,24888,921859,14253,495956,10622,425842,13,61,12662,235936,12162,342707,12752,578643,California
Orange,2021-03-05,24403,946262,12878,508834,11475,437317,50,111,14593,240939,9747,352454,14750,593393,California
Orange,2021-03-06,25844,972106,14265,523099,10675,447992,904,1015,13602,243309,12176,364630,14546,607939,California
Orange,2021-03-07,16847,988953,9058,532157,6903,454895,886,1901,9696,246843,7097,371727,10631,618570,California
Orange,2021-03-08,18986,1007939,8814,540971,8707,463602,1465,3366,11922,253282,6993,378720,13432,632002,California
Orange,2021-03-09,22246,1030185,10176,551147,9404,473006,2666,6032,13030,259806,9160,387880,15684,647686,California
Orange,2021-03-10,25538,1055723,12522,563669,9483,482489,3533,9565,12795,263468,12650,400530,16312,663998,California
Orange,2021-03-11,29942,1085665,16195,579864,9381,491870,4366,13931,13729,265459,16084,416614,18075,682073,California
Orange,2021-03-12,29988,1115653,14565,594429,11485,503355,3938,17869,14918,269360,14945,431559,18846,700919,California
Orange,2021-03-13,28342,1143995,10399,604828,13934,517289,4009,21878,14250,273569,14013,445572,18222,719141,California
Orange,2021-03-14,19320,1163315,8368,613196,8377,525666,2575,24453,11963,280774,7310,452882,14515,733656,California
Orange,2021-03-15,23692,1187007,10413,623609,12505,538171,774,25227,14536,287051,9043,461925,15320,748976,California
Orange,2021-03-16,27005,1214012,11429,635038,15290,553461,286,25513,17254,294984,9640,471565,17573,766549,California
Orange,2021-03-17,27949,1241961,13890,648928,13496,566957,563,26076,19757,307216,8087,479652,20319,786868,California
Orange,2021-03-18,28443,1270404,14386,663314,13743,580700,314,26390,21816,322829,6533,486185,22146,809014,California
Orange,2021-03-19,34538,1304942,19112,682426,14958,595658,468,26858,25387,339676,9013,495198,25860,834874,California
Orange,2021-03-20,26324,1331266,13938,696364,12178,607836,208,27066,22251,358167,3983,499181,22474,857348,California
Orange,2021-03-21,19254,1350520,11010,707374,7495,615331,749,27815,16195,372105,3001,502182,16939,874287,California
Orange,2021-03-22,23256,1373776,12109,719483,10819,626150,328,28143,19344,388015,3772,505954,19682,893969,California
Orange,2021-03-23,26666,1400442,13963,733446,12052,638202,651,28794,20888,403895,5665,511619,21545,915514,California
Orange,2021-03-24,29775,1430217,16685,750131,12155,650357,935,29729,22092,419362,7557,519176,23024,938538,California
Orange,2021-03-25,33115,1463332,17620,767751,14774,665131,721,30450,24229,435561,8757,527933,24956,963494,California
Orange,2021-03-26,35549,1498881,18450,786201,16221,681352,878,31328,24609,450272,10788,538721,25499,988993,California
Orange,2021-03-27,28998,1527879,13875,800076,14801,696153,322,31650,19629,460975,9251,547972,19954,1008947,California
Orange,2021-03-28,25307,1553186,13129,813205,12110,708263,68,31718,18613,473081,6585,554557,18691,1027638,California
Orange,2021-03-29,27092,1580278,12446,825651,14076,722339,570,32288,17723,482153,9228,563785,18300,1045938,California
Orange,2021-03-30,31426,1611704,14247,839898,16538,738877,641,32929,20418,492323,10893,574678,21063,1067001,California
Orange,2021-03-31,37786,1649490,19783,859681,17268,756145,735,33664,23634,502705,13982,588660,24364,1091365,California
Orange,2021-04-01,41434,1690924,21698,881379,17755,773900,1981,35645,25900,515289,15262,603922,27846,1119211,California
Orange,2021-04-02,40747,1731671,20532,901911,18335,792235,1880,37525,21928,520434,18663,622585,23808,1143019,California
Orange,2021-04-03,30783,1762454,15960,917871,13030,805265,1793,39318,14137,519815,16531,639116,15912,1158931,California
Orange,2021-04-04,18671,1781125,10822,928693,7071,812336,778,40096,7932,517861,10657,649773,8703,1167634,California
Orange,2021-04-05,30600,1811725,14284,942977,12824,825160,3492,43588,13176,517199,17307,667080,16645,1184279,California
Orange,2021-04-06,33886,1845611,15855,958832,14546,839706,3485,47073,14116,515118,19644,686724,17563,1201842,California
Orange,2021-04-07,36804,1882415,20441,979273,11674,851380,4689,51762,16082,515247,20593,707317,20722,1222564,California
Orange,2021-04-08,39754,1922169,21959,1001232,12187,863567,5608,57370,19051,519301,20542,727859,24596,1247160,California
Orange,2021-04-09,41625,1963794,24180,1025412,12096,875663,5349,62719,17994,519089,23493,751352,23281,1270441,California
Orange,2021-04-10,35002,1998796,18456,1043868,12221,887884,4325,67044,14285,517064,20599,771951,18574,1289015,California
Orange,2021-04-11,25992,2024788,14710,1058578,7975,895859,3307,70351,9899,514227,16013,787964,13176,1302191,California
Orange,2021-04-12,31077,2055865,15666,1074244,11743,907602,3668,74019,12155,511211,18805,806769,15789,1317980,California
Orange,2021-04-13,33135,2089000,18607,1092851,14455,922057,73,74092,15294,508862,17722,824491,15373,1333353,California
Orange,2021-04-14,35348,2124348,20673,1113524,14637,936694,38,74130,15272,504251,19935,844426,15324,1348677,California
Orange,2021-04-15,41079,2165427,25015,1138539,16041,952735,23,74153,18941,501245,21965,866391,18959,1367636,California
Orange,2021-04-16,42384,2207811,24883,1163422,17472,970207,29,74182,18936,496953,23272,889663,18980,1386616,California
Orange,2021-04-17,30978,2238789,17479,1180901,13491,983698,8,74190,13445,493042,17370,907033,13459,1400075,California
Orange,2021-04-18,22730,2261519,13699,1194600,9029,992727,2,74192,8871,488163,13757,920790,8878,1408953,California
Orange,2021-04-19,33167,2294686,18309,1212909,14853,1007580,5,74197,15102,485346,17933,938723,15116,1424069,California
Orange,2021-04-20,36429,2331115,19108,1232017,17314,1024894,7,74204,17813,484690,18483,957206,17827,1441896,California
Orange,2021-04-21,42928,2374043,25096,1257113,17822,1042716,10,74214,20223,482438,22495,979701,20243,1462139,California
Orange,2021-04-22,40913,2414956,21863,1278976,19038,1061754,12,74226,16861,475463,23859,1003560,16884,1479023,California
Orange,2021-04-23,41717,2456673,21888,1300864,19821,1081575,8,74234,18564,471064,22986,1026546,18587,1497610,California
Orange,2021-04-24,32958,2489631,17126,1317990,15798,1097373,34,74268,13697,465674,19124,1045670,13734,1511344,California
Orange,2021-04-25,23456,2513087,13200,1331190,10241,1107614,15,74283,9956,462259,13396,1059066,9981,1521325,California
Orange,2021-04-26,29802,2542889,14778,1345968,14822,1122436,202,74485,12824,458472,16819,1075885,13032,1534357,California
Orange,2021-04-27,32033,2574922,15163,1361131,16224,1138660,646,75131,12060,451419,19766,1095651,12713,1547070,California
Orange,2021-04-28,32080,2607002,16230,1377361,14950,1153610,900,76031,12811,446044,19083,1114734,13708,1560778,California
Orange,2021-04-29,33178,2640180,18249,1395610,13940,1167550,989,77020,11737,437503,21262,1135996,12721,1573499,California
Orange,2021-04-30,30970,2671150,17794,1413404,12221,1179771,955,77975,13147,433952,17644,1153640,14093,1587592,California
Orange,2021-05-01,23711,2694861,16087,1429491,6616,1186387,1008,78983,9100,429637,14410,1168050,10095,1597687,California
Orange,2021-05-02,15650,2710511,10448,1439939,4553,1190940,649,79632,5458,425640,10099,1178149,6102,1603789,California
Orange,2021-05-03,21117,2731628,12948,1452887,7393,1198333,776,80408,6569,418561,14422,1192571,7343,1611132,California
Orange,2021-05-04,24477,2756105,14153,1467040,9395,1207728,929,81337,8335,411836,15975,1208546,9250,1620382,California
Orange,2021-05-05,25804,2781909,14648,1481688,10247,1217975,909,82246,8279,403661,17362,1225908,9187,1629569,California
Orange,2021-05-06,27359,2809268,16691,1498379,9654,1227629,1014,83260,7467,392413,19714,1245622,8466,1638035,California
Orange,2021-05-07,29821,2839089,18081,1516460,10672,1238301,1068,84328,8251,380416,21308,1266930,9311,1647346,California
Orange,2021-05-08,19472,2858561,13003,1529463,5658,1243959,811,85139,5653,373190,13680,1280610,6454,1653800,California
Orange,2021-05-09,11251,2869812,8582,1538045,2290,1246249,379,85518,2814,368002,8377,1288987,3189,1656989,California
Orange,2021-05-10,19797,2889609,12222,1550267,6779,1253028,796,86314,4362,357853,15302,1304289,5153,1662142,California
Orange,2021-05-11,23469,2913078,13396,1563663,9323,1262351,750,87064,5478,346225,17848,1322137,6220,1668362,California
Orange,2021-05-12,24444,2937522,15172,1578835,8429,1270780,843,87907,6596,335981,17681,1339818,7437,1675799,California
Orange,2021-05-13,22456,2959978,13909,1592744,7927,1278707,620,88527,8250,330788,14062,1353880,8869,1684668,California
Orange,2021-05-14,27274,2987252,18005,1610749,8405,1287112,864,89391,10575,325674,16518,1370398,11404,1696072,California
Orange,2021-05-15,20848,3008100,14990,1625739,5289,1292401,569,89960,8434,322353,12314,1382712,8993,1705065,California
Orange,2021-05-16,15718,3023818,12960,1638699,2414,1294815,344,90304,6740,320528,8905,1391617,7080,1712145,California
Orange,2021-05-17,19796,3043614,12997,1651696,6087,1300902,712,91016,6921,315378,12768,1404385,7618,1719763,California
Orange,2021-05-18,20866,3064480,12113,1663809,8073,1308975,680,91696,8044,311389,12704,1417089,8715,1728478,California
Orange,2021-05-19,22905,3087385,13063,1676872,9153,1318128,689,92385,7786,304889,14962,1432051,8462,1736940,California
Orange,2021-05-20,23022,3110407,13484,1690356,8849,1326977,689,93074,7854,298403,15032,1447083,8546,1745486,California
Orange,2021-05-21,26377,3136784,15212,1705568,10432,1337409,733,93807,8388,289694,17831,1464914,9122,1754608,California
Orange,2021-05-22,18622,3155406,12390,1717958,5679,1343088,553,94360,7039,285810,11475,1476389,7591,1762199,California
Orange,2021-05-23,10153,3165559,7028,1724986,2851,1345939,274,94634,3536,283066,6557,1482946,3813,1766012,California
Orange,2021-05-24,15908,3181467,9441,1734427,5835,1351774,632,95266,5856,279613,9936,1492882,6483,1772495,California
Orange,2021-05-25,15912,3197379,9346,1743773,6032,1357806,534,95800,5610,275585,10163,1503045,6135,1778630,California
Orange,2021-05-26,15491,3212870,8656,1752429,6330,1364136,505,96305,5659,272017,9723,1512768,6155,1784785,California
Orange,2021-05-27,14648,3227518,8807,1761236,5285,1369421,556,96861,6374,270766,8174,1520942,6923,1791708,California
Orange,2021-05-28,17152,3244670,10087,1771323,6428,1375849,637,97498,7504,269372,9528,1530470,8134,1799842,California
Orange,2021-05-29,9167,3253837,5338,1776661,3466,1379315,363,97861,4082,268803,5012,1535482,4443,1804285,California
Orange,2021-05-30,6093,3259930,3961,1780622,1850,1381165,282,98143,2183,267396,3865,1539347,2458,1806743,California
Orange,2021-05-31,1743,3261673,1080,1781702,613,1381778,50,98193,529,266790,1182,1540529,576,1807319,California
Orange,2021-06-01,13710,3275383,7942,1789644,5266,1387044,502,98695,5072,263883,8475,1549004,5568,1812887,California
Orange,2021-06-02,13337,3288720,8225,1797869,4684,1391728,428,99123,4529,260197,8637,1557641,4951,1817838,California
Orange,2021-06-03,13159,3301879,9055,1806924,3639,1395367,465,99588,4465,256506,8617,1566258,4926,1822764,California
Orange,2021-06-04,17491,3319370,12365,1819289,4541,1399908,585,100173,5327,250353,12063,1578321,5910,1828674,California
Orange,2021-06-05,13175,3332545,9928,1829217,2865,1402773,382,100555,3867,245364,9235,1587556,4246,1832920,California
Orange,2021-06-06,5422,3337967,4605,1833822,614,1403387,203,100758,1816,243810,3577,1591133,2023,1834943,California
Orange,2021-06-07,10946,3348913,7732,1841554,2739,1406126,475,101233,3391,240201,7469,1598602,3860,1838803,California
Orange,2021-06-08,12370,3361283,8857,1850411,2992,1409118,521,101754,3780,236014,8488,1607090,4301,1843104,California
Orange,2021-06-09,11923,3373206,8249,1858660,3213,1412331,461,102215,3350,231337,8482,1615572,3805,1846909,California
Orange,2021-06-10,11773,3384979,8558,1867218,2741,1415072,474,102689,3420,226946,8279,1623851,3888,1850797,California
Orange,2021-06-11,13606,3398585,9565,1876783,3541,1418613,500,103189,4405,222762,9086,1632937,4902,1855699,California
Orange,2021-06-12,9949,3408534,7586,1884369,2045,1420658,318,103507,2986,219172,6897,1639834,3307,1859006,California
Orange,2021-06-13,4117,3412651,3009,1887378,941,1421599,167,103674,1037,217335,3042,1642876,1205,1860211,California
Orange,2021-06-14,9976,3422627,7271,1894649,2236,1423835,469,104143,3283,214463,6623,1649499,3751,1863962,California
Orange,2021-06-15,10466,3433093,7534,1902183,2494,1426329,438,104581,3642,211804,6736,1656235,4077,1868039,California
Orange,2021-06-16,9773,3442866,7006,1909189,2287,1428616,480,105061,3355,209285,6349,1662584,3830,1871869,California
Orange,2021-06-17,9567,3452433,7198,1916387,1989,1430605,380,105441,3368,206904,6126,1668710,3745,1875614,California
Orange,2021-06-18,11361,3463794,8265,1924652,2592,1433197,504,105945,3891,203908,7384,1676094,4388,1880002,California
Orange,2021-06-19,6391,3470185,4741,1929393,1401,1434598,249,106194,2619,203064,3716,1679810,2872,1882874,California
Orange,2021-06-20,3097,3473282,2393,1931786,608,1435206,96,106290,1033,202144,2049,1681859,1129,1884003,California
Orange,2021-06-21,6819,3480101,4688,1936474,1677,1436883,454,106744,3650,203115,3134,1684993,4105,1888108,California
Orange,2021-06-22,7853,3487954,5798,1942272,1691,1438574,364,107108,2970,201647,4803,1689796,3335,1891443,California
Orange,2021-06-23,7552,3495506,5675,1947947,1563,1440137,314,107422,3046,200551,4450,1694246,3354,1894797,California
Orange,2021-06-24,7356,3502862,5505,1953452,1463,1441600,388,107810,3110,199846,4199,1698445,3494,1898291,California
Orange,2021-06-25,9003,3511865,6597,1960049,2020,1443620,386,108196,3457,198196,5487,1703932,3837,1902128,California
Orange,2021-06-26,6074,3517939,4651,1964700,1193,1444813,230,108426,2564,197528,3463,1707395,2795,1904923,California
Orange,2021-06-27,3495,3521434,2832,1967532,552,1445365,111,108537,1494,197164,1973,1709368,1609,1906532,California
Orange,2021-06-28,6489,3527923,5217,1972749,913,1446278,359,108896,2897,196889,3533,1712901,3258,1909790,California
Orange,2021-06-29,6443,3534366,4725,1977474,1458,1447736,260,109156,2650,196065,3735,1716636,2911,1912701,California
Orange,2021-06-30,6371,3540737,4602,1982076,1500,1449236,269,109425,2815,195676,3472,1720108,3083,1915784,California
Orange,2021-07-01,6165,3546902,4711,1986787,1201,1450437,253,109678,2831,195493,3267,1723375,3084,1918868,California
Orange,2021-07-02,7343,3554245,5463,1992250,1542,1451979,338,110016,3189,194900,4114,1727489,3521,1922389,California
Orange,2021-07-03,4143,3558388,3049,1995299,953,1452932,141,110157,1893,194719,2211,1729700,2030,1924419,California
Orange,2021-07-04,349,3558737,226,1995525,109,1453041,14,110171,150,194690,194,1729894,165,1924584,California
Orange,2021-07-05,3910,3562647,2991,1998516,782,1453823,137,110308,1853,194657,2025,1731919,1992,1926576,California
Orange,2021-07-06,6918,3569565,5127,2003643,1464,1455287,327,110635,2671,193472,4179,1736098,2994,1929570,California
Orange,2021-07-07,5771,3575336,4282,2007925,1243,1456530,246,110881,2384,192759,3339,1739437,2626,1932196,California
Orange,2021-07-08,5906,3581242,4464,2012389,1173,1457703,269,111150,2319,191810,3537,1742974,2588,1934784,California
Orange,2021-07-09,6960,3588202,5098,2017487,1504,1459207,358,111508,2836,190936,4067,1747041,3193,1937977,California
Orange,2021-07-10,4736,3592938,3562,2021049,1007,1460214,167,111675,1990,190393,2696,1749737,2153,1940130,California
Orange,2021-07-11,2326,3595264,1837,2022886,450,1460664,39,111714,1143,190417,1161,1750898,1185,1941315,California
Orange,2021-07-12,6082,3601346,4607,2027493,1168,1461832,307,112021,2299,189273,3744,1754642,2600,1943915,California
Orange,2021-07-13,5603,3606949,4086,2031579,1305,1463137,212,112233,2502,188935,3051,1757693,2713,1946628,California
Orange,2021-07-14,5236,3612185,3867,2035446,1177,1464314,192,112425,2288,188510,2901,1760594,2476,1949104,California
Orange,2021-07-15,5392,3617577,4118,2039564,1076,1465390,198,112623,2427,188205,2925,1763519,2620,1951724,California
Orange,2021-07-16,6903,3624480,5101,2044665,1533,1466923,269,112892,3252,188125,3601,1767120,3521,1955245,California
Orange,2021-07-17,4652,3629132,3497,2048162,1047,1467970,108,113000,2271,188166,2336,1769456,2377,1957622,California
Orange,2021-07-18,2576,3631708,1979,2050141,534,1468504,63,113063,1178,188020,1388,1770844,1242,1958864,California
Orange,2021-07-19,6152,3637860,4692,2054833,1198,1469702,262,113325,2895,187975,3202,1774046,3157,1962021,California
Orange,2021-07-20,6223,3644083,4493,2059326,1500,1471202,230,113555,3181,188403,2983,1777029,3411,1965432,California
Orange,2021-07-21,5854,3649937,4333,2063659,1315,1472517,206,113761,3190,189187,2608,1779637,3392,1968824,California
Orange,2021-07-22,6112,3656049,4546,2068205,1350,1473867,216,113977,3291,189938,2752,1782389,3503,1972327,California
Orange,2021-07-23,7512,3663561,5479,2073684,1732,1475599,301,114278,3990,190773,3452,1785841,4287,1976614,California
Orange,2021-07-24,4783,3668344,3371,2077055,1272,1476871,140,114418,2682,191522,2074,1787915,2823,1979437,California
Orange,2021-07-25,2417,3670761,1804,2078859,579,1477450,34,114452,1783,192724,614,1788529,1816,1981253,California
Orange,2021-07-26,6157,3676918,4543,2083402,1328,1478778,286,114738,3673,194242,2436,1790965,3954,1985207,California
Orange,2021-07-27,6313,3683231,4561,2087963,1505,1480283,247,114985,3622,195464,2642,1793607,3864,1989071,California
Orange,2021-07-28,6335,3689566,4578,2092541,1442,1481725,315,115300,3671,196856,2591,1796198,3983,1993054,California
Orange,2021-07-29,6220,3695786,4687,2097228,1280,1483005,253,115553,3744,198458,2392,1798590,3994,1997048,California
Orange,2021-07-30,7678,3703464,5661,2102889,1748,1484753,269,115822,4503,200145,3086,1801676,4773,2001821,California
Orange,2021-07-31,4610,3708074,3356,2106245,1098,1485851,156,115978,2589,200927,1964,1803640,2746,2004567,California
Orange,2021-08-01,2724,3710798,2173,2108418,501,1486352,50,116028,1644,201581,1040,1804680,1694,2006261,California
Orange,2021-08-02,6475,3717273,4905,2113323,1281,1487633,289,116317,3953,203374,2452,1807132,4245,2010506,California
Orange,2021-08-03,6489,3723762,4762,2118085,1488,1489121,239,116556,4005,205185,2431,1809563,4242,2014748,California
Orange,2021-08-04,6358,3730120,4786,2122871,1318,1490439,254,116810,3913,206970,2379,1811942,4164,2018912,California
Orange,2021-08-05,6643,3736763,5086,2127957,1289,1491728,268,117078,4098,208847,2482,1814424,4359,2023271,California
Orange,2021-08-06,8327,3745090,6288,2134245,1696,1493424,343,117421,5030,210990,3231,1817655,5374,2028645,California
Orange,2021-08-07,5086,3750176,3739,2137984,1195,1494619,152,117573,3007,212118,2030,1819685,3158,2031803,California
Orange,2021-08-08,3150,3753326,2412,2140396,696,1495315,42,117615,2004,213058,1106,1820791,2046,2033849,California
Orange,2021-08-09,7314,3760640,5702,2146098,1285,1496600,327,117942,4224,214586,3021,1823812,4549,2038398,California
Orange,2021-08-10,6683,3767323,4980,2151078,1418,1498018,285,118227,3710,215683,2898,1826710,3995,2042393,California
Orange,2021-08-11,6230,3773553,4769,2155847,1212,1499230,249,118476,3526,216808,2648,1829358,3773,2046166,California
Orange,2021-08-12,7085,3780638,5302,2161149,1470,1500700,313,118789,4035,218210,2948,1832306,4350,2050516,California
Orange,2021-08-13,8467,3789105,6194,2167343,1963,1502663,310,119099,4829,219876,3469,1835775,5135,2055651,California
Orange,2021-08-14,5706,3794811,4029,2171372,1498,1504161,179,119278,2998,220792,2262,1838037,3178,2058829,California
Orange,2021-08-15,3367,3798178,2512,2173884,814,1504975,41,119319,1663,221092,1406,1839443,1706,2060535,California
Orange,2021-08-16,8230,3806408,5720,2179604,2164,1507139,346,119665,3852,221826,3464,1842907,4198,2064733,California
Orange,2021-08-17,7238,3813646,4925,2184529,2008,1509147,305,119970,3146,222090,3187,1846094,3451,2068184,California
Orange,2021-08-18,7510,3821156,5139,2189668,2114,1511261,257,120227,3242,222386,3199,1849293,3495,2071679,California
Orange,2021-08-19,7449,3828605,5056,2194724,2075,1513336,318,120545,3100,222480,3325,1852618,3419,2075098,California
Orange,2021-08-20,9698,3838303,6773,2201497,2574,1515910,351,120896,4022,222372,4482,1857100,4374,2079472,California
Orange,2021-08-21,5819,3844122,4107,2205604,1563,1517473,149,121045,2417,222276,2661,1859761,2565,2082037,California
Orange,2021-08-22,3613,3847735,2591,2208195,968,1518441,54,121099,1561,222301,1591,1861352,1616,2083653,California
Orange,2021-08-23,8181,3855916,5829,2214024,2030,1520471,322,121421,3193,221912,3902,1865254,3513,2087166,California
Orange,2021-08-24,7592,3863508,5359,2219383,2001,1522472,232,121653,2796,221292,3639,1868893,3019,2090185,California
Orange,2021-08-25,7236,3870744,5286,2224669,1753,1524225,197,121850,2805,220915,3380,1872273,3003,2093188,California
Orange,2021-08-26,7428,3878172,5468,2230137,1729,1525954,231,122081,2825,220460,3508,1875781,3053,2096241,California
Orange,2021-08-27,9849,3888021,7352,2237489,2224,1528178,273,122354,3582,219443,4866,1880647,3849,2100090,California
Orange,2021-08-28,6023,3894044,4410,2241899,1485,1529663,128,122482,2393,219054,2907,1883554,2518,2102608,California
Orange,2021-08-29,3871,3897915,2881,2244780,954,1530617,36,122518,1465,218701,1859,1885413,1506,2104114,California
Orange,2021-08-30,5367,3903282,3551,2248331,1624,1532241,192,122710,1573,217778,2687,1888100,1764,2105878,California
Placer,2020-12-15,30,30,30,30,0,0,0,0,30,30,0,0,30,30,California
Placer,2020-12-16,62,92,62,92,0,0,0,0,62,92,0,0,62,92,California
Placer,2020-12-17,151,243,151,243,0,0,0,0,151,243,0,0,151,243,California
Placer,2020-12-18,451,694,451,694,0,0,0,0,451,694,0,0,451,694,California
Placer,2020-12-19,257,951,257,951,0,0,0,0,257,951,0,0,257,951,California
Placer,2020-12-20,231,1182,231,1182,0,0,0,0,231,1182,0,0,231,1182,California
Placer,2020-12-21,511,1693,509,1691,2,2,0,0,511,1693,0,0,511,1693,California
Placer,2020-12-22,680,2373,674,2365,6,8,0,0,680,2373,0,0,680,2373,California
Placer,2020-12-23,760,3133,670,3035,90,98,0,0,760,3133,0,0,760,3133,California
Placer,2020-12-24,410,3543,358,3393,52,150,0,0,410,3543,0,0,410,3543,California
Placer,2020-12-25,1,3544,1,3394,0,150,0,0,1,3544,0,0,1,3544,California
Placer,2020-12-26,167,3711,121,3515,46,196,0,0,167,3711,0,0,167,3711,California
Placer,2020-12-27,184,3895,161,3676,23,219,0,0,184,3895,0,0,184,3895,California
Placer,2020-12-28,684,4579,557,4233,127,346,0,0,683,4577,1,1,683,4578,California
Placer,2020-12-29,798,5377,546,4779,252,598,0,0,797,5373,1,2,797,5375,California
Placer,2020-12-30,804,6181,529,5308,275,873,0,0,804,6177,0,2,804,6179,California
Placer,2020-12-31,551,6732,366,5674,185,1058,0,0,551,6728,0,2,551,6730,California
Placer,2021-01-01,18,6750,12,5686,6,1064,0,0,18,6746,0,2,18,6748,California
Placer,2021-01-02,190,6940,157,5843,33,1097,0,0,190,6936,0,2,190,6938,California
Placer,2021-01-03,154,7094,78,5921,76,1173,0,0,154,7090,0,2,154,7092,California
Placer,2021-01-04,637,7731,192,6113,445,1618,0,0,637,7727,0,2,637,7729,California
Placer,2021-01-05,725,8456,162,6275,563,2181,0,0,635,8274,89,91,636,8365,California
Placer,2021-01-06,770,9226,251,6526,519,2700,0,0,616,8736,154,245,616,8981,California
Placer,2021-01-07,997,10223,381,6907,616,3316,0,0,762,9264,234,479,762,9743,California
Placer,2021-01-08,1191,11414,540,7447,651,3967,0,0,780,9636,408,887,780,10523,California
Placer,2021-01-09,463,11877,325,7772,138,4105,0,0,241,9656,221,1108,241,10764,California
Placer,2021-01-10,337,12214,187,7959,150,4255,0,0,169,9657,168,1276,169,10933,California
Placer,2021-01-11,1446,13660,822,8781,624,4879,0,0,847,9906,599,1875,848,11781,California
Placer,2021-01-12,1689,15349,892,9673,797,5676,0,0,1076,10371,612,2487,1077,12858,California
Placer,2021-01-13,1659,17008,836,10509,823,6499,0,0,1231,11179,426,2913,1234,14092,California
Placer,2021-01-14,1844,18852,704,11213,1140,7639,0,0,1456,12252,385,3298,1458,15550,California
Placer,2021-01-15,1953,20805,730,11943,1223,8862,0,0,1596,13493,356,3654,1597,17147,California
Placer,2021-01-16,1499,22304,715,12658,784,9646,0,0,1375,14745,124,3778,1376,18523,California
Placer,2021-01-17,585,22889,402,13060,183,9829,0,0,442,15045,142,3920,442,18965,California
Placer,2021-01-18,981,23870,541,13601,440,10269,0,0,736,15538,244,4164,737,19702,California
Placer,2021-01-19,2645,26515,1976,15577,669,10938,0,0,2156,17206,489,4653,2157,21859,California
Placer,2021-01-20,2370,28885,1781,17358,589,11527,0,0,1999,18835,371,5024,2000,23859,California
Placer,2021-01-21,2614,31499,1157,18515,1457,12984,0,0,2195,20614,417,5441,2196,26055,California
Placer,2021-01-22,2353,33852,639,19154,1714,14698,0,0,2165,22595,186,5627,2167,28222,California
Placer,2021-01-23,1203,35055,388,19542,815,15513,0,0,1041,23476,161,5788,1042,29264,California
Placer,2021-01-24,516,35571,266,19808,250,15763,0,0,437,23834,79,5867,437,29701,California
Placer,2021-01-25,1699,37270,818,20626,881,16644,0,0,1397,24929,302,6169,1397,31098,California
Placer,2021-01-26,1877,39147,1042,21668,835,17479,0,0,1601,26254,276,6445,1601,32699,California
Placer,2021-01-27,1848,40995,1159,22827,689,18168,0,0,1594,27597,252,6697,1595,34294,California
Placer,2021-01-28,1855,42850,1153,23980,702,18870,0,0,1607,28959,245,6942,1607,35901,California
Placer,2021-01-29,1926,44776,1172,25152,754,19624,0,0,1722,30480,202,7144,1723,37624,California
Placer,2021-01-30,1723,46499,954,26106,769,20393,0,0,1599,31957,123,7267,1600,39224,California
Placer,2021-01-31,783,47282,623,26729,160,20553,0,0,710,32594,73,7340,710,39934,California
Placer,2021-02-01,2108,49390,1107,27836,1001,21554,0,0,1776,34040,330,7670,1776,41710,California
Placer,2021-02-02,2422,51812,1561,29397,861,22415,0,0,1916,35453,503,8173,1916,43626,California
Placer,2021-02-03,2946,54758,1901,31298,1045,23460,0,0,2306,37123,636,8809,2306,45932,California
Placer,2021-02-04,2760,57518,1190,32488,1570,25030,0,0,1911,38191,844,9653,1912,47844,California
Placer,2021-02-05,2760,60278,1263,33751,1497,26527,0,0,1392,38238,1345,10998,1392,49236,California
Placer,2021-02-06,1999,62277,1327,35078,672,27199,0,0,1441,39122,557,11555,1441,50677,California
Placer,2021-02-07,1176,63453,865,35943,311,27510,0,0,877,39701,298,11853,877,51554,California
Placer,2021-02-08,3286,66739,1751,37694,1535,29045,0,0,1925,40293,1334,13187,1926,53480,California
Placer,2021-02-09,3585,70324,2199,39893,1386,30431,0,0,1628,39968,1953,15140,1628,55108,California
Placer,2021-02-10,3767,74091,2203,42096,1564,31995,0,0,1699,39606,2061,17201,1699,56807,California
Placer,2021-02-11,3729,77820,1919,44015,1810,33805,0,0,1560,39013,2153,19354,1560,58367,California
Placer,2021-02-12,2902,80722,1343,45358,1559,35364,0,0,1676,39503,1187,20541,1677,60044,California
Placer,2021-02-13,2590,83312,1454,46812,1136,36500,0,0,1910,40734,679,21220,1910,61954,California
Placer,2021-02-14,1110,84422,688,47500,422,36922,0,0,749,41125,358,21578,749,62703,California
Placer,2021-02-15,2251,86673,1043,48543,1208,38130,0,0,1527,41930,724,22302,1529,64232,California
Placer,2021-02-16,3575,90248,1781,50324,1794,39924,0,0,1550,41466,2015,24317,1551,65783,California
Placer,2021-02-17,3580,93828,1976,52300,1604,41528,0,0,1513,40916,2063,26380,1513,67296,California
Placer,2021-02-18,3843,97671,2068,54368,1775,43303,0,0,1620,40327,2210,28590,1621,68917,California
Placer,2021-02-19,3664,101335,1954,56322,1710,45013,0,0,1362,39403,2288,30878,1364,70281,California
Placer,2021-02-20,2118,103453,1296,57618,822,45835,0,0,965,39227,1146,32024,970,71251,California
Placer,2021-02-21,1183,104636,780,58398,403,46238,0,0,431,38910,749,32773,432,71683,California
Placer,2021-02-22,2664,107300,1866,60264,798,47036,0,0,629,37509,2030,34803,629,72312,California
Placer,2021-02-23,2787,110087,1736,62000,1051,48087,0,0,924,36572,1861,36664,924,73236,California
Placer,2021-02-24,3468,113555,1231,63231,2237,50324,0,0,1888,36894,1568,38232,1890,75126,California
Placer,2021-02-25,3865,117420,1600,64831,2265,52589,0,0,2109,37260,1746,39978,2112,77238,California
Placer,2021-02-26,4381,121801,2534,67365,1847,54436,0,0,2497,37880,1878,41856,2498,79736,California
Placer,2021-02-27,2995,124796,1586,68951,1409,55845,0,0,1533,37959,1456,43312,1535,81271,California
Placer,2021-02-28,1625,126421,883,69834,741,56586,1,1,750,37844,866,44178,751,82022,California
Placer,2021-03-01,3323,129744,2205,72039,1118,57704,0,1,1681,37897,1628,45806,1681,83703,California
Placer,2021-03-02,3015,132759,1863,73902,1151,58855,1,2,1941,38775,1065,46871,1943,85646,California
Placer,2021-03-03,3492,136251,1515,75417,1976,60831,1,3,1896,39086,1587,48458,1898,87544,California
Placer,2021-03-04,3719,139970,1496,76913,2223,63054,0,3,1922,39225,1784,50242,1923,89467,California
Placer,2021-03-05,3023,142993,1050,77963,1953,65007,20,23,1800,39828,1217,51459,1820,91287,California
Placer,2021-03-06,2488,145481,1537,79500,851,65858,100,123,936,39321,1541,53000,1034,92321,California
Placer,2021-03-07,1382,146863,768,80268,556,66414,58,181,546,39090,832,53832,601,92922,California
Placer,2021-03-08,2939,149802,1842,82110,978,67392,119,300,1657,39589,1276,55108,1775,94697,California
Placer,2021-03-09,3194,152996,1700,83810,1407,68799,87,387,1849,40183,1341,56449,1935,96632,California
Placer,2021-03-10,3331,156327,1344,85154,1885,70684,102,489,1750,40460,1575,58024,1852,98484,California
Placer,2021-03-11,3678,160005,1665,86819,1881,72565,132,621,1764,40456,1901,59925,1897,100381,California
Placer,2021-03-12,3741,163746,1506,88325,1454,74019,781,1402,1281,40062,2450,62375,2056,102437,California
Placer,2021-03-13,2235,165981,756,89081,1355,75374,124,1526,1200,40354,1030,63405,1322,103759,California
Placer,2021-03-14,1734,167715,695,89776,885,76259,154,1680,905,40586,826,64231,1058,104817,California
Placer,2021-03-15,3253,170968,1560,91336,1563,77822,130,1810,1798,41065,1450,65681,1929,106746,California
Placer,2021-03-16,3688,174656,1997,93333,1557,79379,134,1944,2340,42206,1333,67014,2474,109220,California
Placer,2021-03-17,3535,178191,1786,95119,1645,81024,104,2048,2269,43319,1261,68275,2374,111594,California
Placer,2021-03-18,4169,182360,2368,97487,1762,82786,39,2087,2904,45005,1255,69530,2941,114535,California
Placer,2021-03-19,3501,185861,2093,99580,1141,83927,267,2354,2164,46104,1327,70857,2426,116961,California
Placer,2021-03-20,2243,188104,952,100532,1203,85130,88,2442,1344,46643,892,71749,1431,118392,California
Placer,2021-03-21,1319,189423,590,101122,719,85849,10,2452,801,46940,514,72263,811,119203,California
Placer,2021-03-22,3369,192792,2163,103285,1113,86962,93,2545,2164,47997,1198,73461,2255,121458,California
Placer,2021-03-23,3629,196421,2133,105418,1406,88368,90,2635,2572,49607,1051,74512,2661,124119,California
Placer,2021-03-24,3868,200289,2014,107432,1753,90121,101,2736,1926,49713,1923,76435,2029,126148,California
Placer,2021-03-25,3911,204200,1879,109311,1936,92057,96,2832,1690,49291,2206,78641,1784,127932,California
Placer,2021-03-26,3796,207996,1673,110984,1891,93948,232,3064,1495,48731,2285,80926,1725,129657,California
Placer,2021-03-27,1628,209624,478,111462,1131,95079,19,3083,625,48380,994,81920,643,130300,California
Placer,2021-03-28,1129,210753,538,112000,581,95660,10,3093,302,47885,808,82728,313,130613,California
Placer,2021-03-29,3574,214327,2008,114008,1528,97188,38,3131,1709,47780,1853,84581,1748,132361,California
Placer,2021-03-30,4024,218351,2119,116127,1860,99048,45,3176,2092,47995,1918,86499,2133,134494,California
Placer,2021-03-31,4163,222514,1851,117978,2233,101281,79,3255,1671,47261,2482,88981,1748,136242,California
Placer,2021-04-01,3010,225524,1452,119430,1506,102787,52,3307,1658,47629,1341,90322,1709,137951,California
Placer,2021-04-02,2860,228384,1486,120916,1308,104095,66,3373,1586,48012,1267,91589,1650,139601,California
Placer,2021-04-03,1860,230244,992,121908,734,104829,134,3507,886,48065,965,92554,1018,140619,California
Placer,2021-04-04,717,230961,366,122274,296,105125,55,3562,285,47979,425,92979,339,140958,California
Placer,2021-04-05,3052,234013,1914,124188,953,106078,185,3747,1751,48623,1292,94271,1936,142894,California
Placer,2021-04-06,4338,238351,2503,126691,1535,107613,300,4047,1503,47604,2821,97092,1802,144696,California
Placer,2021-04-07,4620,242971,2644,129335,1523,109136,453,4500,2080,47603,2531,99623,2530,147226,California
Placer,2021-04-08,4768,247739,2642,131977,1591,110727,535,5035,1581,46541,3176,102799,2114,149340,California
Placer,2021-04-09,4162,251901,2281,134258,1259,111986,622,5657,1247,45506,2904,105703,1869,151209,California
Placer,2021-04-10,2139,254040,908,135166,1043,113029,188,5845,913,45381,1224,106927,1099,152308,California
Placer,2021-04-11,1404,255444,532,135698,840,113869,32,5877,444,44900,956,107883,475,152783,California
Placer,2021-04-12,4140,259584,2666,138364,1083,114952,391,6268,2449,46056,1682,109565,2838,155621,California
Placer,2021-04-13,4417,264001,3034,141398,1382,116334,1,6269,2213,46075,2196,111761,2215,157836,California
Placer,2021-04-14,4214,268215,2589,143987,1624,117958,1,6270,1880,45633,2322,114083,1880,159716,California
Placer,2021-04-15,4529,272744,2520,146507,2008,119966,1,6271,2344,45803,2175,116258,2345,162061,California
Placer,2021-04-16,3722,276466,2203,148710,1519,121485,0,6271,1435,44958,2280,118538,1435,163496,California
Placer,2021-04-17,2656,279122,860,149570,1796,123281,0,6271,1731,45769,920,119458,1731,165227,California
Placer,2021-04-18,1286,280408,308,149878,978,124259,0,6271,440,45365,844,120302,440,165667,California
Placer,2021-04-19,2978,283386,1833,151711,1145,125404,0,6271,1147,44690,1823,122125,1148,166815,California
Placer,2021-04-20,3945,287331,2583,154294,1362,126766,0,6271,2427,45610,1507,123632,2427,169242,California
Placer,2021-04-21,3841,291172,2546,156840,1294,128060,1,6272,2471,46720,1362,124994,2472,171714,California
Placer,2021-04-22,3779,294951,2369,159209,1410,129470,0,6272,1788,46522,1986,126980,1788,173502,California
Placer,2021-04-23,3625,298576,2395,161604,1229,130699,1,6273,1404,45712,2215,129195,1405,174907,California
Placer,2021-04-24,2128,300704,1276,162880,851,131550,1,6274,1248,46091,869,130064,1248,176155,California
Placer,2021-04-25,943,301647,505,163385,438,131988,0,6274,558,46264,385,130449,558,176713,California
Placer,2021-04-26,2535,304182,1358,164743,1154,133142,23,6297,1227,46216,1298,131747,1250,177963,California
Placer,2021-04-27,2791,306973,1472,166215,1268,134410,51,6348,1572,46627,1213,132960,1624,179587,California
Placer,2021-04-28,3110,310083,1951,168166,1122,135532,37,6385,1624,46812,1477,134437,1662,181249,California
Placer,2021-04-29,3491,313574,2299,170465,1137,136669,55,6440,1453,46288,2031,136468,1507,182756,California
Placer,2021-04-30,3069,316643,1888,172353,1133,137802,48,6488,1237,45747,1826,138294,1285,184041,California
Placer,2021-05-01,1357,318000,950,173303,379,138181,28,6516,608,45639,743,139037,635,184676,California
Placer,2021-05-02,739,318739,580,173883,137,138318,22,6538,338,45599,400,139437,360,185036,California
Placer,2021-05-03,1622,320361,998,174881,557,138875,67,6605,430,44909,1186,140623,496,185532,California
Placer,2021-05-04,2399,322760,1381,176262,856,139731,162,6767,890,44458,1502,142125,1051,186583,California
Placer,2021-05-05,3785,326545,2574,178836,1108,140839,103,6870,992,42770,2781,144906,1093,187676,California
Placer,2021-05-06,3133,329678,1919,180755,1136,141975,78,6948,815,41373,2290,147196,893,188569,California
Placer,2021-05-07,2864,332542,1947,182702,821,142796,96,7044,799,40217,2052,149248,896,189465,California
Placer,2021-05-08,1421,333963,752,183454,627,143423,42,7086,412,39665,1006,150254,454,189919,California
Placer,2021-05-09,461,334424,226,183680,213,143636,22,7108,215,39655,246,150500,236,190155,California
Placer,2021-05-10,1953,336377,1046,184726,810,144446,97,7205,433,38671,1514,152014,530,190685,California
Placer,2021-05-11,3089,339466,2237,186963,738,145184,114,7319,665,37036,2414,154428,779,191464,California
Placer,2021-05-12,2923,342389,2016,188979,850,146034,57,7376,691,35563,2223,156651,750,192214,California
Placer,2021-05-13,2897,345286,1874,190853,976,147010,47,7423,1023,34761,1871,158522,1069,193283,California
Placer,2021-05-14,2885,348171,1895,192748,850,147860,140,7563,1403,34833,1465,159987,1537,194820,California
Placer,2021-05-15,2134,350305,1386,194134,724,148584,24,7587,955,34641,1171,161158,979,195799,California
Placer,2021-05-16,1204,351509,535,194669,650,149234,19,7606,344,34147,857,162015,363,196162,California
Placer,2021-05-17,2370,353879,1583,196252,713,149947,74,7680,1015,33887,1350,163365,1090,197252,California
Placer,2021-05-18,2528,356407,1705,197957,744,150691,79,7759,1137,33717,1386,164751,1216,198468,California
Placer,2021-05-19,2566,358973,1619,199576,900,151591,47,7806,880,32964,1680,166431,927,199395,California
Placer,2021-05-20,2579,361552,1670,201246,859,152450,50,7856,874,32189,1699,168130,924,200319,California
Placer,2021-05-21,2484,364036,1551,202797,784,153234,149,8005,1067,31994,1408,169538,1213,201532,California
Placer,2021-05-22,1628,365664,1075,203872,511,153745,42,8047,751,31915,872,170410,793,202325,California
Placer,2021-05-23,705,366369,366,204238,322,154067,17,8064,284,31797,420,170830,302,202627,California
Placer,2021-05-24,1527,367896,778,205016,616,154683,133,8197,453,31313,1070,171900,586,203213,California
Placer,2021-05-25,1801,369697,952,205968,751,155434,98,8295,639,30895,1155,173055,737,203950,California
Placer,2021-05-26,1612,371309,926,206894,645,156079,41,8336,627,30586,979,174034,670,204620,California
Placer,2021-05-27,1455,372764,724,207618,687,156766,44,8380,670,30522,779,174813,715,205335,California
Placer,2021-05-28,1720,374484,873,208491,747,157513,100,8480,728,30366,984,175797,828,206163,California
Placer,2021-05-29,756,375240,411,208902,314,157827,31,8511,383,30409,370,176167,413,206576,California
Placer,2021-05-30,347,375587,236,209138,96,157923,15,8526,213,30504,133,176300,228,206804,California
Placer,2021-05-31,147,375734,69,209207,61,157984,17,8543,29,30433,116,176416,45,206849,California
Placer,2021-06-01,1701,377435,900,210107,729,158713,72,8615,596,30003,1098,177514,668,207517,California
Placer,2021-06-02,1528,378963,769,210876,690,159403,69,8684,488,29523,1037,178551,557,208074,California
Placer,2021-06-03,1729,380692,1056,211932,614,160017,59,8743,439,28735,1285,179836,497,208571,California
Placer,2021-06-04,1903,382595,1354,213286,495,160512,54,8797,464,27823,1429,181265,517,209088,California
Placer,2021-06-05,1105,383700,786,214072,278,160790,41,8838,273,27310,827,182092,314,209402,California
Placer,2021-06-06,503,384203,364,214436,122,160912,17,8855,121,27067,381,182473,138,209540,California
Placer,2021-06-07,1060,385263,725,215161,263,161175,72,8927,226,26533,830,183303,296,209836,California
Placer,2021-06-08,1755,387018,1336,216497,368,161543,51,8978,441,25713,1311,184614,491,210327,California
Placer,2021-06-09,1196,388214,868,217365,276,161819,52,9030,272,25119,919,185533,325,210652,California
Placer,2021-06-10,1257,389471,866,218231,315,162134,76,9106,310,24560,943,186476,384,211036,California
Placer,2021-06-11,1504,390975,1082,219313,363,162497,59,9165,349,23818,1149,187625,407,211443,California
Placer,2021-06-12,1039,392014,770,220083,239,162736,30,9195,220,23254,814,188439,250,211693,California
Placer,2021-06-13,405,392419,314,220397,80,162816,11,9206,97,23056,306,188745,108,211801,California
Placer,2021-06-14,779,393198,534,220931,201,163017,44,9250,228,22780,547,189292,271,212072,California
Placer,2021-06-15,1318,394516,879,221810,376,163393,63,9313,440,22408,874,190166,502,212574,California
Placer,2021-06-16,1059,395575,766,222576,236,163629,57,9370,342,22091,715,190881,398,212972,California
Placer,2021-06-17,885,396460,613,223189,236,163865,36,9406,271,21788,610,191491,307,213279,California
Placer,2021-06-18,1162,397622,765,223954,305,164170,92,9498,380,21479,781,192272,472,213751,California
Placer,2021-06-19,618,398240,446,224400,138,164308,34,9532,238,21373,377,192649,271,214022,California
Placer,2021-06-20,284,398524,233,224633,43,164351,8,9540,108,21314,174,192823,115,214137,California
Placer,2021-06-21,491,399015,287,224920,166,164517,38,9578,231,21324,259,193082,269,214406,California
Placer,2021-06-22,887,399902,624,225544,209,164726,54,9632,265,21028,615,193697,319,214725,California
Placer,2021-06-23,845,400747,611,226155,187,164913,47,9679,386,21003,458,194155,433,215158,California
Placer,2021-06-24,833,401580,528,226683,260,165173,45,9724,323,20864,507,194662,368,215526,California
Placer,2021-06-25,950,402530,673,227356,224,165397,53,9777,396,20764,548,195210,448,215974,California
Placer,2021-06-26,546,403076,387,227743,126,165523,33,9810,236,20725,308,195518,269,216243,California
Placer,2021-06-27,248,403324,182,227925,55,165578,11,9821,118,20724,129,195647,128,216371,California
Placer,2021-06-28,495,403819,363,228288,85,165663,47,9868,213,20704,280,195927,260,216631,California
Placer,2021-06-29,833,404652,587,228875,199,165862,47,9915,322,20563,510,196437,369,217000,California
Placer,2021-06-30,600,405252,417,229292,142,166004,41,9956,259,20524,339,196776,300,217300,California
Placer,2021-07-01,570,405822,387,229679,145,166149,38,9994,236,20466,332,197108,274,217574,California
Placer,2021-07-02,701,406523,515,230194,159,166308,27,10021,309,20415,387,197495,336,217910,California
Placer,2021-07-03,307,406830,211,230405,83,166391,13,10034,147,20418,156,197651,159,218069,California
Placer,2021-07-04,17,406847,3,230408,14,166405,0,10034,7,20415,10,197661,7,218076,California
Placer,2021-07-05,396,407243,262,230670,100,166505,34,10068,165,20387,227,197888,199,218275,California
Placer,2021-07-06,847,408090,640,231310,162,166667,45,10113,302,20191,543,198431,347,218622,California
Placer,2021-07-07,572,408662,432,231742,108,166775,32,10145,232,20117,338,198769,264,218886,California
Placer,2021-07-08,535,409197,363,232105,130,166905,42,10187,232,20091,300,199069,274,219160,California
Placer,2021-07-09,696,409893,487,232592,139,167044,70,10257,303,20072,391,199460,372,219532,California
Placer,2021-07-10,362,410255,265,232857,91,167135,6,10263,132,19981,229,199689,138,219670,California
Placer,2021-07-11,232,410487,180,233037,38,167173,14,10277,107,19977,125,199814,121,219791,California
Placer,2021-07-12,503,410990,383,233420,85,167258,35,10312,243,19997,258,200072,278,220069,California
Placer,2021-07-13,504,411494,382,233802,106,167364,16,10328,240,19990,263,200335,256,220325,California
Placer,2021-07-14,581,412075,439,234241,118,167482,24,10352,228,19892,349,200684,251,220576,California
Placer,2021-07-15,470,412545,342,234583,107,167589,21,10373,212,19868,257,200941,233,220809,California
Placer,2021-07-16,764,413309,556,235139,173,167762,35,10408,354,19851,406,201347,389,221198,California
Placer,2021-07-17,350,413659,255,235394,78,167840,17,10425,139,19796,211,201558,156,221354,California
Placer,2021-07-18,197,413856,146,235540,47,167887,4,10429,93,19792,101,201659,97,221451,California
Placer,2021-07-19,541,414397,393,235933,123,168010,25,10454,293,19866,244,201903,318,221769,California
Placer,2021-07-20,755,415152,547,236480,176,168186,32,10486,387,19920,364,202267,418,222187,California
Placer,2021-07-21,636,415788,449,236929,153,168339,34,10520,317,19957,313,202580,350,222537,California
Placer,2021-07-22,688,416476,449,237378,201,168540,38,10558,385,20082,296,202876,421,222958,California
Placer,2021-07-23,843,417319,600,237978,201,168741,42,10600,464,20215,373,203249,506,223464,California
Placer,2021-07-24,393,417712,280,238258,95,168836,18,10618,231,20303,161,203410,249,223713,California
Placer,2021-07-25,225,417937,153,238411,66,168902,6,10624,165,20417,57,203467,171,223884,California
Placer,2021-07-26,610,418547,431,238842,151,169053,28,10652,391,20620,216,203683,419,224303,California
Placer,2021-07-27,804,419351,585,239427,177,169230,42,10694,450,20760,351,204034,491,224794,California
Placer,2021-07-28,695,420046,518,239945,133,169363,44,10738,418,20952,270,204304,462,225256,California
Placer,2021-07-29,722,420768,503,240448,176,169539,43,10781,452,21180,267,204571,495,225751,California
Placer,2021-07-30,899,421667,653,241101,208,169747,38,10819,562,21452,327,204898,599,226350,California
Placer,2021-07-31,437,422104,292,241393,121,169868,24,10843,262,21567,171,205069,286,226636,California
Placer,2021-08-01,289,422393,201,241594,83,169951,5,10848,206,21698,80,205149,211,226847,California
Placer,2021-08-02,855,423248,638,242232,166,170117,51,10899,505,21907,344,205493,553,227400,California
Placer,2021-08-03,756,424004,525,242757,192,170309,39,10938,500,22192,252,205745,537,227937,California
Placer,2021-08-04,750,424754,533,243290,167,170476,50,10988,469,22435,276,206021,519,228456,California
Placer,2021-08-05,766,425520,539,243829,171,170647,56,11044,501,22731,259,206280,555,229011,California
Placer,2021-08-06,989,426509,726,244555,213,170860,50,11094,599,22995,385,206665,649,229660,California
Placer,2021-08-07,506,427015,350,244905,122,170982,34,11128,324,23176,176,206841,357,230017,California
Placer,2021-08-08,346,427361,261,245166,63,171045,22,11150,224,23304,118,206959,246,230263,California
Placer,2021-08-09,795,428156,588,245754,167,171212,40,11190,471,23496,318,207277,510,230773,California
Placer,2021-08-10,825,428981,609,246363,158,171370,58,11248,468,23671,351,207628,526,231299,California
Placer,2021-08-11,691,429672,516,246879,133,171503,42,11290,413,23857,269,207897,455,231754,California
Placer,2021-08-12,788,430460,528,247407,195,171698,65,11355,431,24003,350,208247,496,232250,California
Placer,2021-08-13,997,431457,696,248103,246,171944,55,11410,518,24117,459,208706,573,232823,California
Placer,2021-08-14,539,431996,369,248472,144,172088,26,11436,266,24172,237,208943,292,233115,California
Placer,2021-08-15,341,432337,244,248716,76,172164,21,11457,159,24195,157,209100,180,233295,California
Placer,2021-08-16,919,433256,621,249337,253,172417,45,11502,482,24359,363,209463,527,233822,California
Placer,2021-08-17,1011,434267,677,250014,261,172678,73,11575,488,24481,439,209902,561,234383,California
Placer,2021-08-18,988,435255,684,250698,254,172932,50,11625,473,24615,388,210290,522,234905,California
Placer,2021-08-19,1033,436288,677,251375,307,173239,49,11674,442,24675,430,210720,490,235395,California
Placer,2021-08-20,1342,437630,911,252286,357,173596,74,11748,558,24692,616,211336,633,236028,California
Placer,2021-08-21,563,438193,392,252678,149,173745,22,11770,237,24684,267,211603,259,236287,California
Placer,2021-08-22,390,438583,267,252945,109,173854,14,11784,181,24717,162,211765,195,236482,California
Placer,2021-08-23,1191,439774,856,253801,271,174125,64,11848,510,24807,485,212250,575,237057,California
Placer,2021-08-24,991,440765,744,254545,222,174347,25,11873,409,24819,422,212672,434,237491,California
Placer,2021-08-25,1029,441794,743,255288,219,174566,67,11940,420,24892,413,213085,486,237977,California
Placer,2021-08-26,1013,442807,724,256012,237,174803,52,11992,426,24936,433,213518,477,238454,California
Placer,2021-08-27,1193,444000,857,256869,284,175087,52,12044,445,24839,594,214112,497,238951,California
Placer,2021-08-28,613,444613,431,257300,165,175252,17,12061,242,24793,305,214417,259,239210,California
Placer,2021-08-29,416,445029,299,257599,113,175365,4,12065,145,24716,226,214643,149,239359,California
Placer,2021-08-30,707,445736,470,258069,201,175566,36,12101,217,24617,351,214994,252,239611,California
Plumas,2020-12-18,3,3,3,3,0,0,0,0,3,3,0,0,3,3,California
Plumas,2020-12-19,2,5,2,5,0,0,0,0,2,5,0,0,2,5,California
Plumas,2020-12-21,46,51,46,51,0,0,0,0,46,51,0,0,46,51,California
Plumas,2020-12-22,95,146,95,146,0,0,0,0,95,146,0,0,95,146,California
Plumas,2020-12-23,50,196,50,196,0,0,0,0,50,196,0,0,50,196,California
Plumas,2020-12-24,7,203,7,203,0,0,0,0,7,203,0,0,7,203,California
Plumas,2020-12-28,9,212,1,204,8,8,0,0,9,212,0,0,9,212,California
Plumas,2020-12-29,33,245,23,227,10,18,0,0,33,245,0,0,33,245,California
Plumas,2020-12-30,24,269,2,229,22,40,0,0,24,269,0,0,24,269,California
Plumas,2020-12-31,5,274,2,231,3,43,0,0,5,274,0,0,5,274,California
Plumas,2021-01-01,4,278,0,231,4,47,0,0,4,278,0,0,4,278,California
Plumas,2021-01-02,1,279,0,231,1,48,0,0,1,279,0,0,1,279,California
Plumas,2021-01-04,10,289,3,234,7,55,0,0,10,289,0,0,10,289,California
Plumas,2021-01-05,23,312,1,235,22,77,0,0,23,312,0,0,23,312,California
Plumas,2021-01-06,117,429,4,239,113,190,0,0,117,429,0,0,117,429,California
Plumas,2021-01-07,53,482,2,241,51,241,0,0,51,479,2,2,52,481,California
Plumas,2021-01-08,11,493,4,245,7,248,0,0,8,484,3,5,8,489,California
Plumas,2021-01-09,2,495,2,247,0,248,0,0,0,482,2,7,0,489,California
Plumas,2021-01-11,60,555,51,298,9,257,0,0,12,446,48,55,12,501,California
Plumas,2021-01-12,157,712,88,386,69,326,0,0,70,430,87,142,71,572,California
Plumas,2021-01-13,56,768,51,437,5,331,0,0,9,392,47,189,9,581,California
Plumas,2021-01-14,99,867,15,452,84,415,0,0,93,479,6,195,93,674,California
Plumas,2021-01-15,61,928,7,459,54,469,0,0,59,536,2,197,59,733,California
Plumas,2021-01-16,57,985,1,460,56,525,0,0,57,593,0,197,57,790,California
Plumas,2021-01-18,4,989,3,463,1,526,0,0,4,597,0,197,4,794,California
Plumas,2021-01-19,38,1027,6,469,32,558,0,0,33,625,5,202,33,827,California
Plumas,2021-01-20,143,1170,7,476,136,694,0,0,138,758,5,207,138,965,California
Plumas,2021-01-21,114,1284,3,479,111,805,0,0,114,872,0,207,114,1079,California
Plumas,2021-01-22,5,1289,1,480,4,809,0,0,5,877,0,207,5,1084,California
Plumas,2021-01-23,96,1385,2,482,94,903,0,0,95,971,1,208,95,1179,California
Plumas,2021-01-24,1,1386,1,483,0,903,0,0,1,972,0,208,1,1180,California
Plumas,2021-01-25,10,1396,7,490,3,906,0,0,9,979,2,210,9,1189,California
Plumas,2021-01-26,62,1458,2,492,60,966,0,0,54,1025,8,218,54,1243,California
Plumas,2021-01-27,26,1484,20,512,6,972,0,0,6,1011,20,238,6,1249,California
Plumas,2021-01-28,27,1511,0,512,27,999,0,0,25,1034,2,240,25,1274,California
Plumas,2021-01-29,11,1522,5,517,6,1005,0,0,10,1043,1,241,10,1284,California
Plumas,2021-01-30,8,1530,2,519,6,1011,0,0,7,1049,1,242,7,1291,California
Plumas,2021-01-31,3,1533,3,522,0,1011,0,0,3,1052,0,242,3,1294,California
Plumas,2021-02-01,26,1559,4,526,22,1033,0,0,17,1060,9,251,17,1311,California
Plumas,2021-02-02,26,1585,4,530,22,1055,0,0,6,1046,20,271,6,1317,California
Plumas,2021-02-03,123,1708,6,536,117,1172,0,0,14,952,108,379,14,1331,California
Plumas,2021-02-04,103,1811,9,545,94,1266,0,0,23,896,79,458,23,1354,California
Plumas,2021-02-05,29,1840,13,558,16,1282,0,0,14,895,15,473,14,1368,California
Plumas,2021-02-06,8,1848,1,559,7,1289,0,0,8,903,0,473,8,1376,California
Plumas,2021-02-08,16,1864,6,565,10,1299,0,0,2,891,14,487,2,1378,California
Plumas,2021-02-09,174,2038,4,569,170,1469,0,0,112,942,61,548,112,1490,California
Plumas,2021-02-10,117,2155,11,580,106,1575,0,0,110,1046,7,555,111,1601,California
Plumas,2021-02-11,343,2498,5,585,338,1913,0,0,283,1269,60,615,283,1884,California
Plumas,2021-02-12,126,2624,5,590,121,2034,0,0,121,1385,5,620,121,2005,California
Plumas,2021-02-13,77,2701,8,598,69,2103,0,0,17,1342,60,680,17,2022,California
Plumas,2021-02-14,10,2711,6,604,4,2107,0,0,10,1352,0,680,10,2032,California
Plumas,2021-02-15,28,2739,5,609,23,2130,0,0,25,1374,3,683,25,2057,California
Plumas,2021-02-16,81,2820,5,614,76,2206,0,0,16,1325,65,748,16,2073,California
Plumas,2021-02-17,153,2973,5,619,148,2354,0,0,12,1196,141,889,12,2085,California
Plumas,2021-02-18,133,3106,6,625,127,2481,0,0,22,1108,111,1000,23,2108,California
Plumas,2021-02-19,45,3151,8,633,37,2518,0,0,8,1079,37,1037,8,2116,California
Plumas,2021-02-20,104,3255,5,638,99,2617,0,0,12,1000,91,1128,12,2128,California
Plumas,2021-02-21,5,3260,4,642,1,2618,0,0,2,999,3,1131,2,2130,California
Plumas,2021-02-22,9,3269,3,645,6,2624,0,0,1,992,8,1139,1,2131,California
Plumas,2021-02-23,26,3295,4,649,22,2646,0,0,18,1002,8,1147,18,2149,California
Plumas,2021-02-24,487,3782,8,657,479,3125,0,0,474,1463,13,1160,474,2623,California
Plumas,2021-02-25,239,4021,11,668,228,3353,0,0,174,1572,65,1225,174,2797,California
Plumas,2021-02-26,266,4287,9,677,257,3610,0,0,256,1819,10,1235,257,3054,California
Plumas,2021-02-27,45,4332,5,682,40,3650,0,0,37,1848,8,1243,37,3091,California
Plumas,2021-02-28,8,4340,0,682,8,3658,0,0,5,1850,3,1246,5,3096,California
Plumas,2021-03-01,31,4371,7,689,23,3681,1,1,16,1853,14,1260,17,3113,California
Plumas,2021-03-02,14,4385,1,690,13,3694,0,1,8,1856,5,1265,8,3121,California
Plumas,2021-03-03,185,4570,14,704,171,3865,0,1,165,2001,20,1285,165,3286,California
Plumas,2021-03-04,254,4824,8,712,246,4111,0,1,232,2211,22,1307,232,3518,California
Plumas,2021-03-05,399,5223,8,720,386,4497,5,6,385,2587,14,1321,390,3908,California
Plumas,2021-03-06,23,5246,4,724,11,4508,8,14,4,2580,19,1340,12,3920,California
Plumas,2021-03-07,14,5260,2,726,3,4511,9,23,5,2584,9,1349,13,3933,California
Plumas,2021-03-08,34,5294,4,730,5,4516,25,48,6,2588,28,1377,32,3965,California
Plumas,2021-03-09,134,5428,4,734,115,4631,15,63,18,2505,116,1493,33,3998,California
Plumas,2021-03-10,307,5735,4,738,289,4920,14,77,111,2435,195,1688,125,4123,California
Plumas,2021-03-11,191,5926,10,748,177,5097,4,81,154,2556,37,1725,158,4281,California
Plumas,2021-03-12,596,6522,7,755,303,5400,286,367,25,2295,571,2296,310,4591,California
Plumas,2021-03-13,27,6549,4,759,12,5412,11,378,7,2293,20,2316,18,4609,California
Plumas,2021-03-14,14,6563,4,763,5,5417,5,383,1,2287,12,2328,6,4615,California
Plumas,2021-03-15,39,6602,3,766,28,5445,8,391,10,2276,29,2357,18,4633,California
Plumas,2021-03-16,64,6666,4,770,59,5504,1,392,49,2313,13,2370,50,4683,California
Plumas,2021-03-17,72,6738,7,777,64,5568,1,393,56,2355,15,2385,57,4740,California
Plumas,2021-03-18,62,6800,6,783,40,5608,16,409,12,2334,49,2434,28,4768,California
Plumas,2021-03-19,161,6961,4,787,155,5763,2,411,153,2484,6,2440,156,4924,California
Plumas,2021-03-20,716,7677,4,791,711,6474,1,412,692,3155,22,2462,693,5617,California
Plumas,2021-03-21,2,7679,0,791,2,6476,0,412,1,3156,0,2462,1,5618,California
Plumas,2021-03-22,206,7885,2,793,204,6680,0,412,198,3347,7,2469,198,5816,California
Plumas,2021-03-23,28,7913,1,794,27,6707,0,412,14,3347,14,2483,14,5830,California
Plumas,2021-03-24,700,8613,5,799,694,7401,1,413,233,3116,466,2949,235,6065,California
Plumas,2021-03-25,324,8937,8,807,314,7715,2,415,179,3150,145,3094,179,6244,California
Plumas,2021-03-26,315,9252,9,816,305,8020,1,416,46,2929,268,3362,47,6291,California
Plumas,2021-03-27,15,9267,1,817,13,8033,1,417,4,2923,11,3373,5,6296,California
Plumas,2021-03-28,10,9277,3,820,6,8039,1,418,3,2920,7,3380,4,6300,California
Plumas,2021-03-29,10,9287,3,823,6,8045,1,419,3,2917,7,3387,4,6304,California
Plumas,2021-03-30,182,9469,4,827,174,8219,4,423,26,2791,156,3543,30,6334,California
Plumas,2021-03-31,300,9769,3,830,295,8514,2,425,275,3043,25,3568,277,6611,California
Plumas,2021-04-01,321,10090,14,844,304,8818,3,428,68,2863,250,3818,70,6681,California
Plumas,2021-04-02,375,10465,3,847,368,9186,4,432,29,2562,334,4152,33,6714,California
Plumas,2021-04-03,15,10480,3,850,6,9192,6,438,1,2555,14,4166,7,6721,California
Plumas,2021-04-04,3,10483,1,851,1,9193,1,439,0,2553,3,4169,1,6722,California
Plumas,2021-04-05,18,10501,6,857,10,9203,2,441,5,2548,12,4181,7,6729,California
Plumas,2021-04-06,138,10639,7,864,103,9306,28,469,17,2472,120,4301,44,6773,California
Plumas,2021-04-07,297,10936,10,874,101,9407,186,655,29,2419,268,4569,215,6988,California
Plumas,2021-04-08,158,11094,4,878,134,9541,20,675,40,2360,118,4687,59,7047,California
Plumas,2021-04-09,50,11144,9,887,24,9565,17,692,18,2362,32,4719,34,7081,California
Plumas,2021-04-10,22,11166,1,888,4,9569,17,709,4,2364,18,4737,20,7101,California
Plumas,2021-04-11,5,11171,3,891,1,9570,1,710,3,2367,1,4738,4,7105,California
Plumas,2021-04-12,12,11183,3,894,6,9576,3,713,5,2369,6,4744,8,7113,California
Plumas,2021-04-13,221,11404,3,897,218,9794,0,713,154,2456,67,4811,154,7267,California
Plumas,2021-04-14,108,11512,6,903,102,9896,0,713,54,2457,53,4864,54,7321,California
Plumas,2021-04-15,55,11567,4,907,51,9947,0,713,34,2471,20,4884,34,7355,California
Plumas,2021-04-16,144,11711,3,910,141,10088,0,713,4,2335,140,5024,4,7359,California
Plumas,2021-04-17,689,12400,2,912,687,10775,0,713,18,1688,665,5689,18,7377,California
Plumas,2021-04-18,4,12404,3,915,1,10776,0,713,1,1686,3,5692,1,7378,California
Plumas,2021-04-19,38,12442,1,916,37,10813,0,713,4,1657,34,5726,5,7383,California
Plumas,2021-04-20,48,12490,5,921,43,10856,0,713,30,1671,17,5743,31,7414,California
Plumas,2021-04-21,345,12835,6,927,338,11194,1,714,15,1356,330,6073,15,7429,California
Plumas,2021-04-22,285,13120,7,934,278,11472,0,714,132,1335,153,6226,132,7561,California
Plumas,2021-04-23,73,13193,3,937,70,11542,0,714,16,1294,57,6283,16,7577,California
Plumas,2021-04-24,171,13364,4,941,167,11709,0,714,145,1414,25,6308,145,7722,California
Plumas,2021-04-26,31,13395,3,944,28,11737,0,714,8,1400,22,6330,8,7730,California
Plumas,2021-04-27,111,13506,4,948,107,11844,0,714,70,1429,41,6371,70,7800,California
Plumas,2021-04-28,287,13793,5,953,282,12126,0,714,34,1213,250,6621,34,7834,California
Plumas,2021-04-29,180,13973,72,1025,108,12234,0,714,124,1281,56,6677,124,7958,California
Plumas,2021-04-30,23,13996,12,1037,11,12245,0,714,8,1274,15,6692,8,7966,California
Plumas,2021-05-01,12,14008,4,1041,7,12252,1,715,4,1273,6,6698,5,7971,California
Plumas,2021-05-02,4,14012,4,1045,0,12252,0,715,2,1273,2,6700,2,7973,California
Plumas,2021-05-03,20,14032,5,1050,8,12260,7,722,6,1274,12,6712,13,7986,California
Plumas,2021-05-04,33,14065,5,1055,20,12280,8,730,18,1286,14,6726,26,8012,California
Plumas,2021-05-05,53,14118,3,1058,49,12329,1,731,26,1287,26,6752,27,8039,California
Plumas,2021-05-06,70,14188,3,1061,62,12391,5,736,20,1262,50,6802,25,8064,California
Plumas,2021-05-07,23,14211,6,1067,16,12407,1,737,8,1256,15,6817,9,8073,California
Plumas,2021-05-08,7,14218,0,1067,4,12411,3,740,4,1260,3,6820,7,8080,California
Plumas,2021-05-09,1,14219,0,1067,0,12411,1,741,0,1260,1,6821,1,8081,California
Plumas,2021-05-10,50,14269,0,1067,28,12439,22,763,24,1280,26,6847,46,8127,California
Plumas,2021-05-11,180,14449,2,1069,160,12599,18,781,15,1150,163,7010,33,8160,California
Plumas,2021-05-12,101,14550,1,1070,92,12691,8,789,37,1132,63,7073,45,8205,California
Plumas,2021-05-13,45,14595,3,1073,40,12731,2,791,14,1117,31,7104,16,8221,California
Plumas,2021-05-14,21,14616,3,1076,13,12744,5,796,10,1121,11,7115,15,8236,California
Plumas,2021-05-15,13,14629,4,1080,5,12749,4,800,4,1120,8,7123,7,8243,California
Plumas,2021-05-16,2,14631,1,1081,1,12750,0,800,1,1120,1,7124,1,8244,California
Plumas,2021-05-17,15,14646,0,1081,6,12756,9,809,5,1124,10,7134,14,8258,California
Plumas,2021-05-18,49,14695,8,1089,40,12796,1,810,27,1130,22,7156,28,8286,California
Plumas,2021-05-19,52,14747,4,1093,30,12826,18,828,12,1121,39,7195,30,8316,California
Plumas,2021-05-20,198,14945,141,1234,46,12872,11,839,82,1100,114,7309,93,8409,California
Plumas,2021-05-21,32,14977,11,1245,14,12886,7,846,14,1103,18,7327,21,8430,California
Plumas,2021-05-22,139,15116,1,1246,138,13024,0,846,7,980,130,7457,7,8437,California
Plumas,2021-05-23,2,15118,2,1248,0,13024,0,846,0,978,2,7459,0,8437,California
Plumas,2021-05-24,49,15167,35,1283,13,13037,1,847,40,1011,8,7467,41,8478,California
Plumas,2021-05-25,84,15251,3,1286,80,13117,1,848,18,964,66,7533,19,8497,California
Plumas,2021-05-26,42,15293,6,1292,28,13145,8,856,17,965,24,7557,25,8522,California
Plumas,2021-05-27,102,15395,26,1318,62,13207,14,870,42,962,59,7616,56,8578,California
Plumas,2021-05-28,43,15438,16,1334,25,13232,2,872,21,964,21,7637,23,8601,California
Plumas,2021-05-29,10,15448,1,1335,9,13241,0,872,6,969,2,7639,7,8608,California
Plumas,2021-05-30,1,15449,0,1335,1,13242,0,872,0,969,0,7639,0,8608,California
Plumas,2021-05-31,7,15456,0,1335,4,13246,3,875,0,967,5,7644,3,8611,California
Plumas,2021-06-01,34,15490,9,1344,19,13265,6,881,9,958,25,7669,16,8627,California
Plumas,2021-06-02,66,15556,5,1349,38,13303,23,904,11,937,55,7724,34,8661,California
Plumas,2021-06-03,68,15624,18,1367,40,13343,10,914,29,937,39,7763,39,8700,California
Plumas,2021-06-04,15,15639,3,1370,11,13354,1,915,8,941,5,7768,9,8709,California
Plumas,2021-06-05,7,15646,3,1373,4,13358,0,915,2,938,5,7773,2,8711,California
Plumas,2021-06-06,3,15649,1,1374,2,13360,0,915,0,935,3,7776,0,8711,California
Plumas,2021-06-07,38,15687,5,1379,25,13385,8,923,9,923,29,7805,17,8728,California
Plumas,2021-06-08,32,15719,9,1388,21,13406,2,925,9,911,23,7828,11,8739,California
Plumas,2021-06-09,43,15762,6,1394,34,13440,3,928,10,891,33,7861,13,8752,California
Plumas,2021-06-10,39,15801,15,1409,20,13460,4,932,14,886,23,7884,18,8770,California
Plumas,2021-06-11,26,15827,14,1423,9,13469,3,935,8,879,18,7902,11,8781,California
Plumas,2021-06-12,11,15838,3,1426,7,13476,1,936,6,881,5,7907,7,8788,California
Plumas,2021-06-13,3,15841,1,1427,2,13478,0,936,3,884,0,7907,3,8791,California
Plumas,2021-06-14,100,15941,90,1517,7,13485,3,939,11,810,88,7995,14,8805,California
Plumas,2021-06-15,30,15971,7,1524,21,13506,2,941,9,800,21,8016,11,8816,California
Plumas,2021-06-16,33,16004,11,1535,13,13519,9,950,9,794,24,8040,18,8834,California
Plumas,2021-06-17,51,16055,32,1567,15,13534,4,954,12,774,36,8076,16,8850,California
Plumas,2021-06-18,39,16094,17,1584,14,13548,8,962,13,768,26,8102,20,8870,California
Plumas,2021-06-19,9,16103,2,1586,7,13555,0,962,2,763,7,8109,2,8872,California
Plumas,2021-06-20,2,16105,1,1587,0,13555,1,963,1,764,1,8110,2,8874,California
Plumas,2021-06-21,10,16115,5,1592,4,13559,1,964,6,767,4,8114,7,8881,California
Plumas,2021-06-22,32,16147,13,1605,17,13576,2,966,12,761,20,8134,14,8895,California
Plumas,2021-06-23,30,16177,16,1621,10,13586,4,970,16,768,13,8147,20,8915,California
Plumas,2021-06-24,33,16210,21,1642,8,13594,4,974,15,769,17,8164,18,8933,California
Plumas,2021-06-25,22,16232,9,1651,11,13605,2,976,8,767,12,8176,10,8943,California
Plumas,2021-06-26,14,16246,4,1655,8,13613,2,978,3,761,11,8187,5,8948,California
Plumas,2021-06-28,12,16258,5,1660,3,13616,4,982,2,758,9,8196,6,8954,California
Plumas,2021-06-29,24,16282,16,1676,7,13623,1,983,11,757,13,8209,12,8966,California
Plumas,2021-06-30,23,16305,9,1685,10,13633,4,987,9,756,14,8223,13,8979,California
Plumas,2021-07-01,46,16351,30,1715,12,13645,4,991,23,760,23,8246,27,9006,California
Plumas,2021-07-02,18,16369,13,1728,4,13649,1,992,4,751,13,8259,4,9010,California
Plumas,2021-07-03,1,16370,0,1728,1,13650,0,992,1,752,0,8259,1,9011,California
Plumas,2021-07-06,33,16403,17,1745,13,13663,3,995,11,743,22,8281,13,9024,California
Plumas,2021-07-07,24,16427,15,1760,8,13671,1,996,12,744,12,8293,13,9037,California
Plumas,2021-07-08,31,16458,9,1769,12,13683,10,1006,13,749,18,8311,23,9060,California
Plumas,2021-07-09,15,16473,10,1779,2,13685,3,1009,7,751,8,8319,10,9070,California
Plumas,2021-07-10,9,16482,1,1780,7,13692,1,1010,2,747,7,8326,3,9073,California
Plumas,2021-07-11,3,16485,1,1781,2,13694,0,1010,2,748,1,8327,2,9075,California
Plumas,2021-07-12,8,16493,5,1786,3,13697,0,1010,4,748,4,8331,4,9079,California
Plumas,2021-07-13,23,16516,14,1800,7,13704,2,1012,12,751,11,8342,14,9093,California
Plumas,2021-07-14,33,16549,18,1818,11,13715,4,1016,15,753,17,8359,19,9112,California
Plumas,2021-07-15,40,16589,28,1846,11,13726,1,1017,23,761,17,8376,25,9137,California
Plumas,2021-07-16,29,16618,13,1859,14,13740,2,1019,12,758,17,8393,14,9151,California
Plumas,2021-07-17,7,16625,4,1863,3,13743,0,1019,2,755,5,8398,2,9153,California
Plumas,2021-07-19,7,16632,3,1866,3,13746,1,1020,2,753,5,8403,3,9156,California
Plumas,2021-07-20,38,16670,21,1887,11,13757,6,1026,10,741,28,8431,16,9172,California
Plumas,2021-07-21,19,16689,12,1899,1,13758,6,1032,11,750,8,8439,17,9189,California
Plumas,2021-07-22,36,16725,26,1925,7,13765,3,1035,12,741,24,8463,15,9204,California
Plumas,2021-07-23,14,16739,9,1934,5,13770,0,1035,8,743,6,8469,8,9212,California
Plumas,2021-07-24,3,16742,0,1934,3,13773,0,1035,2,744,1,8470,2,9214,California
Plumas,2021-07-26,8,16750,6,1940,0,13773,2,1037,6,750,2,8472,8,9222,California
Plumas,2021-07-27,21,16771,14,1954,6,13779,1,1038,12,754,9,8481,13,9235,California
Plumas,2021-07-28,19,16790,9,1963,8,13787,2,1040,7,751,12,8493,9,9244,California
Plumas,2021-07-29,29,16819,14,1977,11,13798,4,1044,14,755,14,8507,18,9262,California
Plumas,2021-07-30,35,16854,22,1999,6,13804,7,1051,21,770,12,8519,27,9289,California
Plumas,2021-07-31,7,16861,2,2001,4,13808,1,1052,5,774,2,8521,6,9295,California
Plumas,2021-08-01,4,16865,2,2003,1,13809,1,1053,3,777,1,8522,4,9299,California
Plumas,2021-08-02,11,16876,5,2008,5,13814,1,1054,4,775,7,8529,5,9304,California
Plumas,2021-08-03,18,16894,7,2015,10,13824,1,1055,14,786,4,8533,15,9319,California
Plumas,2021-08-04,36,16930,19,2034,11,13835,6,1061,22,802,12,8545,28,9347,California
Plumas,2021-08-05,41,16971,23,2057,12,13847,6,1067,14,796,26,8571,20,9367,California
Plumas,2021-08-06,30,17001,21,2078,6,13853,3,1070,17,804,12,8583,20,9387,California
Plumas,2021-08-07,13,17014,9,2087,4,13857,0,1070,12,815,1,8584,12,9399,California
Plumas,2021-08-08,4,17018,4,2091,0,13857,0,1070,4,819,0,8584,4,9403,California
Plumas,2021-08-09,16,17034,10,2101,4,13861,2,1072,12,830,3,8587,14,9417,California
Plumas,2021-08-10,27,17061,16,2117,6,13867,5,1077,13,834,14,8601,18,9435,California
Plumas,2021-08-11,33,17094,20,2137,10,13877,3,1080,23,850,10,8611,26,9461,California
Plumas,2021-08-12,45,17139,21,2158,21,13898,3,1083,29,867,15,8626,32,9493,California
Plumas,2021-08-13,32,17171,18,2176,9,13907,5,1088,19,878,13,8639,24,9517,California
Plumas,2021-08-14,8,17179,3,2179,5,13912,0,1088,6,883,1,8640,6,9523,California
Plumas,2021-08-15,1,17180,1,2180,0,13912,0,1088,1,884,0,8640,1,9524,California
Plumas,2021-08-16,19,17199,9,2189,9,13921,1,1089,11,890,6,8646,12,9536,California
Plumas,2021-08-17,24,17223,16,2205,6,13927,2,1091,9,886,15,8661,11,9547,California
Plumas,2021-08-18,17,17240,8,2213,8,13935,1,1092,11,896,2,8663,12,9559,California
Plumas,2021-08-19,28,17268,12,2225,13,13948,3,1095,17,906,10,8673,20,9579,California
Plumas,2021-08-20,19,17287,13,2238,4,13952,2,1097,5,900,13,8686,7,9586,California
Plumas,2021-08-21,2,17289,0,2238,2,13954,0,1097,1,901,0,8686,1,9587,California
Plumas,2021-08-22,5,17294,1,2239,4,13958,0,1097,5,906,0,8686,5,9592,California
Plumas,2021-08-23,18,17312,12,2251,1,13959,5,1102,12,917,6,8692,17,9609,California
Plumas,2021-08-24,14,17326,9,2260,4,13963,1,1103,5,914,9,8701,6,9615,California
Plumas,2021-08-25,38,17364,26,2286,12,13975,0,1103,21,919,16,8717,21,9636,California
Plumas,2021-08-26,47,17411,27,2313,13,13988,7,1110,24,929,21,8738,31,9667,California
Plumas,2021-08-27,45,17456,32,2345,9,13997,4,1114,18,927,24,8762,22,9689,California
Plumas,2021-08-28,10,17466,8,2353,2,13999,0,1114,1,924,4,8766,1,9690,California
Plumas,2021-08-29,4,17470,4,2357,0,13999,0,1114,3,926,1,8767,3,9693,California
Plumas,2021-08-30,12,17482,4,2361,6,14005,2,1116,5,927,6,8773,7,9700,California
Riverside,2020-12-15,8,8,8,8,0,0,0,0,8,8,0,0,8,8,California
Riverside,2020-12-16,101,109,101,109,0,0,0,0,101,109,0,0,101,109,California
Riverside,2020-12-17,880,989,880,989,0,0,0,0,879,988,0,0,879,988,California
Riverside,2020-12-18,1858,2847,1855,2844,3,3,0,0,1858,2846,0,0,1858,2846,California
Riverside,2020-12-19,1081,3928,1078,3922,3,6,0,0,1079,3924,1,1,1079,3925,California
Riverside,2020-12-20,1134,5062,1131,5053,3,9,0,0,1134,5058,0,1,1134,5059,California
Riverside,2020-12-21,2392,7454,2391,7444,1,10,0,0,2391,7449,0,1,2391,7450,California
Riverside,2020-12-22,2368,9822,2315,9759,53,63,0,0,2368,9817,0,1,2368,9818,California
Riverside,2020-12-23,2211,12033,1842,11601,369,432,0,0,2211,12028,0,1,2211,12029,California
Riverside,2020-12-24,866,12899,656,12257,210,642,0,0,865,12893,0,1,865,12894,California
Riverside,2020-12-25,43,12942,19,12276,24,666,0,0,42,12935,0,1,42,12936,California
Riverside,2020-12-26,506,13448,282,12558,224,890,0,0,506,13441,0,1,506,13442,California
Riverside,2020-12-27,400,13848,270,12828,130,1020,0,0,399,13839,1,2,399,13841,California
Riverside,2020-12-28,1756,15604,1212,14040,544,1564,0,0,1757,15596,0,2,1757,15598,California
Riverside,2020-12-29,1885,17489,1079,15119,806,2370,0,0,1885,17481,0,2,1885,17483,California
Riverside,2020-12-30,2723,20212,1761,16880,962,3332,0,0,2722,20202,1,3,2722,20205,California
Riverside,2020-12-31,1102,21314,432,17312,670,4002,0,0,1103,21304,1,4,1103,21308,California
Riverside,2021-01-01,154,21468,66,17378,88,4090,0,0,154,21458,0,4,154,21462,California
Riverside,2021-01-02,939,22407,729,18107,210,4300,0,0,939,22397,0,4,939,22401,California
Riverside,2021-01-03,370,22777,312,18419,58,4358,0,0,369,22766,0,4,369,22770,California
Riverside,2021-01-04,1348,24125,830,19249,518,4876,0,0,1345,24109,2,6,1345,24115,California
Riverside,2021-01-05,2118,26243,1447,20696,671,5547,0,0,1991,25980,121,127,1992,26107,California
Riverside,2021-01-06,2642,28885,1181,21877,1461,7008,0,0,2289,27924,345,472,2289,28396,California
Riverside,2021-01-07,2992,31877,1946,23823,1046,8054,0,0,1830,28602,1154,1626,1832,30228,California
Riverside,2021-01-08,4282,36159,3077,26900,1205,9259,0,0,2332,28991,1944,3570,2333,32561,California
Riverside,2021-01-09,2181,38340,895,27795,1286,10545,0,0,1798,30410,381,3951,1800,34361,California
Riverside,2021-01-10,1723,40063,757,28552,966,11511,0,0,1103,30893,620,4571,1103,35464,California
Riverside,2021-01-11,4739,44802,3246,31798,1493,13004,0,0,2888,31934,1850,6421,2891,38355,California
Riverside,2021-01-12,3633,48435,2863,34661,770,13774,0,0,1857,32027,1771,8192,1864,40219,California
Riverside,2021-01-13,4673,53108,3067,37728,1606,15380,0,0,3001,33361,1667,9859,3001,43220,California
Riverside,2021-01-14,5869,58977,2098,39826,3771,19151,0,0,5241,37978,626,10485,5243,48463,California
Riverside,2021-01-15,6351,65328,2134,41960,4217,23368,0,0,6001,43634,347,10832,6003,54466,California
Riverside,2021-01-16,3762,69090,1059,43019,2703,26071,0,0,3488,46849,274,11106,3489,57955,California
Riverside,2021-01-17,3673,72763,620,43639,3053,29124,0,0,3463,50103,209,11315,3463,61418,California
Riverside,2021-01-18,3945,76708,2162,45801,1783,30907,0,0,2872,51904,1072,12387,2873,64291,California
Riverside,2021-01-19,7639,84347,2775,48576,4864,35771,0,0,6439,57152,1197,13584,6445,70736,California
Riverside,2021-01-20,8605,92952,3345,51921,5260,41031,0,0,6872,62313,1718,15302,6879,77615,California
Riverside,2021-01-21,8631,101583,3616,55537,5015,46046,0,0,7909,69504,720,16022,7911,85526,California
Riverside,2021-01-22,9071,110654,3097,58634,5974,52020,0,0,8576,77590,492,16514,8578,94104,California
Riverside,2021-01-23,6127,116781,2401,61035,3726,55746,0,0,5295,82059,829,17343,5298,99402,California
Riverside,2021-01-24,3126,119907,1453,62488,1673,57419,0,0,2894,84726,228,17571,2895,102297,California
Riverside,2021-01-25,8100,128007,4623,67111,3477,60896,0,0,6893,90420,1203,18774,6897,109194,California
Riverside,2021-01-26,9325,137332,5766,72877,3559,64455,0,0,7723,96546,1599,20373,7725,116919,California
Riverside,2021-01-27,11221,148553,6454,79331,4767,69222,0,0,9543,104419,1674,22047,9547,126466,California
Riverside,2021-01-28,11823,160376,6854,86185,4969,74191,0,0,10592,113791,1223,23270,10595,137061,California
Riverside,2021-01-29,12145,172521,7313,93498,4832,79023,0,0,10724,123123,1397,24667,10729,147790,California
Riverside,2021-01-30,9166,181687,4547,98045,4619,83642,0,0,8634,131232,528,25195,8637,156427,California
Riverside,2021-01-31,5345,187032,4352,102397,993,84635,0,0,5194,136282,148,25343,5198,161625,California
Riverside,2021-02-01,11665,198697,7238,109635,4427,89062,0,0,9594,143825,2059,27402,9602,171227,California
Riverside,2021-02-02,9959,208656,5073,114708,4886,93948,0,0,8374,150635,1571,28973,8381,179608,California
Riverside,2021-02-03,12649,221305,5382,120090,7267,101215,0,0,10119,158240,2518,31491,10123,189731,California
Riverside,2021-02-04,13868,235173,6071,126161,7797,109012,0,0,11614,167625,2245,33736,11630,201361,California
Riverside,2021-02-05,14793,249966,5550,131711,9243,118255,0,0,11493,175840,3289,37025,11504,212865,California
Riverside,2021-02-06,7416,257382,4293,136004,3123,121378,0,0,5721,179884,1682,38707,5726,218591,California
Riverside,2021-02-07,2255,259637,825,136829,1430,122808,0,0,1900,181436,354,39061,1906,220497,California
Riverside,2021-02-08,12738,272375,5637,142466,7101,129909,0,0,10285,189300,2436,41497,10300,230797,California
Riverside,2021-02-09,10020,282395,4720,147186,5300,135209,0,0,7903,195120,2109,43606,7929,238726,California
Riverside,2021-02-10,12552,294947,7219,154405,5333,140542,0,0,9168,200938,3369,46975,9187,247913,California
Riverside,2021-02-11,17075,312022,9176,163581,7899,148441,0,0,12325,208575,4729,51704,12366,260279,California
Riverside,2021-02-12,18131,330153,10905,174486,7226,155667,0,0,12959,216433,5129,56833,12987,273266,California
Riverside,2021-02-13,6553,336706,2222,176708,4331,159998,0,0,3185,216294,3355,60188,3216,276482,California
Riverside,2021-02-14,5089,341795,1204,177912,3885,163883,0,0,2285,215799,2798,62986,2303,278785,California
Riverside,2021-02-15,10111,351906,5110,183022,5001,168884,0,0,5606,216945,4481,67467,5627,284412,California
Riverside,2021-02-16,16512,368418,10282,193304,6230,175114,0,0,9474,219429,7020,74487,9504,293916,California
Riverside,2021-02-17,15492,383910,8471,201775,7021,182135,0,0,7657,219330,7818,82305,7719,301635,California
Riverside,2021-02-18,15933,399843,9138,210913,6795,188930,0,0,8174,219819,7732,90037,8221,309856,California
Riverside,2021-02-19,15804,415647,8454,219367,7350,196280,0,0,7450,218980,8320,98357,7481,317337,California
Riverside,2021-02-20,8654,424301,4652,224019,4002,200282,0,0,2286,214951,6339,104696,2310,319647,California
Riverside,2021-02-21,4670,428971,4098,228117,572,200854,0,0,1285,212890,3359,108055,1298,320945,California
Riverside,2021-02-22,13198,442169,8314,236431,4884,205738,0,0,5181,210106,7982,116037,5198,326143,California
Riverside,2021-02-23,12188,454357,8287,244718,3901,209639,0,0,5878,209747,6271,122308,5912,332055,California
Riverside,2021-02-24,15883,470240,8740,253458,7143,216782,0,0,6681,207349,9150,131458,6752,338807,California
Riverside,2021-02-25,18434,488674,7956,261414,10478,227260,0,0,8456,205943,9938,141396,8532,347339,California
Riverside,2021-02-26,19800,508474,7184,268598,12616,239876,0,0,9826,205956,9901,151297,9914,357253,California
Riverside,2021-02-27,12872,521346,5953,274551,6919,246795,0,0,6081,205354,6748,158045,6146,363399,California
Riverside,2021-02-28,5274,526620,3477,278028,1797,248592,0,0,2583,205306,2667,160712,2619,366018,California
Riverside,2021-03-01,15012,541632,6397,284425,8606,257198,9,9,8818,208065,6138,166850,8897,374915,California
Riverside,2021-03-02,16222,557854,7969,292394,8250,265448,3,12,9411,210782,6773,173623,9490,384405,California
Riverside,2021-03-03,17801,575655,8836,301230,8961,274409,4,16,7713,208656,10025,183648,7899,392304,California
Riverside,2021-03-04,19373,595028,7742,308972,11627,286036,4,20,9177,207916,10142,193790,9402,401706,California
Riverside,2021-03-05,19471,614499,7858,316830,11558,297594,55,75,9557,208014,9854,203644,9952,411658,California
Riverside,2021-03-06,9869,624368,5225,322055,4157,301751,487,562,4850,208397,5003,208647,5386,417044,California
Riverside,2021-03-07,4546,628914,2844,324899,1235,302986,467,1029,2100,208564,2433,211080,2600,419644,California
Riverside,2021-03-08,12293,641207,4890,329789,6967,309953,436,1465,5480,207779,6789,217869,6004,425648,California
Riverside,2021-03-09,15153,656360,7065,336854,7566,317519,522,1987,5986,205313,9136,227005,6670,432318,California
Riverside,2021-03-10,16443,672803,8775,345629,6696,324215,972,2959,6378,202840,10015,237020,7542,439860,California
Riverside,2021-03-11,19765,692568,9689,355318,8194,332409,1882,4841,7697,200626,12019,249039,9805,449665,California
Riverside,2021-03-12,21474,714042,8035,363353,8668,341077,4771,9612,7079,198447,14348,263387,12169,461834,California
Riverside,2021-03-13,8748,722790,2594,365947,4894,345971,1260,10872,4432,199959,4283,267670,5795,467629,California
Riverside,2021-03-14,4888,727678,1674,367621,1847,347818,1367,12239,2133,200722,2738,270408,3501,471130,California
Riverside,2021-03-15,18916,746594,7963,375584,9276,357094,1677,13916,9176,202005,9686,280094,10969,482099,California
Riverside,2021-03-16,21227,767821,10327,385911,10081,367175,819,14735,11362,204502,9816,289910,12313,494412,California
Riverside,2021-03-17,21936,789757,11306,397217,9553,376728,1077,15812,13113,209998,8762,298672,14258,508670,California
Riverside,2021-03-18,23462,813219,12154,409371,9605,386333,1703,17515,12771,213874,10626,309298,14502,523172,California
Riverside,2021-03-19,24576,837795,12880,422251,10701,397034,995,18510,14147,219021,10359,319657,15506,538678,California
Riverside,2021-03-20,11085,848880,6990,429241,2875,399909,1220,19730,6969,223141,4071,323728,8191,546869,California
Riverside,2021-03-21,3978,852858,3053,432294,642,400551,283,20013,2606,224689,1345,325073,2893,549762,California
Riverside,2021-03-22,16853,869711,10055,442349,6243,406794,555,20568,10542,229539,6249,331322,11099,560861,California
Riverside,2021-03-23,18908,888619,10697,453046,7790,414584,421,20989,11897,234946,6941,338263,12348,573209,California
Riverside,2021-03-24,19114,907733,10672,463718,8316,422900,126,21115,12885,241817,6166,344429,13037,586246,California
Riverside,2021-03-25,21553,929286,11925,475643,9446,432346,182,21297,14243,249045,7222,351651,14450,600696,California
Riverside,2021-03-26,24485,953771,12103,487746,12218,444564,164,21461,14948,254745,9425,361076,15125,615821,California
Riverside,2021-03-27,9545,963316,5009,492755,3482,448046,1054,22515,4857,256012,4652,365728,5919,621740,California
Riverside,2021-03-28,4897,968213,3200,495955,1598,449644,99,22614,2861,256956,2021,367749,2965,624705,California
Riverside,2021-03-29,17922,986135,8563,504518,9230,458874,129,22743,10857,260972,7009,374758,11025,635730,California
Riverside,2021-03-30,18598,1004733,9677,514195,8704,467578,217,22960,11697,266042,6851,381609,11921,647651,California
Riverside,2021-03-31,18460,1023193,8578,522773,9548,477126,334,23294,11394,270777,7006,388615,11741,659392,California
Riverside,2021-04-01,25922,1049115,12652,535425,12456,489582,814,24108,16537,278845,9285,397900,17353,676745,California
Riverside,2021-04-02,26485,1075600,14194,549619,11294,500876,997,25105,16443,286533,9969,407869,17657,694402,California
Riverside,2021-04-03,9516,1085116,6023,555642,2870,503746,623,25728,6088,289842,3403,411272,6712,701114,California
Riverside,2021-04-04,3471,1088587,2079,557721,1121,504867,271,25999,1728,290114,1727,412999,1999,703113,California
Riverside,2021-04-05,18772,1107359,9541,567262,7314,512181,1917,27916,10008,293335,8715,421714,11936,715049,California
Riverside,2021-04-06,24074,1131433,12483,579745,9393,521574,2198,30114,13350,298207,10665,432379,15537,730586,California
Riverside,2021-04-07,25204,1156637,13545,593290,9098,530672,2561,32675,13888,303396,11256,443635,16445,747031,California
Riverside,2021-04-08,27779,1184416,15278,608568,9435,540107,3066,35741,16785,312320,10912,454547,19836,766867,California
Riverside,2021-04-09,26754,1211170,15628,624196,8580,548687,2546,38287,16231,320666,10458,465005,18804,785671,California
Riverside,2021-04-10,12269,1223439,6811,631007,4025,552712,1433,39720,5387,320639,6836,471841,6809,792480,California
Riverside,2021-04-11,4740,1228179,2811,633818,1291,554003,638,40358,2224,321004,2501,474342,2866,795346,California
Riverside,2021-04-12,20574,1248753,9211,643029,8668,562671,2695,43053,10288,323756,10237,484579,12989,808335,California
Riverside,2021-04-13,20330,1269083,11364,654393,8938,571609,28,43081,11593,326697,8692,493271,11633,819968,California
Riverside,2021-04-14,22632,1291715,12447,666840,10166,581775,19,43100,11050,326290,11500,504771,11093,831061,California
Riverside,2021-04-15,22429,1314144,12681,679521,9738,591513,10,43110,11704,327368,10651,515422,11729,842790,California
Riverside,2021-04-16,25587,1339731,14728,694249,10851,602364,8,43118,11795,325472,13720,529142,11824,854614,California
Riverside,2021-04-17,10030,1349761,6644,700893,3386,605750,0,43118,4980,325446,5018,534160,4992,859606,California
Riverside,2021-04-18,4270,1354031,3166,704059,1097,606847,7,43125,1957,325127,2295,536455,1976,861582,California
Riverside,2021-04-19,19750,1373781,11707,715766,8040,614887,3,43128,7016,319485,12679,549134,7037,868619,California
Riverside,2021-04-20,19731,1393512,10608,726374,9114,624001,9,43137,7983,315805,11688,560822,8008,876627,California
Riverside,2021-04-21,20978,1414490,12343,738717,8624,632625,11,43148,8315,311571,12576,573398,8342,884969,California
Riverside,2021-04-22,24205,1438695,14346,753063,9853,642478,6,43154,9040,305552,15084,588482,9065,894034,California
Riverside,2021-04-23,24280,1462975,14414,767477,9851,652329,15,43169,9489,300369,14716,603198,9533,903567,California
Riverside,2021-04-24,10748,1473723,7426,774903,3313,655642,9,43178,4926,299541,5775,608973,4947,908514,California
Riverside,2021-04-25,4297,1478020,2886,777789,1404,657046,7,43185,2217,299708,2059,611032,2226,910740,California
Riverside,2021-04-26,17672,1495692,11082,788871,6531,663577,59,43244,6020,294207,11603,622635,6102,916842,California
Riverside,2021-04-27,18833,1514525,10812,799683,7811,671388,210,43454,6583,288819,12195,634830,6807,923649,California
Riverside,2021-04-28,17194,1531719,9371,809054,7553,678941,270,43724,5857,283699,11257,646087,6137,929786,California
Riverside,2021-04-29,19519,1551238,12017,821071,7146,686087,356,44080,5690,276007,13746,659833,6054,935840,California
Riverside,2021-04-30,20804,1572042,12044,833115,8363,694450,397,44477,6825,269324,13908,673741,7225,943065,California
Riverside,2021-05-01,7027,1579069,5007,838122,1832,696282,188,44665,2413,267348,4579,678320,2603,945668,California
Riverside,2021-05-02,3395,1582464,2277,840399,906,697188,212,44877,1115,266429,2259,680579,1340,947008,California
Riverside,2021-05-03,18369,1600833,11307,851706,6562,703750,500,45377,4280,257207,14007,694586,4785,951793,California
Riverside,2021-05-04,17959,1618792,11467,863173,6021,709771,471,45848,5067,249950,12809,707395,5552,957345,California
Riverside,2021-05-05,16615,1635407,9576,872749,6661,716432,378,46226,4791,243391,11759,719154,5200,962545,California
Riverside,2021-05-06,18600,1654007,10581,883330,7601,724033,418,46644,4770,234884,13738,732892,5231,967776,California
Riverside,2021-05-07,21111,1675118,12066,895396,8592,732625,453,47097,5639,225605,15379,748271,6100,973876,California
Riverside,2021-05-08,7226,1682344,4779,900175,2178,734803,269,47366,2693,224081,4497,752768,2973,976849,California
Riverside,2021-05-09,2522,1684866,1714,901889,649,735452,159,47525,930,223596,1583,754351,1098,977947,California
Riverside,2021-05-10,10391,1695257,5355,907244,4634,740086,402,47927,2940,219553,7392,761743,3349,981296,California
Riverside,2021-05-11,14607,1709864,8938,916182,5143,745229,526,48453,4087,213761,10428,772171,4636,985932,California
Riverside,2021-05-12,13316,1723180,6816,922998,6158,751387,342,48795,4007,208863,9250,781421,4352,990284,California
Riverside,2021-05-13,15510,1738690,9482,932480,5743,757130,285,49080,5517,204747,9936,791357,5820,996104,California
Riverside,2021-05-14,18695,1757385,11832,944312,6063,763193,800,49880,7289,201510,11328,802685,8091,1004195,California
Riverside,2021-05-15,10126,1767511,7271,951583,2448,765641,407,50287,5211,202260,4873,807558,5623,1009818,California
Riverside,2021-05-16,3749,1771260,2786,954369,846,766487,117,50404,1865,202377,1865,809423,1982,1011800,California
Riverside,2021-05-17,11991,1783251,7685,962054,3946,770433,360,50764,5190,201169,6767,816190,5559,1017359,California
Riverside,2021-05-18,15373,1798624,9555,971609,5461,775894,357,51121,6224,198654,9100,825290,6585,1023944,California
Riverside,2021-05-19,12382,1811006,7818,979427,4317,780211,247,51368,5945,198472,6380,831670,6198,1030142,California
Riverside,2021-05-20,12182,1823188,7646,987073,4274,784485,262,51630,5416,197437,6716,838386,5681,1035823,California
Riverside,2021-05-21,14751,1837939,9081,996154,5338,789823,332,51962,6179,195462,8492,846878,6517,1042340,California
Riverside,2021-05-22,7342,1845281,5001,1001155,2138,791961,203,52165,3923,196226,3366,850244,4130,1046470,California
Riverside,2021-05-23,2763,1848044,1871,1003026,815,792776,77,52242,1310,196180,1436,851680,1390,1047860,California
Riverside,2021-05-24,9117,1857161,5943,1008969,2858,795634,316,52558,4058,195535,5023,856703,4378,1052238,California
Riverside,2021-05-25,9957,1867118,5927,1014896,3748,799382,282,52840,3979,193867,5932,862635,4264,1056502,California
Riverside,2021-05-26,9054,1876172,5610,1020506,3111,802493,333,53173,3954,193115,5044,867679,4292,1060794,California
Riverside,2021-05-27,8684,1884856,5209,1025715,3234,805727,241,53414,3926,192589,4699,872378,4173,1064967,California
Riverside,2021-05-28,11023,1895879,6674,1032389,4029,809756,320,53734,5054,192071,5904,878282,5386,1070353,California
Riverside,2021-05-29,5095,1900974,3487,1035876,1477,811233,131,53865,2846,192837,2215,880497,2981,1073334,California
Riverside,2021-05-30,2010,1902984,1442,1037318,497,811730,71,53936,1031,192969,971,881468,1103,1074437,California
Riverside,2021-05-31,911,1903895,516,1037834,361,812091,34,53970,347,192791,559,882027,381,1074818,California
Riverside,2021-06-01,9373,1913268,5797,1043631,3332,815423,244,54214,3526,190774,5787,887814,3770,1078588,California
Riverside,2021-06-02,7270,1920538,4452,1048083,2532,817955,286,54500,2797,189437,4422,892236,3085,1081673,California
Riverside,2021-06-03,8119,1928657,5399,1053482,2445,820400,275,54775,2760,187171,5311,897547,3045,1084718,California
Riverside,2021-06-04,11013,1939670,7851,1061333,2901,823301,261,55036,3819,184125,7136,904683,4090,1088808,California
Riverside,2021-06-05,7108,1946778,5251,1066584,1300,824601,557,55593,2216,182038,4868,909551,2781,1091589,California
Riverside,2021-06-06,2240,1949018,1897,1068481,290,824891,53,55646,693,181249,1538,911089,749,1092338,California
Riverside,2021-06-07,7106,1956124,5379,1073860,1490,826381,237,55883,2356,179126,4718,915807,2595,1094933,California
Riverside,2021-06-08,9208,1965332,6656,1080516,2268,828649,284,56167,3008,176286,6140,921947,3300,1098233,California
Riverside,2021-06-09,7873,1973205,5724,1086240,1849,830498,300,56467,2415,173598,5407,927354,2719,1100952,California
Riverside,2021-06-10,7716,1980921,5416,1091656,2059,832557,241,56708,2390,170940,5296,932650,2638,1103590,California
Riverside,2021-06-11,9238,1990159,6287,1097943,2646,835203,305,57013,3200,168466,5980,938630,3506,1107096,California
Riverside,2021-06-12,5451,1995610,4035,1101978,1289,836492,127,57140,1689,166568,3727,942357,1829,1108925,California
Riverside,2021-06-13,1824,1997434,1355,1103333,424,836916,45,57185,513,165828,1298,943655,558,1109483,California
Riverside,2021-06-14,6571,2004005,4731,1108064,1525,838441,315,57500,2163,163933,4376,948031,2481,1111964,California
Riverside,2021-06-15,7273,2011278,4959,1113023,1994,840435,320,57820,2706,162456,4509,952540,3032,1114996,California
Riverside,2021-06-16,6990,2018268,4822,1117845,1850,842285,318,58138,2483,160803,4456,956996,2803,1117799,California
Riverside,2021-06-17,6579,2024847,4596,1122441,1734,844019,249,58387,2450,159422,4088,961084,2707,1120506,California
Riverside,2021-06-18,8334,2033181,6006,1128447,2043,846062,285,58672,3380,158183,4908,965992,3669,1124175,California
Riverside,2021-06-19,4332,2037513,3310,1131757,867,846929,155,58827,1803,157642,2504,968496,1963,1126138,California
Riverside,2021-06-20,1529,2039042,1159,1132916,332,847261,38,58865,591,157345,928,969424,631,1126769,California
Riverside,2021-06-21,4358,2043400,2877,1135793,1194,848455,287,59152,2240,157776,2097,971521,2528,1129297,California
Riverside,2021-06-22,6435,2049835,4520,1140313,1656,850111,259,59411,2761,157158,3637,975158,3019,1132316,California
Riverside,2021-06-23,5634,2055469,3998,1144311,1376,851487,260,59671,2606,157034,2991,978149,2867,1135183,California
Riverside,2021-06-24,5556,2061025,3777,1148088,1527,853014,252,59923,2405,156581,3113,981262,2660,1137843,California
Riverside,2021-06-25,6956,2067981,4981,1153069,1689,854703,286,60209,3000,155951,3922,985184,3292,1141135,California
Riverside,2021-06-26,3884,2071865,2994,1156063,764,855467,126,60335,1790,155799,2070,987254,1918,1143053,California
Riverside,2021-06-27,1526,2073391,1228,1157291,252,855719,46,60381,709,155751,805,988059,757,1143810,California
Riverside,2021-06-28,4379,2077770,3410,1160701,738,856457,231,60612,2054,155745,2294,990353,2288,1146098,California
Riverside,2021-06-29,5784,2083554,4294,1164995,1313,857770,177,60789,2688,155555,3061,993414,2871,1148969,California
Riverside,2021-06-30,5065,2088619,3742,1168737,1150,858920,173,60962,2467,155670,2526,995940,2641,1151610,California
Riverside,2021-07-01,4834,2093453,3364,1172101,1161,860081,309,61271,2267,155718,2535,998475,2583,1154193,California
Riverside,2021-07-02,6016,2099469,4502,1176603,1315,861396,199,61470,2823,155596,3145,1001620,3023,1157216,California
Riverside,2021-07-03,2910,2102379,2177,1178780,654,862050,79,61549,1436,155670,1444,1003064,1518,1158734,California
Riverside,2021-07-04,251,2102630,144,1178924,98,862148,9,61558,101,155634,146,1003210,110,1158844,California
Riverside,2021-07-05,2631,2105261,2059,1180983,509,862657,63,61621,1283,155643,1339,1004549,1348,1160192,California
Riverside,2021-07-06,5650,2110911,4162,1185145,1257,863914,231,61852,2292,154859,3310,1007859,2526,1162718,California
Riverside,2021-07-07,4637,2115548,3374,1188519,1064,864978,199,62051,2059,154579,2539,1010398,2259,1164977,California
Riverside,2021-07-08,4488,2120036,3239,1191758,1032,866010,217,62268,2021,154460,2351,1012749,2232,1167209,California
Riverside,2021-07-09,5640,2125676,4216,1195974,1170,867180,254,62522,2508,154124,3092,1015841,2756,1169965,California
Riverside,2021-07-10,3108,2128784,2332,1198306,693,867873,83,62605,1560,154245,1523,1017364,1644,1171609,California
Riverside,2021-07-11,1178,2129962,912,1199218,233,868106,33,62638,613,154333,558,1017922,646,1172255,California
Riverside,2021-07-12,3952,2133914,3073,1202291,721,868827,158,62796,1824,154209,2103,1020025,1979,1174234,California
Riverside,2021-07-13,4876,2138790,3629,1205920,1106,869933,141,62937,2403,154317,2439,1022464,2547,1176781,California
Riverside,2021-07-14,4706,2143496,3473,1209393,1105,871038,128,63065,2258,154279,2423,1024887,2385,1179166,California
Riverside,2021-07-15,4620,2148116,3362,1212755,1072,872110,186,63251,2240,154373,2339,1027226,2433,1181599,California
Riverside,2021-07-16,5901,2154017,4465,1217220,1266,873376,170,63421,2998,154678,2862,1030088,3167,1184766,California
Riverside,2021-07-17,3643,2157660,2799,1220019,769,874145,75,63496,2010,155157,1611,1031699,2090,1186856,California
Riverside,2021-07-18,1511,2159171,1159,1221178,293,874438,59,63555,790,155297,710,1032409,850,1187706,California
Riverside,2021-07-19,4367,2163538,3406,1224584,831,875269,130,63685,2309,155704,2034,1034443,2441,1190147,California
Riverside,2021-07-20,5349,2168887,3836,1228420,1274,876543,239,63924,2738,156104,2576,1037019,2976,1193123,California
Riverside,2021-07-21,5036,2173923,3672,1232092,1163,877706,201,64125,2579,156458,2433,1039452,2787,1195910,California
Riverside,2021-07-22,5015,2178938,3600,1235692,1286,878992,129,64254,2750,157114,2228,1041680,2884,1198794,California
Riverside,2021-07-23,6756,2185694,5113,1240805,1483,880475,160,64414,3967,158501,2744,1044424,4131,1202925,California
Riverside,2021-07-24,3854,2189548,2959,1243764,819,881294,76,64490,2260,159261,1579,1046003,2339,1205264,California
Riverside,2021-07-25,1659,2191207,1297,1245061,353,881647,9,64499,1276,160183,369,1046372,1291,1206555,California
Riverside,2021-07-26,4923,2196130,3673,1248734,1123,882770,127,64626,3234,161901,1644,1048016,3362,1209917,California
Riverside,2021-07-27,5791,2201921,4387,1253121,1225,883995,179,64805,3462,163264,2280,1050296,3643,1213560,California
Riverside,2021-07-28,5635,2207556,4108,1257229,1339,885334,188,64993,3451,164750,2151,1052447,3637,1217197,California
Riverside,2021-07-29,5537,2213093,4112,1261341,1292,886626,133,65126,3495,166392,1994,1054441,3636,1220833,California
Riverside,2021-07-30,6775,2219868,5189,1266530,1429,888055,157,65283,4103,168031,2625,1057066,4264,1225097,California
Riverside,2021-07-31,3988,2223856,3033,1269563,849,888904,106,65389,2492,169161,1468,1058534,2598,1227695,California
Riverside,2021-08-01,1929,2225785,1549,1271112,359,889263,21,65410,1335,169934,584,1059118,1357,1229052,California
Riverside,2021-08-02,5238,2231023,4113,1275225,975,890238,150,65560,3472,171827,1730,1060848,3623,1232675,California
Riverside,2021-08-03,6153,2237176,4638,1279863,1334,891572,181,65741,3840,173580,2268,1063116,4021,1236696,California
Riverside,2021-08-04,5593,2242769,4141,1284004,1293,892865,159,65900,3509,175208,2044,1065160,3672,1240368,California
Riverside,2021-08-05,5730,2248499,4326,1288330,1239,894104,165,66065,3621,176936,2061,1067221,3789,1244157,California
Riverside,2021-08-06,7513,2256012,5765,1294095,1485,895589,263,66328,4629,179013,2818,1070039,4895,1249052,California
Riverside,2021-08-07,4181,2260193,3243,1297338,840,896429,98,66426,2509,179977,1644,1071683,2608,1251660,California
Riverside,2021-08-08,2340,2262533,1855,1299193,458,896887,27,66453,1491,180666,830,1072513,1519,1253179,California
Riverside,2021-08-09,5691,2268224,4342,1303535,1152,898039,197,66650,3366,181931,2298,1074811,3563,1256742,California
Riverside,2021-08-10,6176,2274400,4637,1308172,1288,899327,251,66901,3581,183206,2558,1077369,3833,1260575,California
Riverside,2021-08-11,5187,2279587,3783,1311955,1210,900537,194,67095,2935,184122,2211,1079580,3127,1263702,California
Riverside,2021-08-12,5925,2285512,4299,1316254,1372,901909,254,67349,3496,185499,2377,1081957,3754,1267456,California
Riverside,2021-08-13,8138,2293650,6191,1322445,1674,903583,273,67622,4687,187090,3376,1085333,4967,1272423,California
Riverside,2021-08-14,5769,2299419,4500,1326945,1169,904752,100,67722,3244,188136,2300,1087633,3346,1275769,California
Riverside,2021-08-15,2648,2302067,2045,1328990,576,905328,27,67749,1454,188616,1003,1088636,1483,1277252,California
Riverside,2021-08-16,6647,2308714,4871,1333861,1562,906890,214,67963,3383,189424,2794,1091430,3602,1280854,California
Riverside,2021-08-17,7399,2316113,5410,1339271,1770,908660,219,68182,3699,190208,3135,1094565,3919,1284773,California
Riverside,2021-08-18,6957,2323070,5047,1344318,1745,910405,165,68347,3375,190853,2899,1097464,3544,1288317,California
Riverside,2021-08-19,7448,2330518,5339,1349657,1868,912273,241,68588,3667,191712,3046,1100510,3905,1292222,California
Riverside,2021-08-20,9047,2339565,6642,1356299,2149,914422,256,68844,4161,192081,4046,1104556,4415,1296637,California
Riverside,2021-08-21,4974,2344539,3801,1360100,1064,915486,109,68953,2189,191928,2454,1107010,2301,1298938,California
Riverside,2021-08-22,2789,2347328,2081,1362181,684,916170,24,68977,1362,192090,1224,1108234,1386,1300324,California
Riverside,2021-08-23,7107,2354435,5299,1367480,1640,917810,168,69145,3240,192289,3216,1111450,3415,1303739,California
Riverside,2021-08-24,7216,2361651,5505,1372985,1527,919337,184,69329,3165,192249,3393,1114843,3353,1307092,California
Riverside,2021-08-25,6695,2368346,5048,1378033,1510,920847,137,69466,2957,192174,3175,1118018,3100,1310192,California
Riverside,2021-08-26,6633,2374979,5030,1383063,1419,922266,184,69650,2929,192247,3042,1121060,3115,1313307,California
Riverside,2021-08-27,8915,2383894,6852,1389915,1864,924130,199,69849,3679,191798,4337,1125397,3888,1317195,California
Riverside,2021-08-28,4936,2388830,3897,1393812,972,925102,67,69916,2006,191282,2594,1127991,2078,1319273,California
Riverside,2021-08-29,2876,2391706,2335,1396147,518,925620,23,69939,1274,191170,1412,1129403,1300,1320573,California
Riverside,2021-08-30,3626,2395332,2532,1398679,954,926574,140,70079,1365,190929,1750,1131153,1509,1322082,California
Sacramento,2020-12-15,316,316,316,316,0,0,0,0,316,316,0,0,316,316,California
Sacramento,2020-12-16,688,1004,688,1004,0,0,0,0,688,1004,0,0,688,1004,California
Sacramento,2020-12-17,728,1732,728,1732,0,0,0,0,728,1732,0,0,728,1732,California
Sacramento,2020-12-18,1146,2878,1145,2877,1,1,0,0,1146,2878,0,0,1146,2878,California
Sacramento,2020-12-19,635,3513,635,3512,0,1,0,0,635,3513,0,0,635,3513,California
Sacramento,2020-12-20,645,4158,643,4155,2,3,0,0,645,4158,0,0,645,4158,California
Sacramento,2020-12-21,1697,5855,1697,5852,0,3,0,0,1698,5856,0,0,1698,5856,California
Sacramento,2020-12-22,2137,7992,2094,7946,43,46,0,0,2138,7994,0,0,2138,7994,California
Sacramento,2020-12-23,2288,10280,2100,10046,188,234,0,0,2288,10282,0,0,2288,10282,California
Sacramento,2020-12-24,1057,11337,831,10877,226,460,0,0,1057,11339,0,0,1057,11339,California
Sacramento,2020-12-25,5,11342,4,10881,1,461,0,0,5,11344,0,0,5,11344,California
Sacramento,2020-12-26,508,11850,288,11169,220,681,0,0,508,11852,0,0,508,11852,California
Sacramento,2020-12-27,357,12207,250,11419,107,788,0,0,357,12209,0,0,357,12209,California
Sacramento,2020-12-28,1939,14146,1352,12771,587,1375,0,0,1938,14146,1,1,1938,14147,California
Sacramento,2020-12-29,2064,16210,1275,14046,789,2164,0,0,2064,16210,0,1,2064,16211,California
Sacramento,2020-12-30,2860,19070,1761,15807,1099,3263,0,0,2861,19071,0,1,2861,19072,California
Sacramento,2020-12-31,1235,20305,693,16500,542,3805,0,0,1236,20307,0,1,1236,20308,California
Sacramento,2021-01-01,110,20415,85,16585,25,3830,0,0,110,20417,0,1,110,20418,California
Sacramento,2021-01-02,576,20991,372,16957,204,4034,0,0,576,20993,0,1,576,20994,California
Sacramento,2021-01-03,418,21409,227,17184,191,4225,0,0,417,21409,1,2,417,21411,California
Sacramento,2021-01-04,1961,23370,853,18037,1108,5333,0,0,1959,23367,1,3,1959,23370,California
Sacramento,2021-01-05,2270,25640,1027,19064,1243,6576,0,0,1881,24866,389,392,1888,25258,California
Sacramento,2021-01-06,2777,28417,1654,20718,1123,7699,0,0,1959,26014,812,1204,1960,27218,California
Sacramento,2021-01-07,2899,31316,1550,22268,1349,9048,0,0,1941,27002,953,2157,1941,29159,California
Sacramento,2021-01-08,3335,34651,2115,24383,1220,10268,0,0,2190,28053,1141,3298,2192,31351,California
Sacramento,2021-01-09,1291,35942,807,25190,484,10752,0,0,892,28546,399,3697,892,32243,California
Sacramento,2021-01-10,1227,37169,716,25906,511,11263,0,0,755,28830,472,4169,756,32999,California
Sacramento,2021-01-11,4399,41568,2991,28897,1408,12671,0,0,2441,29325,1958,6127,2453,35452,California
Sacramento,2021-01-12,4751,46319,3335,32232,1416,14087,0,0,2665,29913,2085,8212,2673,38125,California
Sacramento,2021-01-13,3890,50209,2252,34484,1638,15725,0,0,2462,30949,1427,9639,2463,40588,California
Sacramento,2021-01-14,4781,54990,2438,36922,2343,18068,0,0,3863,33897,915,10554,3863,44451,California
Sacramento,2021-01-15,4536,59526,2265,39187,2271,20339,0,0,3816,36995,719,11273,3817,48268,California
Sacramento,2021-01-16,2442,61968,1289,40476,1153,21492,0,0,2220,38994,221,11494,2220,50488,California
Sacramento,2021-01-17,1688,63656,985,41461,703,22195,0,0,1504,40316,184,11678,1506,51994,California
Sacramento,2021-01-18,2864,66520,1745,43206,1119,23314,0,0,2215,41884,648,12326,2216,54210,California
Sacramento,2021-01-19,5040,71560,3043,46249,1997,25311,0,0,3661,44171,1377,13703,3664,57874,California
Sacramento,2021-01-20,5013,76573,3012,49261,2001,27312,0,0,3608,46383,1402,15105,3614,61488,California
Sacramento,2021-01-21,5305,81878,3052,52313,2253,29565,0,0,4252,49596,1042,16147,4255,65743,California
Sacramento,2021-01-22,5098,86976,2725,55038,2373,31938,0,0,4740,53980,357,16504,4741,70484,California
Sacramento,2021-01-23,3898,90874,1579,56617,2319,34257,0,0,3428,56938,470,16974,3428,73912,California
Sacramento,2021-01-24,1712,92586,1062,57679,650,34907,0,0,1462,58154,248,17222,1464,75376,California
Sacramento,2021-01-25,4460,97046,2194,59873,2266,37173,0,0,2957,59610,1503,18725,2959,78335,California
Sacramento,2021-01-26,4812,101858,2202,62075,2610,39783,0,0,3584,61973,1224,19949,3587,81922,California
Sacramento,2021-01-27,5926,107784,3069,65144,2857,42640,0,0,4276,64607,1644,21593,4278,86200,California
Sacramento,2021-01-28,5590,113374,2810,67954,2780,45420,0,0,4458,67936,1130,22723,4459,90659,California
Sacramento,2021-01-29,5477,118851,2945,70899,2532,47952,0,0,4438,71344,1031,23754,4439,95098,California
Sacramento,2021-01-30,4891,123742,2209,73108,2682,50634,0,0,4454,75364,434,24188,4454,99552,California
Sacramento,2021-01-31,2490,126232,2186,75294,304,50938,0,0,2136,77151,351,24539,2138,101690,California
Sacramento,2021-02-01,5996,132228,3069,78363,2927,53865,0,0,4289,79740,1701,26240,4290,105980,California
Sacramento,2021-02-02,7141,139369,3863,82226,3278,57143,0,0,4998,82619,2121,28361,5000,110980,California
Sacramento,2021-02-03,7179,146548,3615,85841,3564,60707,0,0,5282,86018,1885,30246,5284,116264,California
Sacramento,2021-02-04,7833,154381,3705,89546,4128,64835,0,0,5555,89304,2269,32515,5555,121819,California
Sacramento,2021-02-05,7925,162306,4502,94048,3423,68258,0,0,4844,91102,3054,35569,4852,126671,California
Sacramento,2021-02-06,9050,171356,3506,97554,5544,73802,0,0,7684,97424,1364,36933,7686,134357,California
Sacramento,2021-02-07,4186,175542,2319,99873,1867,75669,0,0,2994,99232,1187,38120,2995,137352,California
Sacramento,2021-02-08,6318,181860,3282,103155,3036,78705,0,0,3932,100786,2379,40499,3933,141285,California
Sacramento,2021-02-09,6866,188726,3594,106749,3272,81977,0,0,4046,102030,2805,43304,4049,145334,California
Sacramento,2021-02-10,7806,196532,4262,111011,3544,85521,0,0,4536,103316,3251,46555,4537,149871,California
Sacramento,2021-02-11,9714,206246,5789,116800,3925,89446,0,0,5551,104723,4146,50701,5553,155424,California
Sacramento,2021-02-12,10814,217060,4207,121007,6607,96053,0,0,6455,106894,4289,54990,6460,161884,California
Sacramento,2021-02-13,8188,225248,3035,124042,5153,101206,0,0,6137,110989,2043,57033,6138,168022,California
Sacramento,2021-02-14,3382,228630,2078,126120,1304,102510,0,0,2158,111931,1222,58255,2164,170186,California
Sacramento,2021-02-15,6085,234715,2081,128201,4004,106514,0,0,4204,114270,1870,60125,4209,174395,California
Sacramento,2021-02-16,9412,244127,4280,132481,5132,111646,0,0,5386,115648,4014,64139,5392,179787,California
Sacramento,2021-02-17,8994,253121,5066,137547,3928,115574,0,0,5180,117033,3801,67940,5186,184973,California
Sacramento,2021-02-18,9746,262867,5845,143392,3901,119475,0,0,5789,118883,3942,71882,5792,190765,California
Sacramento,2021-02-19,10198,273065,6257,149649,3941,123416,0,0,6008,120726,4175,76057,6018,196783,California
Sacramento,2021-02-20,8282,281347,5901,155550,2381,125797,0,0,4831,122118,3442,79499,4834,201617,California
Sacramento,2021-02-21,5117,286464,2634,158184,2483,128280,0,0,2945,122900,2163,81662,2945,204562,California
Sacramento,2021-02-22,6580,293044,3995,162179,2585,130865,0,0,2839,122028,3715,85377,2843,207405,California
Sacramento,2021-02-23,7780,300824,4835,167014,2945,133810,0,0,3570,121414,4187,89564,3573,210978,California
Sacramento,2021-02-24,10247,311071,5667,172681,4580,138390,0,0,5503,122206,4718,94282,5510,216488,California
Sacramento,2021-02-25,11705,322776,6712,179393,4993,143383,0,0,6769,124064,4913,99195,6771,223259,California
Sacramento,2021-02-26,14947,337723,7071,186464,7876,151259,0,0,10175,129517,4728,103923,10181,233440,California
Sacramento,2021-02-27,11525,349248,7075,193539,4447,155706,3,3,8501,135027,2995,106918,8505,241945,California
Sacramento,2021-02-28,6964,356212,2560,196099,4404,160110,0,3,3223,134530,3725,110643,3228,245173,California
Sacramento,2021-03-01,8994,365206,3779,199878,5210,165320,5,8,4870,135316,4092,114735,4878,250051,California
Sacramento,2021-03-02,9852,375058,4424,204302,5427,170747,1,9,5875,137240,3956,118691,5880,255931,California
Sacramento,2021-03-03,11594,386652,5345,209647,6245,176992,4,13,6895,139470,4672,123363,6902,262833,California
Sacramento,2021-03-04,14044,400696,6555,216202,7485,184477,4,17,7716,140917,6281,129644,7728,270561,California
Sacramento,2021-03-05,11043,411739,5170,221372,5842,190319,31,48,7190,144317,3822,133466,7222,277783,California
Sacramento,2021-03-06,8411,420150,3315,224687,4969,195288,127,175,4147,144346,4244,137710,4273,282056,California
Sacramento,2021-03-07,8237,428387,2311,226998,5781,201069,145,320,3684,143637,4534,142244,3825,285881,California
Sacramento,2021-03-08,9351,437738,4427,231425,4680,205749,244,564,6020,146583,3314,145558,6260,292141,California
Sacramento,2021-03-09,9923,447661,4674,236099,4951,210700,298,862,5626,148230,4272,149830,5919,298060,California
Sacramento,2021-03-10,11940,459601,7574,243673,4014,214714,352,1214,6970,150623,4929,154759,7322,305382,California
Sacramento,2021-03-11,15308,474909,10169,253842,4295,219009,844,2058,8993,154185,6267,161026,9829,315211,California
Sacramento,2021-03-12,18204,493113,8405,262247,8927,227936,872,2930,8900,154723,9232,170258,9770,324981,California
Sacramento,2021-03-13,13725,506838,3618,265865,9674,237610,433,3363,8459,158361,5252,175510,8890,333871,California
Sacramento,2021-03-14,9531,516369,3531,269396,5375,242985,625,3988,4475,158437,5022,180532,5098,338969,California
Sacramento,2021-03-15,12377,528746,4962,274358,6757,249742,658,4646,7117,160985,5229,185761,7777,346746,California
Sacramento,2021-03-16,14382,543128,6493,280851,7235,256977,654,5300,8831,164950,5510,191271,9475,356221,California
Sacramento,2021-03-17,14149,557277,6903,287754,6611,263588,635,5935,9038,169535,5084,196355,9669,365890,California
Sacramento,2021-03-18,15918,573195,8367,296121,6934,270522,617,6552,10031,174328,5850,202205,10643,376533,California
Sacramento,2021-03-19,15799,588994,8070,304191,6341,276863,1388,7940,7893,175723,7873,210078,9268,385801,California
Sacramento,2021-03-20,13434,602428,7591,311782,5497,282360,346,8286,8429,179526,4968,215046,8771,394572,California
Sacramento,2021-03-21,5857,608285,2787,314569,3030,285390,40,8326,3348,180426,2492,217538,3392,397964,California
Sacramento,2021-03-22,9477,617762,4895,319464,3735,289125,847,9173,6232,184285,3213,220751,7072,405036,California
Sacramento,2021-03-23,11559,629321,6877,326341,3872,292997,810,9983,7334,188250,4174,224925,8139,413175,California
Sacramento,2021-03-24,12026,641347,7329,333670,4067,297064,630,10613,6655,190252,5284,230209,7286,420461,California
Sacramento,2021-03-25,14403,655750,8461,342131,5100,302164,842,11455,8527,193781,5829,236038,9358,429819,California
Sacramento,2021-03-26,18518,674268,9007,351138,9000,311164,511,11966,9113,194081,9324,245362,9624,439443,California
Sacramento,2021-03-27,10301,684569,3641,354779,6359,317523,301,12267,5558,195226,4705,250067,5850,445293,California
Sacramento,2021-03-28,6705,691274,3275,358054,3173,320696,257,12524,2647,194084,4049,254116,2907,448200,California
Sacramento,2021-03-29,11136,702410,5936,363990,4805,325501,395,12919,4902,193181,6201,260317,5298,453498,California
Sacramento,2021-03-30,11999,714409,6115,370105,5475,330976,409,13328,5988,193597,5978,266295,6394,459892,California
Sacramento,2021-03-31,13561,727970,7912,378017,5238,336214,411,13739,5545,191561,7983,274278,5947,465839,California
Sacramento,2021-04-01,17612,745582,10517,388534,6839,343053,256,13995,7298,188861,10256,284534,7556,473395,California
Sacramento,2021-04-02,17299,762881,9781,398315,6771,349824,747,14742,9008,190363,8250,292784,9752,483147,California
Sacramento,2021-04-03,10509,773390,6270,404585,3686,353510,553,15295,6406,193243,4071,296855,6951,490098,California
Sacramento,2021-04-04,3757,777147,1554,406139,2001,355511,202,15497,1459,192609,2290,299145,1656,491754,California
Sacramento,2021-04-05,12132,789279,7599,413738,3692,359203,841,16338,5335,192019,6758,305903,6168,497922,California
Sacramento,2021-04-06,15781,805060,8907,422645,5531,364734,1343,17681,6781,191174,8964,314867,8119,506041,California
Sacramento,2021-04-07,15010,820070,8077,430722,5311,370045,1622,19303,6985,191798,7970,322837,8594,514635,California
Sacramento,2021-04-08,15170,835240,6814,437536,5351,375396,3005,22308,6013,191658,9118,331955,8978,523613,California
Sacramento,2021-04-09,18454,853694,9407,446943,6808,382204,2239,24547,7443,190360,10961,342916,9663,533276,California
Sacramento,2021-04-10,13509,867203,3868,450811,8407,390611,1234,25781,5880,189847,7594,350510,7081,540357,California
Sacramento,2021-04-11,11229,878432,4403,455214,6595,397206,231,26012,3656,186185,7546,358056,3884,544241,California
Sacramento,2021-04-12,13065,891497,5070,460284,6082,403288,1913,27925,4906,184898,8088,366144,6801,551042,California
Sacramento,2021-04-13,16404,907901,10011,470295,6388,409676,5,27930,7592,183722,8777,374921,7601,558643,California
Sacramento,2021-04-14,15134,923035,8047,478342,7084,416760,3,27933,5950,180531,9147,384068,5956,564599,California
Sacramento,2021-04-15,16490,939525,8456,486798,8031,424791,3,27936,6626,177347,9816,393884,6632,571231,California
Sacramento,2021-04-16,17681,957206,9761,496559,7920,432711,0,27936,7976,175673,9652,403536,7978,579209,California
Sacramento,2021-04-17,15952,973158,6223,502782,9729,442440,0,27936,11623,183001,4300,407836,11628,590837,California
Sacramento,2021-04-18,9124,982282,3317,506099,5807,448247,0,27936,3891,181685,5211,413047,3895,594732,California
Sacramento,2021-04-19,10665,992947,5754,511853,4906,453153,5,27941,4685,180423,5954,419001,4692,599424,California
Sacramento,2021-04-20,11505,1004452,7079,518932,4422,457575,4,27945,5983,180920,5494,424495,5991,605415,California
Sacramento,2021-04-21,12411,1016863,7420,526352,4988,462563,3,27948,6639,181825,5738,430233,6643,612058,California
Sacramento,2021-04-22,15423,1032286,10358,536710,5059,467622,6,27954,7050,180550,8332,438565,7057,619115,California
Sacramento,2021-04-23,16549,1048835,10458,547168,6091,473713,0,27954,7645,179340,8857,447422,7647,626762,California
Sacramento,2021-04-24,11792,1060627,7131,554299,4659,478372,2,27956,6271,180136,5477,452899,6273,633035,California
Sacramento,2021-04-25,8629,1069256,4544,558843,4085,482457,0,27956,4217,179963,4391,457290,4218,637253,California
Sacramento,2021-04-26,10915,1080171,6876,565719,4015,486472,24,27980,5189,179482,5696,462986,5215,642468,California
Sacramento,2021-04-27,12387,1092558,8152,573871,4076,490548,159,28139,6068,179428,6283,469269,6229,648697,California
Sacramento,2021-04-28,10951,1103509,6206,580077,4534,495082,211,28350,6059,180844,4859,474128,6275,654972,California
Sacramento,2021-04-29,11342,1114851,7679,587756,3356,498438,307,28657,6222,182301,5073,479201,6530,661502,California
Sacramento,2021-04-30,12891,1127742,8154,595910,4475,502913,262,28919,6087,181903,6749,485950,6351,667853,California
Sacramento,2021-05-01,7753,1135495,5547,601457,2029,504942,177,29096,2855,180084,4855,490805,3036,670889,California
Sacramento,2021-05-02,5052,1140547,4350,605807,548,505490,154,29250,2243,179699,2781,493586,2396,673285,California
Sacramento,2021-05-03,9266,1149813,7407,613214,1578,507068,281,29531,4014,178764,5227,498813,4292,677577,California
Sacramento,2021-05-04,9781,1159594,6025,619239,3443,510511,313,29844,3884,177110,5848,504661,4194,681771,California
Sacramento,2021-05-05,11446,1171040,6267,625506,4715,515226,464,30308,4655,175480,6741,511402,5111,686882,California
Sacramento,2021-05-06,11516,1182556,6436,631942,4771,519997,309,30617,4639,173930,6495,517897,4945,691827,California
Sacramento,2021-05-07,10938,1193494,6393,638335,4173,524170,372,30989,4587,172598,6291,524188,4959,696786,California
Sacramento,2021-05-08,9068,1202562,4029,642364,4807,528977,232,31221,2846,169496,6173,530361,3071,699857,California
Sacramento,2021-05-09,3305,1205867,1805,644169,1388,530365,112,31333,1206,168728,2085,532446,1317,701174,California
Sacramento,2021-05-10,8379,1214246,3928,648097,4177,534542,274,31607,2007,164676,6334,538780,2282,703456,California
Sacramento,2021-05-11,8785,1223031,5572,653669,2948,537490,265,31872,3043,162285,5700,544480,3309,706765,California
Sacramento,2021-05-12,8855,1231886,5330,658999,3268,540758,257,32129,2967,159654,5851,550331,3220,709985,California
Sacramento,2021-05-13,12156,1244042,7764,666763,4112,544870,280,32409,4579,156984,7529,557860,4859,714844,California
Sacramento,2021-05-14,12719,1256761,7193,673956,5233,550103,293,32702,5119,154856,7540,565400,5412,720256,California
Sacramento,2021-05-15,13375,1270136,8081,682037,5148,555251,146,32848,5899,153457,7439,572839,6040,726296,California
Sacramento,2021-05-16,8603,1278739,4341,686378,4147,559398,115,32963,2285,149575,6285,579124,2403,728699,California
Sacramento,2021-05-17,10549,1289288,6445,692823,3801,563199,303,33266,3932,147237,6575,585699,4237,732936,California
Sacramento,2021-05-18,10002,1299290,6264,699087,3518,566717,220,33486,3748,144996,6211,591910,3970,736906,California
Sacramento,2021-05-19,9981,1309271,6348,705435,3366,570083,267,33753,4489,144313,5446,597356,4763,741669,California
Sacramento,2021-05-20,10419,1319690,6866,712301,3288,573371,265,34018,3871,141957,6495,603851,4139,745808,California
Sacramento,2021-05-21,10903,1330593,6898,719199,3676,577047,329,34347,4516,140464,6344,610195,4851,750659,California
Sacramento,2021-05-22,7541,1338134,4669,723868,2698,579745,174,34521,3364,139862,4143,614338,3541,754200,California
Sacramento,2021-05-23,5321,1343455,3029,726897,2187,581932,105,34626,1971,138611,3328,617666,2077,756277,California
Sacramento,2021-05-24,7954,1351409,4798,731695,2824,584756,332,34958,2542,136115,5369,623035,2873,759150,California
Sacramento,2021-05-25,6837,1358246,3955,735650,2587,587343,295,35253,2426,134455,4377,627412,2717,761867,California
Sacramento,2021-05-26,8666,1366912,4778,740428,3544,590887,344,35597,2841,131861,5776,633188,3182,765049,California
Sacramento,2021-05-27,6778,1373690,3711,744139,2821,593708,246,35843,2962,131300,3769,636957,3208,768257,California
Sacramento,2021-05-28,8590,1382280,4845,748984,3371,597079,374,36217,3669,130466,4875,641832,4041,772298,California
Sacramento,2021-05-29,4494,1386774,2741,751725,1589,598668,164,36381,2232,130630,2230,644062,2394,774692,California
Sacramento,2021-05-30,1697,1388471,1083,752808,576,599244,38,36419,757,130493,933,644995,796,775488,California
Sacramento,2021-05-31,898,1389369,455,753263,430,599674,13,36432,319,130252,574,645569,333,775821,California
Sacramento,2021-06-01,7028,1396397,4217,757480,2603,602277,208,36640,2547,128568,4436,650005,2752,778573,California
Sacramento,2021-06-02,6174,1402571,3398,760878,2562,604839,214,36854,2292,127234,3839,653844,2505,781078,California
Sacramento,2021-06-03,7572,1410143,5153,766031,2229,607068,190,37044,2183,124256,5346,659190,2368,783446,California
Sacramento,2021-06-04,7192,1417335,4604,770635,2372,609440,216,37260,2246,121808,4910,664100,2462,785908,California
Sacramento,2021-06-05,6289,1423624,4608,775243,1539,610979,142,37402,1769,119229,4491,668591,1912,787820,California
Sacramento,2021-06-06,2510,1426134,1992,777235,461,611440,57,37459,787,118360,1714,670305,845,788665,California
Sacramento,2021-06-07,5660,1431794,3966,781201,1514,612954,180,37639,1605,116120,4022,674327,1782,790447,California
Sacramento,2021-06-08,5440,1437234,3704,784905,1558,614512,178,37817,1719,114325,3694,678021,1899,792346,California
Sacramento,2021-06-09,6236,1443470,4319,789224,1732,616244,185,38002,1636,111596,4549,682570,1820,794166,California
Sacramento,2021-06-10,5455,1448925,3479,792703,1764,618008,212,38214,1621,109646,3783,686353,1833,795999,California
Sacramento,2021-06-11,7827,1456752,5476,798179,2155,620163,196,38410,2239,106528,5551,691904,2433,798432,California
Sacramento,2021-06-12,4805,1461557,3118,801297,1567,621730,120,38530,1302,104466,3485,695389,1423,799855,California
Sacramento,2021-06-13,1949,1463506,1432,802729,472,622202,45,38575,400,103371,1538,696927,443,800298,California
Sacramento,2021-06-14,4396,1467902,2845,805574,1387,623589,164,38739,1362,101879,3016,699943,1524,801822,California
Sacramento,2021-06-15,4971,1472873,2987,808561,1757,625346,227,38966,1719,100593,3233,703176,1947,803769,California
Sacramento,2021-06-16,4567,1477440,3063,811624,1280,626626,224,39190,1584,99442,2951,706127,1800,805569,California
Sacramento,2021-06-17,4113,1481553,2673,814297,1270,627896,170,39360,1409,98347,2668,708795,1573,807142,California
Sacramento,2021-06-18,5305,1486858,3536,817833,1529,629425,240,39600,1829,96966,3449,712244,2068,809210,California
Sacramento,2021-06-19,3358,1490216,2277,820110,936,630361,145,39745,1189,96151,2147,714391,1332,810542,California
Sacramento,2021-06-20,1251,1491467,929,821039,293,630654,29,39774,574,96087,666,715057,602,811144,California
Sacramento,2021-06-21,2542,1494009,1346,822385,1033,631687,163,39937,1235,96190,1292,716349,1395,812539,California
Sacramento,2021-06-22,3933,1497942,2705,825090,1027,632714,201,40138,1536,95550,2371,718720,1731,814270,California
Sacramento,2021-06-23,4106,1502048,2826,827916,1072,633786,208,40346,1533,94735,2551,721271,1736,816006,California
Sacramento,2021-06-24,3492,1505540,2256,830172,1040,634826,196,40542,1386,94232,2085,723356,1582,817588,California
Sacramento,2021-06-25,4334,1509874,2963,833135,1152,635978,219,40761,1790,93714,2525,725881,2007,819595,California
Sacramento,2021-06-26,2872,1512746,2050,835185,696,636674,126,40887,1202,93389,1650,727531,1325,820920,California
Sacramento,2021-06-27,1261,1514007,928,836113,300,636974,33,40920,457,93081,798,728329,490,821410,California
Sacramento,2021-06-28,2663,1516670,1977,838090,544,637518,142,41062,1152,92880,1493,729822,1292,822702,California
Sacramento,2021-06-29,3346,1520016,2228,840318,975,638493,143,41205,1363,92433,1953,731775,1506,824208,California
Sacramento,2021-06-30,3328,1523344,2269,842587,919,639412,140,41345,1573,92411,1734,733509,1712,825920,California
Sacramento,2021-07-01,2918,1526262,1943,844530,809,640221,166,41511,1251,92185,1641,735150,1415,827335,California
Sacramento,2021-07-02,3491,1529753,2330,846860,1005,641226,156,41667,1495,91863,1969,737119,1647,828982,California
Sacramento,2021-07-03,1866,1531619,1263,848123,569,641795,34,41701,803,91654,1046,738165,837,829819,California
Sacramento,2021-07-04,160,1531779,62,848185,88,641883,10,41711,70,91645,89,738254,80,829899,California
Sacramento,2021-07-05,1442,1533221,981,849166,426,642309,35,41746,710,91668,722,738976,745,830644,California
Sacramento,2021-07-06,3522,1536743,2474,851640,870,643179,178,41924,1307,90956,2188,741164,1476,832120,California
Sacramento,2021-07-07,3238,1539981,2255,853895,834,644013,149,42073,1372,90626,1845,743009,1515,833635,California
Sacramento,2021-07-08,2748,1542729,1770,855665,803,644816,175,42248,1136,90335,1597,744606,1306,834941,California
Sacramento,2021-07-09,3386,1546115,2204,857869,985,645801,197,42445,1435,90039,1924,746530,1628,836569,California
Sacramento,2021-07-10,2037,1548152,1426,859295,543,646344,68,42513,886,89857,1136,747666,954,837523,California
Sacramento,2021-07-11,819,1548971,575,859870,219,646563,25,42538,377,89823,436,748102,402,837925,California
Sacramento,2021-07-12,2636,1551607,1918,861788,595,647158,123,42661,1234,89797,1384,749486,1358,839283,California
Sacramento,2021-07-13,2916,1554523,1974,863762,801,647959,141,42802,1357,89742,1550,751036,1495,840778,California
Sacramento,2021-07-14,2845,1557368,1916,865678,783,648742,146,42948,1252,89558,1580,752616,1396,842174,California
Sacramento,2021-07-15,2579,1559947,1746,867424,718,649460,115,43063,1185,89473,1383,753999,1298,843472,California
Sacramento,2021-07-16,3375,1563322,2214,869638,987,650447,174,43237,1587,89464,1769,755768,1760,845232,California
Sacramento,2021-07-17,2211,1565533,1503,871141,647,651094,61,43298,1037,89405,1155,756923,1096,846328,California
Sacramento,2021-07-18,936,1566469,687,871828,220,651314,29,43327,461,89421,473,757396,489,846817,California
Sacramento,2021-07-19,2606,1569075,1874,873702,615,651929,117,43444,1327,89593,1271,758667,1443,848260,California
Sacramento,2021-07-20,2992,1572067,1999,875701,851,652780,142,43586,1563,89892,1404,760071,1703,849963,California
Sacramento,2021-07-21,3187,1575254,2192,877893,831,653611,164,43750,1550,89982,1619,761690,1709,851672,California
Sacramento,2021-07-22,2984,1578238,2042,879935,804,654415,138,43888,1528,90213,1434,763124,1665,853337,California
Sacramento,2021-07-23,3694,1581932,2586,882521,975,655390,133,44021,2049,90790,1602,764726,2179,855516,California
Sacramento,2021-07-24,2270,1584202,1536,884057,663,656053,71,44092,1255,91117,999,765725,1326,856842,California
Sacramento,2021-07-25,911,1585113,663,884720,232,656285,16,44108,666,91561,239,765964,683,857525,California
Sacramento,2021-07-26,2853,1587966,1976,886696,771,657056,106,44214,1804,92448,1027,766991,1914,859439,California
Sacramento,2021-07-27,3379,1591345,2372,889068,880,657936,127,44341,2001,93224,1349,768340,2125,861564,California
Sacramento,2021-07-28,3379,1594724,2426,891494,813,658749,140,44481,1921,93852,1434,769774,2062,863626,California
Sacramento,2021-07-29,3139,1597863,2222,893716,780,659529,137,44618,1877,94629,1237,771011,2014,865640,California
Sacramento,2021-07-30,4015,1601878,2780,896496,1043,660572,192,44810,2395,95624,1588,772599,2583,868223,California
Sacramento,2021-07-31,2420,1604298,1661,898157,649,661221,110,44920,1498,96334,897,773496,1607,869830,California
Sacramento,2021-08-01,1161,1605459,826,898983,310,661531,25,44945,769,96747,381,773877,794,870624,California
Sacramento,2021-08-02,3434,1608893,2563,901546,742,662273,129,45074,2150,97761,1263,775140,2277,872901,California
Sacramento,2021-08-03,3623,1612516,2603,904149,860,663133,160,45234,2155,98629,1445,776585,2313,875214,California
Sacramento,2021-08-04,3308,1615824,2338,906487,840,663973,130,45364,1984,99432,1309,777894,2112,877326,California
Sacramento,2021-08-05,3367,1619191,2372,908859,828,664801,167,45531,2081,100411,1269,779163,2248,879574,California
Sacramento,2021-08-06,4090,1623281,2943,911802,1011,665812,136,45667,2484,101457,1575,780738,2621,882195,California
Sacramento,2021-08-07,2474,1625755,1725,913527,651,666463,98,45765,1457,102003,1006,781744,1552,883747,California
Sacramento,2021-08-08,1221,1626976,835,914362,350,666813,36,45801,738,102308,468,782212,773,884520,California
Sacramento,2021-08-09,3734,1630710,2797,917159,832,667645,105,45906,2274,103256,1430,783642,2378,886898,California
Sacramento,2021-08-10,3431,1634141,2461,919620,844,668489,126,46032,1971,103927,1425,785067,2096,888994,California
Sacramento,2021-08-11,3412,1637553,2366,921986,845,669334,201,46233,1956,104662,1419,786486,2154,891148,California
Sacramento,2021-08-12,3239,1640792,2137,924123,898,670232,204,46437,1801,105255,1407,787893,2000,893148,California
Sacramento,2021-08-13,4420,1645212,3054,927177,1164,671396,202,46639,2395,105866,1984,789877,2595,895743,California
Sacramento,2021-08-14,2711,1647923,1892,929069,719,672115,100,46739,1424,106207,1180,791057,1521,897264,California
Sacramento,2021-08-15,1340,1649263,973,930042,332,672447,35,46774,696,106356,583,791640,732,897996,California
Sacramento,2021-08-16,3891,1653154,2697,932739,1037,673484,157,46931,2044,106902,1649,793289,2195,900191,California
Sacramento,2021-08-17,3859,1657013,2649,935388,1015,674499,195,47126,1834,107097,1834,795123,2029,902220,California
Sacramento,2021-08-18,3910,1660923,2680,938068,1037,675536,193,47319,1836,107319,1807,796930,2029,904249,California
Sacramento,2021-08-19,4011,1664934,2719,940787,1106,676642,186,47505,1947,107752,1703,798633,2136,906385,California
Sacramento,2021-08-20,4965,1669899,3480,944267,1294,677936,191,47696,2254,107953,2243,800876,2444,908829,California
Sacramento,2021-08-21,2777,1672676,1928,946195,744,678680,105,47801,1257,107991,1324,802200,1362,910191,California
Sacramento,2021-08-22,1522,1674198,1086,947281,398,679078,38,47839,757,108108,679,802879,796,910987,California
Sacramento,2021-08-23,4592,1678790,3314,950595,1102,680180,176,48015,2032,108270,2044,804923,2206,913193,California
Sacramento,2021-08-24,4365,1683155,3301,953896,929,681109,135,48150,1869,108177,2098,807021,2005,915198,California
Sacramento,2021-08-25,4383,1687538,3215,957111,946,682055,222,48372,1879,108271,2005,809026,2099,917297,California
Sacramento,2021-08-26,4301,1691839,3155,960266,976,683031,170,48542,1997,108552,1884,810910,2165,919462,California
Sacramento,2021-08-27,4889,1696728,3581,963847,1123,684154,185,48727,1971,108267,2440,813350,2155,921617,California
Sacramento,2021-08-28,3035,1699763,2165,966012,784,684938,86,48813,1241,108070,1525,814875,1328,922945,California
Sacramento,2021-08-29,1588,1701351,1140,967152,420,685358,28,48841,771,108138,729,815604,797,923742,California
Sacramento,2021-08-30,3100,1704451,2272,969424,683,686041,145,48986,1141,107805,1620,817224,1287,925029,California
San Benito,2020-12-16,30,30,30,30,0,0,0,0,30,30,0,0,30,30,California
San Benito,2020-12-17,47,77,47,77,0,0,0,0,47,77,0,0,47,77,California
San Benito,2020-12-18,76,153,76,153,0,0,0,0,76,153,0,0,76,153,California
San Benito,2020-12-19,46,199,46,199,0,0,0,0,46,199,0,0,46,199,California
San Benito,2020-12-20,24,223,24,223,0,0,0,0,24,223,0,0,24,223,California
San Benito,2020-12-21,79,302,79,302,0,0,0,0,79,302,0,0,79,302,California
San Benito,2020-12-22,100,402,100,402,0,0,0,0,100,402,0,0,100,402,California
San Benito,2020-12-23,84,486,74,476,10,10,0,0,84,486,0,0,84,486,California
San Benito,2020-12-24,13,499,6,482,7,17,0,0,13,499,0,0,13,499,California
San Benito,2020-12-25,3,502,3,485,0,17,0,0,3,502,0,0,3,502,California
San Benito,2020-12-26,13,515,5,490,8,25,0,0,13,515,0,0,13,515,California
San Benito,2020-12-27,9,524,8,498,1,26,0,0,9,524,0,0,9,524,California
San Benito,2020-12-28,69,593,38,536,31,57,0,0,69,593,0,0,69,593,California
San Benito,2020-12-29,51,644,20,556,31,88,0,0,51,644,0,0,51,644,California
San Benito,2020-12-30,60,704,38,594,22,110,0,0,60,704,0,0,60,704,California
San Benito,2020-12-31,17,721,2,596,15,125,0,0,17,721,0,0,17,721,California
San Benito,2021-01-02,22,743,21,617,1,126,0,0,22,743,0,0,22,743,California
San Benito,2021-01-03,4,747,2,619,2,128,0,0,3,746,0,0,3,746,California
San Benito,2021-01-04,68,815,24,643,44,172,0,0,68,814,0,0,68,814,California
San Benito,2021-01-05,127,942,38,681,89,261,0,0,124,935,3,3,124,938,California
San Benito,2021-01-06,106,1048,47,728,59,320,0,0,86,1001,20,23,86,1024,California
San Benito,2021-01-07,112,1160,70,798,42,362,0,0,59,1007,53,76,59,1083,California
San Benito,2021-01-08,184,1344,89,887,95,457,0,0,120,1063,64,140,120,1203,California
San Benito,2021-01-09,42,1386,31,918,11,468,0,0,28,1077,14,154,28,1231,California
San Benito,2021-01-10,16,1402,14,932,2,470,0,0,5,1071,11,165,5,1236,California
San Benito,2021-01-11,180,1582,114,1046,66,536,0,0,72,1035,108,273,72,1308,California
San Benito,2021-01-12,164,1746,56,1102,108,644,0,0,126,1123,38,311,126,1434,California
San Benito,2021-01-13,243,1989,69,1171,174,818,0,0,192,1264,51,362,192,1626,California
San Benito,2021-01-14,135,2124,24,1195,111,929,0,0,116,1361,19,381,116,1742,California
San Benito,2021-01-15,222,2346,22,1217,200,1129,0,0,206,1551,16,397,206,1948,California
San Benito,2021-01-16,26,2372,8,1225,18,1147,0,0,21,1567,5,402,21,1969,California
San Benito,2021-01-17,11,2383,4,1229,7,1154,0,0,9,1574,2,404,9,1978,California
San Benito,2021-01-18,38,2421,23,1252,15,1169,0,0,22,1580,16,420,22,2000,California
San Benito,2021-01-19,192,2613,83,1335,109,1278,0,0,153,1694,39,459,153,2153,California
San Benito,2021-01-20,345,2958,107,1442,238,1516,0,0,298,1946,46,505,298,2451,California
San Benito,2021-01-21,148,3106,32,1474,116,1632,0,0,123,2044,25,530,123,2574,California
San Benito,2021-01-22,245,3351,20,1494,225,1857,0,0,235,2269,10,540,235,2809,California
San Benito,2021-01-23,29,3380,14,1508,15,1872,0,0,14,2268,15,555,14,2823,California
San Benito,2021-01-24,27,3407,3,1511,24,1896,0,0,23,2287,4,559,23,2846,California
San Benito,2021-01-25,94,3501,24,1535,70,1966,0,0,45,2283,49,608,45,2891,California
San Benito,2021-01-26,143,3644,44,1579,99,2065,0,0,86,2312,57,665,86,2977,California
San Benito,2021-01-27,232,3876,70,1649,162,2227,0,0,191,2462,41,706,191,3168,California
San Benito,2021-01-28,154,4030,32,1681,122,2349,0,0,124,2557,29,735,124,3292,California
San Benito,2021-01-29,304,4334,37,1718,267,2616,0,0,277,2808,26,761,277,3569,California
San Benito,2021-01-30,55,4389,33,1751,22,2638,0,0,32,2817,23,784,32,3601,California
San Benito,2021-01-31,17,4406,5,1756,12,2650,0,0,12,2824,5,789,12,3613,California
San Benito,2021-02-01,143,4549,31,1787,112,2762,0,0,98,2877,45,834,98,3711,California
San Benito,2021-02-02,235,4784,49,1836,186,2948,0,0,142,2926,93,927,142,3853,California
San Benito,2021-02-03,342,5126,43,1879,299,3247,0,0,276,3136,66,993,276,4129,California
San Benito,2021-02-04,170,5296,24,1903,146,3393,0,0,121,3208,49,1042,121,4250,California
San Benito,2021-02-05,313,5609,46,1949,267,3660,0,0,243,3381,70,1112,243,4493,California
San Benito,2021-02-06,50,5659,9,1958,41,3701,0,0,35,3401,15,1127,35,4528,California
San Benito,2021-02-07,21,5680,11,1969,10,3711,0,0,19,3418,2,1129,19,4547,California
San Benito,2021-02-08,144,5824,17,1986,127,3838,0,0,95,3464,49,1178,95,4642,California
San Benito,2021-02-09,334,6158,65,2051,269,4107,0,0,195,3520,139,1317,195,4837,California
San Benito,2021-02-10,331,6489,90,2141,241,4348,0,0,109,3408,221,1538,109,4946,California
San Benito,2021-02-11,301,6790,30,2171,271,4619,0,0,197,3501,104,1642,197,5143,California
San Benito,2021-02-12,424,7214,31,2202,393,5012,0,0,213,3504,210,1852,213,5356,California
San Benito,2021-02-13,59,7273,7,2209,52,5064,0,0,48,3541,11,1863,48,5404,California
San Benito,2021-02-14,39,7312,6,2215,33,5097,0,0,29,3560,10,1873,29,5433,California
San Benito,2021-02-15,109,7421,10,2225,99,5196,0,0,99,3649,10,1883,99,5532,California
San Benito,2021-02-16,216,7637,12,2237,204,5400,0,0,107,3648,109,1992,108,5640,California
San Benito,2021-02-17,337,7974,31,2268,306,5706,0,0,283,3877,54,2046,283,5923,California
San Benito,2021-02-18,301,8275,40,2308,261,5967,0,0,69,3714,232,2278,69,5992,California
San Benito,2021-02-19,366,8641,53,2361,313,6280,0,0,189,3726,177,2455,189,6181,California
San Benito,2021-02-20,53,8694,28,2389,25,6305,0,0,39,3751,14,2469,39,6220,California
San Benito,2021-02-21,30,8724,15,2404,15,6320,0,0,21,3763,9,2478,21,6241,California
San Benito,2021-02-22,144,8868,37,2441,107,6427,0,0,103,3826,40,2518,103,6344,California
San Benito,2021-02-23,392,9260,98,2539,294,6721,0,0,271,3977,121,2639,272,6616,California
San Benito,2021-02-24,409,9669,80,2619,329,7050,0,0,254,4077,154,2793,254,6870,California
San Benito,2021-02-25,404,10073,71,2690,333,7383,0,0,278,4227,128,2921,278,7148,California
San Benito,2021-02-26,682,10755,85,2775,597,7980,0,0,420,4385,262,3183,420,7568,California
San Benito,2021-02-27,114,10869,44,2819,70,8050,0,0,92,4455,22,3205,92,7660,California
San Benito,2021-02-28,261,11130,33,2852,228,8278,0,0,246,4686,15,3220,246,7906,California
San Benito,2021-03-01,242,11372,65,2917,177,8455,0,0,167,4778,75,3295,167,8073,California
San Benito,2021-03-02,309,11681,103,3020,206,8661,0,0,230,4929,79,3374,230,8303,California
San Benito,2021-03-03,425,12106,68,3088,357,9018,0,0,241,4987,183,3557,241,8544,California
San Benito,2021-03-04,630,12736,131,3219,484,9502,15,15,438,5236,192,3749,441,8985,California
San Benito,2021-03-05,610,13346,318,3537,280,9782,12,27,388,5416,220,3969,400,9385,California
San Benito,2021-03-06,214,13560,79,3616,121,9903,14,41,158,5532,56,4025,172,9557,California
San Benito,2021-03-07,650,14210,600,4216,21,9924,29,70,612,6135,38,4063,641,10198,California
San Benito,2021-03-08,295,14505,68,4284,180,10104,47,117,168,6222,127,4190,214,10412,California
San Benito,2021-03-09,439,14944,90,4374,247,10351,102,219,145,6150,292,4482,220,10632,California
San Benito,2021-03-10,429,15373,133,4507,199,10550,97,316,250,6319,178,4660,347,10979,California
San Benito,2021-03-11,487,15860,130,4637,203,10753,154,470,214,6414,272,4932,367,11346,California
San Benito,2021-03-12,537,16397,128,4765,312,11065,97,567,232,6441,302,5234,329,11675,California
San Benito,2021-03-13,205,16602,102,4867,83,11148,20,587,130,6519,72,5306,150,11825,California
San Benito,2021-03-14,233,16835,41,4908,172,11320,20,607,180,6667,52,5358,200,12025,California
San Benito,2021-03-15,322,17157,97,5005,206,11526,19,626,192,6748,130,5488,211,12236,California
San Benito,2021-03-16,514,17671,226,5231,256,11782,32,658,359,6983,154,5642,389,12625,California
San Benito,2021-03-17,804,18475,482,5713,300,12082,22,680,562,7322,237,5879,576,13201,California
San Benito,2021-03-18,793,19268,534,6247,205,12287,54,734,581,7735,211,6090,624,13825,California
San Benito,2021-03-19,784,20052,407,6654,353,12640,24,758,572,8118,212,6302,595,14420,California
San Benito,2021-03-20,250,20302,153,6807,86,12726,11,769,185,8249,65,6367,196,14616,California
San Benito,2021-03-21,112,20414,59,6866,49,12775,4,773,83,8307,29,6396,87,14703,California
San Benito,2021-03-22,368,20782,183,7049,160,12935,25,798,231,8428,135,6531,256,14959,California
San Benito,2021-03-23,485,21267,202,7251,273,13208,10,808,210,8372,275,6806,219,15178,California
San Benito,2021-03-24,595,21862,316,7567,272,13480,7,815,353,8493,239,7045,360,15538,California
San Benito,2021-03-25,753,22615,448,8015,301,13781,4,819,440,8627,310,7355,444,15982,California
San Benito,2021-03-26,1037,23652,539,8554,494,14275,4,823,337,8268,700,8055,341,16323,California
San Benito,2021-03-27,363,24015,204,8758,123,14398,36,859,230,8402,132,8187,266,16589,California
San Benito,2021-03-28,745,24760,613,9371,126,14524,6,865,132,7928,613,8800,139,16728,California
San Benito,2021-03-29,349,25109,112,9483,217,14741,20,885,142,7883,206,9006,161,16889,California
San Benito,2021-03-30,609,25718,295,9778,218,14959,96,981,306,7982,303,9309,402,17291,California
San Benito,2021-03-31,610,26328,374,10152,212,15171,24,1005,342,8084,264,9573,366,17657,California
San Benito,2021-04-01,977,27305,397,10549,540,15711,40,1045,571,8286,403,9976,605,18262,California
San Benito,2021-04-02,550,27855,264,10813,150,15861,136,1181,272,8417,277,10253,408,18670,California
San Benito,2021-04-03,266,28121,91,10904,110,15971,65,1246,75,8366,190,10443,139,18809,California
San Benito,2021-04-04,144,28265,107,11011,31,16002,6,1252,104,8436,40,10483,110,18919,California
San Benito,2021-04-05,361,28626,174,11185,144,16146,43,1295,150,8417,211,10694,192,19111,California
San Benito,2021-04-06,476,29102,164,11349,129,16275,183,1478,164,8450,312,11006,345,19456,California
San Benito,2021-04-07,957,30059,530,11879,236,16511,191,1669,272,8231,682,11688,463,19919,California
San Benito,2021-04-08,874,30933,437,12316,179,16690,258,1927,229,8075,643,12331,487,20406,California
San Benito,2021-04-09,862,31795,507,12823,262,16952,93,2020,299,7904,562,12893,391,20797,California
San Benito,2021-04-10,361,32156,220,13043,79,17031,62,2082,204,8013,157,13050,266,21063,California
San Benito,2021-04-11,487,32643,279,13322,172,17203,36,2118,277,8093,210,13260,290,21353,California
San Benito,2021-04-12,546,33189,295,13617,133,17336,118,2236,283,8228,262,13522,397,21750,California
San Benito,2021-04-13,765,33954,297,13914,445,17781,23,2259,529,8546,235,13757,553,22303,California
San Benito,2021-04-14,865,34819,680,14594,185,17966,0,2259,405,8500,451,14208,405,22708,California
San Benito,2021-04-15,964,35783,748,15342,215,18181,1,2260,482,8504,480,14688,484,23192,California
San Benito,2021-04-16,721,36504,376,15718,334,18515,11,2271,302,8402,416,15104,314,23506,California
San Benito,2021-04-17,326,36830,229,15947,97,18612,0,2271,133,8340,195,15299,133,23639,California
San Benito,2021-04-18,521,37351,438,16385,83,18695,0,2271,252,8325,269,15568,254,23893,California
San Benito,2021-04-19,763,38114,612,16997,151,18846,0,2271,434,8433,327,15895,435,24328,California
San Benito,2021-04-20,820,38934,443,17440,375,19221,2,2273,511,8641,304,16199,512,24840,California
San Benito,2021-04-21,997,39931,730,18170,267,19488,0,2273,540,8741,440,16639,540,25380,California
San Benito,2021-04-22,938,40869,716,18886,222,19710,0,2273,584,8979,346,16985,584,25964,California
San Benito,2021-04-23,667,41536,424,19310,243,19953,0,2273,356,9074,261,17246,356,26320,California
San Benito,2021-04-24,369,41905,204,19514,165,20118,0,2273,170,9085,159,17405,170,26490,California
San Benito,2021-04-25,209,42114,129,19643,80,20198,0,2273,97,9089,93,17498,97,26587,California
San Benito,2021-04-26,517,42631,411,20054,106,20304,0,2273,268,9171,186,17684,268,26855,California
San Benito,2021-04-27,576,43207,296,20350,272,20576,8,2281,418,9450,147,17831,426,27281,California
San Benito,2021-04-28,578,43785,409,20759,161,20737,8,2289,408,9700,166,17997,416,27697,California
San Benito,2021-04-29,647,44432,245,21004,392,21129,10,2299,260,9602,385,18382,287,27984,California
San Benito,2021-04-30,396,44828,224,21228,164,21293,8,2307,214,9644,180,18562,222,28206,California
San Benito,2021-05-01,211,45039,155,21383,47,21340,9,2316,66,9577,142,18704,75,28281,California
San Benito,2021-05-02,200,45239,169,21552,27,21367,4,2320,60,9501,140,18844,64,28345,California
San Benito,2021-05-03,381,45620,299,21851,70,21437,12,2332,92,9319,288,19132,106,28451,California
San Benito,2021-05-04,429,46049,264,22115,157,21594,8,2340,152,9203,275,19407,159,28610,California
San Benito,2021-05-05,630,46679,446,22561,167,21761,17,2357,219,9031,408,19815,236,28846,California
San Benito,2021-05-06,651,47330,518,23079,117,21878,16,2373,229,8857,419,20234,245,29091,California
San Benito,2021-05-07,470,47800,299,23378,160,22038,11,2384,181,8763,287,20521,193,29284,California
San Benito,2021-05-08,288,48088,231,23609,51,22089,6,2390,155,8791,133,20654,161,29445,California
San Benito,2021-05-09,112,48200,86,23695,23,22112,3,2393,47,8776,65,20719,50,29495,California
San Benito,2021-05-10,439,48639,343,24038,71,22183,25,2418,54,8472,384,21103,80,29575,California
San Benito,2021-05-11,864,49503,449,24487,399,22582,16,2434,198,8023,664,21767,215,29790,California
San Benito,2021-05-12,529,50032,418,24905,98,22680,13,2447,127,7764,400,22167,141,29931,California
San Benito,2021-05-13,756,50788,646,25551,94,22774,16,2463,219,7464,534,22701,234,30165,California
San Benito,2021-05-14,614,51402,457,26008,150,22924,7,2470,237,7332,376,23077,244,30409,California
San Benito,2021-05-15,233,51635,175,26183,52,22976,6,2476,130,7365,103,23180,136,30545,California
San Benito,2021-05-16,173,51808,146,26329,25,23001,2,2478,96,7386,77,23257,98,30643,California
San Benito,2021-05-17,402,52210,320,26649,72,23073,10,2488,176,7349,223,23480,186,30829,California
San Benito,2021-05-18,692,52902,368,27017,319,23392,5,2493,215,7093,477,23957,221,31050,California
San Benito,2021-05-19,587,53489,422,27439,157,23549,8,2501,226,6966,361,24318,234,31284,California
San Benito,2021-05-20,617,54106,485,27924,121,23670,11,2512,325,7012,290,24608,336,31620,California
San Benito,2021-05-21,487,54593,287,28211,183,23853,17,2529,221,6987,263,24871,238,31858,California
San Benito,2021-05-22,311,54904,233,28444,73,23926,5,2534,191,7066,118,24989,197,32055,California
San Benito,2021-05-23,100,55004,62,28506,34,23960,4,2538,36,7041,64,25053,39,32094,California
San Benito,2021-05-24,318,55322,269,28775,42,24002,7,2545,194,7119,123,25176,201,32295,California
San Benito,2021-05-25,535,55857,248,29023,280,24282,7,2552,176,6945,357,25533,183,32478,California
San Benito,2021-05-26,326,56183,201,29224,117,24399,8,2560,130,6888,194,25727,137,32615,California
San Benito,2021-05-27,417,56600,320,29544,74,24473,23,2583,154,6805,263,25990,180,32795,California
San Benito,2021-05-28,302,56902,187,29731,107,24580,8,2591,118,6748,183,26173,126,32921,California
San Benito,2021-05-29,151,57053,129,29860,20,24600,2,2593,66,6731,85,26258,68,32989,California
San Benito,2021-05-30,268,57321,251,30111,17,24617,0,2593,92,6647,176,26434,92,33081,California
San Benito,2021-05-31,104,57425,90,30201,12,24629,2,2595,45,6636,58,26492,47,33128,California
San Benito,2021-06-01,271,57696,125,30326,120,24749,26,2621,86,6564,183,26675,111,33239,California
San Benito,2021-06-02,329,58025,249,30575,78,24827,2,2623,114,6467,214,26889,117,33356,California
San Benito,2021-06-03,349,58374,296,30871,48,24875,5,2628,103,6331,244,27133,108,33464,California
San Benito,2021-06-04,284,58658,214,31085,70,24945,0,2628,89,6226,194,27327,89,33553,California
San Benito,2021-06-05,106,58764,87,31172,18,24963,1,2629,26,6174,79,27406,27,33580,California
San Benito,2021-06-06,60,58824,49,31221,8,24971,3,2632,13,6143,47,27453,16,33596,California
San Benito,2021-06-07,338,59162,300,31521,33,25004,5,2637,87,5986,249,27702,92,33688,California
San Benito,2021-06-08,311,59473,219,31740,77,25081,15,2652,96,5883,214,27916,111,33799,California
San Benito,2021-06-09,246,59719,188,31928,50,25131,8,2660,70,5787,174,28090,78,33877,California
San Benito,2021-06-10,365,60084,334,32262,24,25155,7,2667,75,5582,287,28377,82,33959,California
San Benito,2021-06-11,269,60353,241,32503,23,25178,5,2672,98,5516,169,28546,103,34062,California
San Benito,2021-06-12,167,60520,152,32655,11,25189,4,2676,47,5462,105,28651,51,34113,California
San Benito,2021-06-13,54,60574,43,32698,9,25198,2,2678,17,5451,30,28681,19,34132,California
San Benito,2021-06-14,193,60767,162,32860,27,25225,4,2682,68,5399,123,28804,71,34203,California
San Benito,2021-06-15,226,60993,132,32992,88,25313,6,2688,79,5340,145,28949,86,34289,California
San Benito,2021-06-16,218,61211,174,33166,31,25344,13,2701,74,5284,143,29092,87,34376,California
San Benito,2021-06-17,260,61471,215,33381,17,25361,28,2729,81,5215,179,29271,110,34486,California
San Benito,2021-06-18,166,61637,107,33488,52,25413,7,2736,69,5194,97,29368,76,34562,California
San Benito,2021-06-19,114,61751,108,33596,6,25419,0,2736,48,5176,66,29434,48,34610,California
San Benito,2021-06-20,38,61789,36,33632,2,25421,0,2736,18,5174,20,29454,18,34628,California
San Benito,2021-06-21,117,61906,87,33719,15,25436,15,2751,63,5198,53,29507,77,34705,California
San Benito,2021-06-22,227,62133,126,33845,60,25496,41,2792,74,5160,152,29659,114,34819,California
San Benito,2021-06-23,153,62286,113,33958,30,25526,10,2802,60,5137,93,29752,70,34889,California
San Benito,2021-06-24,189,62475,161,34119,15,25541,13,2815,81,5123,108,29860,94,34983,California
San Benito,2021-06-25,153,62628,120,34239,30,25571,3,2818,62,5098,91,29951,66,35049,California
San Benito,2021-06-26,83,62711,66,34305,15,25586,2,2820,36,5090,46,29997,38,35087,California
San Benito,2021-06-27,59,62770,52,34357,2,25588,5,2825,25,5086,34,30031,30,35117,California
San Benito,2021-06-28,129,62899,105,34462,20,25608,4,2829,54,5069,75,30106,58,35175,California
San Benito,2021-06-29,111,63010,58,34520,41,25649,12,2841,41,5053,70,30176,54,35229,California
San Benito,2021-06-30,142,63152,117,34637,18,25667,7,2848,57,5033,84,30260,64,35293,California
San Benito,2021-07-01,135,63287,105,34742,21,25688,9,2857,53,5012,81,30341,60,35353,California
San Benito,2021-07-02,131,63418,75,34817,44,25732,12,2869,52,4997,79,30420,64,35417,California
San Benito,2021-07-03,104,63522,98,34915,5,25737,1,2870,56,5006,48,30468,57,35474,California
San Benito,2021-07-04,14,63536,13,34928,1,25738,0,2870,6,5004,8,30476,6,35480,California
San Benito,2021-07-05,96,63632,82,35010,13,25751,1,2871,47,5003,49,30525,48,35528,California
San Benito,2021-07-06,123,63755,61,35071,53,25804,9,2880,47,4983,76,30601,56,35584,California
San Benito,2021-07-07,145,63900,107,35178,36,25840,2,2882,50,4942,93,30694,52,35636,California
San Benito,2021-07-08,101,64001,82,35260,15,25855,4,2886,45,4937,54,30748,49,35685,California
San Benito,2021-07-09,85,64086,57,35317,25,25880,3,2889,43,4941,42,30790,46,35731,California
San Benito,2021-07-10,163,64249,103,35420,8,25888,52,2941,47,4924,116,30906,99,35830,California
San Benito,2021-07-11,44,64293,37,35457,7,25895,0,2941,10,4900,34,30940,10,35840,California
San Benito,2021-07-12,92,64385,60,35517,28,25923,4,2945,37,4885,55,30995,40,35880,California
San Benito,2021-07-13,137,64522,74,35591,60,25983,3,2948,55,4861,82,31077,58,35938,California
San Benito,2021-07-14,131,64653,93,35684,31,26014,7,2955,50,4838,80,31157,57,35995,California
San Benito,2021-07-15,155,64808,128,35812,22,26036,5,2960,73,4835,81,31238,78,36073,California
San Benito,2021-07-16,99,64907,74,35886,18,26054,7,2967,52,4847,47,31285,59,36132,California
San Benito,2021-07-17,81,64988,66,35952,14,26068,1,2968,37,4841,44,31329,38,36170,California
San Benito,2021-07-18,26,65014,18,35970,6,26074,2,2970,11,4839,15,31344,13,36183,California
San Benito,2021-07-19,126,65140,100,36070,19,26093,7,2977,71,4861,55,31399,77,36260,California
San Benito,2021-07-20,85,65225,42,36112,38,26131,5,2982,44,4869,41,31440,49,36309,California
San Benito,2021-07-21,160,65385,126,36238,33,26164,1,2983,86,4882,74,31514,87,36396,California
San Benito,2021-07-22,95,65480,72,36310,19,26183,4,2987,49,4889,46,31560,53,36449,California
San Benito,2021-07-23,145,65625,99,36409,39,26222,7,2994,78,4909,65,31625,85,36534,California
San Benito,2021-07-24,105,65730,82,36491,19,26241,4,2998,55,4918,50,31675,59,36593,California
San Benito,2021-07-25,65,65795,57,36548,8,26249,0,2998,40,4934,24,31699,40,36633,California
San Benito,2021-07-26,102,65897,79,36627,19,26268,4,3002,66,4968,36,31735,70,36703,California
San Benito,2021-07-27,124,66021,90,36717,30,26298,4,3006,85,5018,39,31774,89,36792,California
San Benito,2021-07-28,165,66186,132,36849,22,26320,11,3017,109,5081,56,31830,119,36911,California
San Benito,2021-07-29,143,66329,121,36970,15,26335,7,3024,84,5115,57,31887,91,37002,California
San Benito,2021-07-30,120,66449,74,37044,39,26374,7,3031,76,5154,44,31931,83,37085,California
San Benito,2021-07-31,119,66568,94,37138,19,26393,6,3037,75,5192,43,31974,81,37166,California
San Benito,2021-08-01,25,66593,14,37152,10,26403,1,3038,20,5209,4,31978,21,37187,California
San Benito,2021-08-02,111,66704,76,37228,30,26433,5,3043,74,5250,37,32015,78,37265,California
San Benito,2021-08-03,171,66875,118,37346,42,26475,11,3054,109,5309,61,32076,120,37385,California
San Benito,2021-08-04,149,67024,116,37462,25,26500,8,3062,103,5374,46,32122,111,37496,California
San Benito,2021-08-05,183,67207,136,37598,40,26540,7,3069,118,5434,65,32187,125,37621,California
San Benito,2021-08-06,151,67358,99,37697,45,26585,7,3076,94,5478,57,32244,101,37722,California
San Benito,2021-08-07,32,67390,18,37715,14,26599,0,3076,27,5500,5,32249,27,37749,California
San Benito,2021-08-08,113,67503,93,37808,19,26618,1,3077,79,5547,34,32283,81,37830,California
San Benito,2021-08-09,176,67679,113,37921,58,26676,5,3082,91,5559,84,32367,96,37926,California
San Benito,2021-08-10,178,67857,134,38055,37,26713,7,3089,111,5610,67,32434,118,38044,California
San Benito,2021-08-11,170,68027,118,38173,44,26757,8,3097,91,5630,79,32513,99,38143,California
San Benito,2021-08-12,148,68175,95,38268,42,26799,11,3108,82,5658,64,32577,92,38235,California
San Benito,2021-08-13,179,68354,114,38382,59,26858,6,3114,111,5709,67,32644,118,38353,California
San Benito,2021-08-14,171,68525,140,38522,27,26885,4,3118,98,5742,69,32713,102,38455,California
San Benito,2021-08-15,33,68558,17,38539,13,26898,3,3121,26,5764,7,32720,29,38484,California
San Benito,2021-08-16,160,68718,119,38658,34,26932,7,3128,73,5761,83,32803,80,38564,California
San Benito,2021-08-17,133,68851,64,38722,62,26994,7,3135,59,5764,63,32866,66,38630,California
San Benito,2021-08-18,212,69063,131,38853,68,27062,13,3148,107,5789,95,32961,120,38750,California
San Benito,2021-08-19,185,69248,135,38988,37,27099,13,3161,86,5795,93,33054,99,38849,California
San Benito,2021-08-20,200,69448,130,39118,57,27156,13,3174,96,5804,100,33154,109,38958,California
San Benito,2021-08-21,119,69567,90,39208,29,27185,0,3174,59,5807,56,33210,59,39017,California
San Benito,2021-08-22,41,69608,30,39238,11,27196,0,3174,18,5805,20,33230,18,39035,California
San Benito,2021-08-23,141,69749,96,39334,39,27235,6,3180,64,5803,72,33302,70,39105,California
San Benito,2021-08-24,134,69883,87,39421,43,27278,4,3184,69,5817,59,33361,73,39178,California
San Benito,2021-08-25,196,70079,158,39579,31,27309,7,3191,76,5788,112,33473,83,39261,California
San Benito,2021-08-26,233,70312,194,39773,29,27338,10,3201,102,5777,123,33596,112,39373,California
San Benito,2021-08-27,200,70512,149,39922,47,27385,4,3205,83,5766,98,33694,87,39460,California
San Benito,2021-08-28,124,70636,99,40021,21,27406,4,3209,55,5761,64,33758,59,39519,California
San Benito,2021-08-29,50,70686,29,40050,21,27427,0,3209,19,5752,28,33786,19,39538,California
San Benito,2021-08-30,91,70777,60,40110,30,27457,1,3210,37,5743,47,33833,38,39576,California
San Bernardino,2020-12-15,13,13,13,13,0,0,0,0,13,13,0,0,13,13,California
San Bernardino,2020-12-16,119,132,119,132,0,0,0,0,119,132,0,0,119,132,California
San Bernardino,2020-12-17,2417,2549,2417,2549,0,0,0,0,2416,2548,0,0,2416,2548,California
San Bernardino,2020-12-18,3305,5854,3301,5850,4,4,0,0,3307,5855,0,0,3307,5855,California
San Bernardino,2020-12-19,1162,7016,1161,7011,1,5,0,0,1163,7018,0,0,1163,7018,California
San Bernardino,2020-12-20,1226,8242,1222,8233,4,9,0,0,1227,8245,0,0,1227,8245,California
San Bernardino,2020-12-21,2496,10738,2489,10722,7,16,0,0,2496,10741,0,0,2496,10741,California
San Bernardino,2020-12-22,2303,13041,2170,12892,133,149,0,0,2303,13044,0,0,2303,13044,California
San Bernardino,2020-12-23,2720,15761,1500,14392,1220,1369,0,0,2720,15764,0,0,2720,15764,California
San Bernardino,2020-12-24,1180,16941,599,14991,581,1950,0,0,1180,16943,1,1,1180,16944,California
San Bernardino,2020-12-25,78,17019,17,15008,61,2011,0,0,78,17021,0,1,78,17022,California
San Bernardino,2020-12-26,466,17485,253,15261,213,2224,0,0,466,17487,0,1,466,17488,California
San Bernardino,2020-12-27,352,17837,166,15427,186,2410,0,0,351,17837,1,2,351,17839,California
San Bernardino,2020-12-28,1617,19454,704,16131,913,3323,0,0,1616,19452,1,3,1616,19455,California
San Bernardino,2020-12-29,2305,21759,1050,17181,1255,4578,0,0,2305,21757,0,3,2305,21760,California
San Bernardino,2020-12-30,2965,24724,1476,18657,1489,6067,0,0,2964,24721,0,3,2964,24724,California
San Bernardino,2020-12-31,1403,26127,447,19104,956,7023,0,0,1401,26122,0,3,1401,26125,California
San Bernardino,2021-01-01,260,26387,151,19255,109,7132,0,0,259,26381,0,3,259,26384,California
San Bernardino,2021-01-02,498,26885,348,19603,150,7282,0,0,497,26878,0,3,497,26881,California
San Bernardino,2021-01-03,177,27062,87,19690,90,7372,0,0,177,27055,0,3,177,27058,California
San Bernardino,2021-01-04,2173,29235,1308,20998,865,8237,0,0,2172,29227,0,3,2172,29230,California
San Bernardino,2021-01-05,2389,31624,1485,22483,904,9141,0,0,2274,31388,113,116,2274,31504,California
San Bernardino,2021-01-06,3589,35213,2465,24948,1124,10265,0,0,2991,33790,591,707,2993,34497,California
San Bernardino,2021-01-07,5560,40773,4606,29554,954,11219,0,0,2516,33282,3025,3732,2517,37014,California
San Bernardino,2021-01-08,5486,46259,4535,34089,951,12170,0,0,2318,32438,3164,6896,2320,39334,California
San Bernardino,2021-01-09,1434,47693,1118,35207,316,12486,0,0,915,32834,519,7415,915,40249,California
San Bernardino,2021-01-10,1042,48735,607,35814,435,12921,0,0,586,32965,455,7870,586,40835,California
San Bernardino,2021-01-11,5014,53749,4102,39916,912,13833,0,0,2774,33503,2236,10106,2774,43609,California
San Bernardino,2021-01-12,4285,58034,3245,43161,1040,14873,0,0,2543,34308,1738,11844,2543,46152,California
San Bernardino,2021-01-13,4672,62706,2908,46069,1764,16637,0,0,3412,36472,1249,13093,3413,49565,California
San Bernardino,2021-01-14,4915,67621,2896,48965,2019,18656,0,0,4308,40177,603,13696,4308,53873,California
San Bernardino,2021-01-15,6096,73717,3023,51988,3073,21729,0,0,5697,45486,391,14087,5700,59573,California
San Bernardino,2021-01-16,2283,76000,1298,53286,985,22714,0,0,2134,47471,149,14236,2134,61707,California
San Bernardino,2021-01-17,1187,77187,504,53790,683,23397,0,0,1104,48494,82,14318,1105,62812,California
San Bernardino,2021-01-18,4297,81484,2645,56435,1652,25049,0,0,3664,51528,633,14951,3667,66479,California
San Bernardino,2021-01-19,6558,88042,3749,60184,2809,27858,0,0,5450,55874,1106,16057,5452,71931,California
San Bernardino,2021-01-20,6965,95007,3810,63994,3155,31013,0,0,4969,58860,1985,18042,4971,76902,California
San Bernardino,2021-01-21,6155,101162,3187,67181,2968,33981,0,0,5019,62754,1127,19169,5021,81923,California
San Bernardino,2021-01-22,6630,107792,3103,70284,3527,37508,0,0,5893,67913,735,19904,5894,87817,California
San Bernardino,2021-01-23,3161,110953,1891,72175,1270,38778,0,0,2756,70265,404,20308,2756,90573,California
San Bernardino,2021-01-24,1217,112170,465,72640,752,39530,0,0,1111,71270,106,20414,1111,91684,California
San Bernardino,2021-01-25,7014,119184,3429,76069,3585,43115,0,0,5115,74495,1897,22311,5122,96806,California
San Bernardino,2021-01-26,7204,126388,3515,79584,3689,46804,0,0,4978,77249,2226,24537,4980,101786,California
San Bernardino,2021-01-27,8744,135132,4196,83780,4548,51352,0,0,5822,80158,2914,27451,5823,107609,California
San Bernardino,2021-01-28,8739,143871,4125,87905,4614,55966,0,0,6370,84168,2360,29811,6370,113979,California
San Bernardino,2021-01-29,8289,152160,3782,91687,4507,60473,0,0,6262,88424,2007,31818,6263,120242,California
San Bernardino,2021-01-30,3107,155267,1867,93554,1240,61713,0,0,2802,90925,303,32121,2804,123046,California
San Bernardino,2021-01-31,953,156220,490,94044,463,62176,0,0,890,91754,62,32183,891,123937,California
San Bernardino,2021-02-01,7684,163904,4266,98310,3418,65594,0,0,4973,94022,2706,34889,4974,128911,California
San Bernardino,2021-02-02,10640,174544,3681,101991,6959,72553,0,0,8492,100372,2144,37033,8494,137405,California
San Bernardino,2021-02-03,9154,183698,4155,106146,4999,77552,0,0,6580,104387,2566,39599,6581,143986,California
San Bernardino,2021-02-04,10611,194309,5187,111333,5424,82976,0,0,7451,108691,3148,42747,7452,151438,California
San Bernardino,2021-02-05,11253,205562,5995,117328,5258,88234,0,0,7596,112642,3646,46393,7597,159035,California
San Bernardino,2021-02-06,5314,210876,2224,119552,3090,91324,0,0,3658,114673,1630,48023,3661,162696,California
San Bernardino,2021-02-07,857,211733,495,120047,362,91686,0,0,465,114752,387,48410,466,163162,California
San Bernardino,2021-02-08,7402,219135,3950,123997,3452,95138,0,0,5694,118742,1705,50115,5695,168857,California
San Bernardino,2021-02-09,10281,229416,5961,129958,4320,99458,0,0,6899,122269,3376,53491,6903,175760,California
San Bernardino,2021-02-10,12295,241711,6530,136488,5765,105223,0,0,8082,126149,4203,57694,8083,183843,California
San Bernardino,2021-02-11,12646,254357,7236,143724,5410,110633,0,0,7986,129509,4632,62326,7992,191835,California
San Bernardino,2021-02-12,10660,265017,6021,149745,4639,115272,0,0,5772,130419,4866,67192,5776,197611,California
San Bernardino,2021-02-13,6186,271203,4101,153846,2085,117357,0,0,3888,132032,2280,69472,3893,201504,California
San Bernardino,2021-02-14,1602,272805,680,154526,922,118279,0,0,902,132242,693,70165,903,202407,California
San Bernardino,2021-02-15,5567,278372,3032,157558,2535,120814,0,0,3104,132897,2449,72614,3104,205511,California
San Bernardino,2021-02-16,12766,291138,7423,164981,5343,126157,0,0,7935,136021,4816,77430,7940,213451,California
San Bernardino,2021-02-17,12026,303164,6572,171553,5454,131611,0,0,7220,138467,4780,82210,7226,220677,California
San Bernardino,2021-02-18,12721,315885,7686,179239,5035,136646,0,0,7806,141384,4893,87103,7810,228487,California
San Bernardino,2021-02-19,11905,327790,6104,185343,5801,142447,0,0,7011,143528,4869,91972,7013,235500,California
San Bernardino,2021-02-20,4667,332457,3571,188914,1096,143543,0,0,2087,143049,2569,94541,2090,237590,California
San Bernardino,2021-02-21,1214,333671,739,189653,475,144018,0,0,426,142690,787,95328,428,238018,California
San Bernardino,2021-02-22,9161,342832,5647,195300,3514,147532,0,0,4200,141955,4936,100264,4201,242219,California
San Bernardino,2021-02-23,9988,352820,6057,201357,3931,151463,0,0,5048,142107,4903,105167,5055,247274,California
San Bernardino,2021-02-24,13133,365953,7554,208911,5579,157042,0,0,6391,141792,6714,111881,6399,253673,California
San Bernardino,2021-02-25,13812,379765,6665,215576,7147,164189,0,0,7946,143906,5838,117719,7952,261625,California
San Bernardino,2021-02-26,14417,394182,6753,222329,7664,171853,0,0,7987,145549,6354,124073,7997,269622,California
San Bernardino,2021-02-27,7015,401197,3913,226242,3099,174952,3,3,5021,148598,1979,126052,5028,274650,California
San Bernardino,2021-02-28,1908,403105,814,227056,1094,176046,0,3,1206,149117,689,126741,1208,275858,California
San Bernardino,2021-03-01,8876,411981,4592,231648,4277,180323,7,10,4002,148299,4838,131579,4020,279878,California
San Bernardino,2021-03-02,14460,426441,5799,237447,8661,188984,0,10,6710,147311,7709,139288,6721,286599,California
San Bernardino,2021-03-03,13521,439962,6906,244353,6610,195594,5,15,6343,146524,7146,146434,6359,292958,California
San Bernardino,2021-03-04,14332,454294,7072,251425,7259,202853,1,16,6194,144619,8109,154543,6204,299162,California
San Bernardino,2021-03-05,14718,469012,7618,259043,7098,209951,2,18,7095,144154,7583,162126,7118,306280,California
San Bernardino,2021-03-06,9850,478862,5519,264562,4098,214049,233,251,4552,143660,5274,167400,4780,311060,California
San Bernardino,2021-03-07,1809,480671,1045,265607,624,214673,140,391,1104,144203,702,168102,1245,312305,California
San Bernardino,2021-03-08,8264,488935,3643,269250,4433,219106,188,579,3669,143476,4586,172688,3859,316164,California
San Bernardino,2021-03-09,13245,502180,7546,276796,5437,224543,262,841,5301,141115,7925,180613,5564,321728,California
San Bernardino,2021-03-10,14357,516537,7912,284708,5890,230433,555,1396,6399,140138,7928,188541,6951,328679,California
San Bernardino,2021-03-11,16044,532581,7562,292270,6860,237293,1622,3018,7468,140668,8549,197090,9079,337758,California
San Bernardino,2021-03-12,15930,548511,7209,299479,6663,243956,2058,5076,7414,141690,8479,205569,9501,347259,California
San Bernardino,2021-03-13,8487,556998,4597,304076,3358,247314,532,5608,4985,143724,3485,209054,5519,352778,California
San Bernardino,2021-03-14,3356,560354,1701,305777,1066,248380,589,6197,1859,144678,1487,210541,2441,355219,California
San Bernardino,2021-03-15,11524,571878,5443,311220,4055,252435,2026,8223,5425,146039,6076,216617,7437,362656,California
San Bernardino,2021-03-16,16374,588252,8100,319320,7330,259765,944,9167,9854,150357,6483,223100,10801,373457,California
San Bernardino,2021-03-17,17625,605877,8755,328075,8123,267888,747,9914,10534,154571,7063,230163,11277,384734,California
San Bernardino,2021-03-18,16937,622814,8379,336454,8159,276047,399,10313,9833,157731,7068,237231,10228,394962,California
San Bernardino,2021-03-19,17320,640134,8618,345072,8097,284144,605,10918,9738,160576,7545,244776,10390,405352,California
San Bernardino,2021-03-20,9659,649793,6043,351115,3006,287150,610,11528,5641,162831,3988,248764,6243,411595,California
San Bernardino,2021-03-21,2889,652682,2331,353446,504,287654,54,11582,2273,164562,595,249359,2326,413921,California
San Bernardino,2021-03-22,9818,662500,4641,358087,4736,292390,441,12023,7059,169335,2727,252086,7500,421421,California
San Bernardino,2021-03-23,15842,678342,8963,367050,6250,298640,629,12652,9641,173430,6169,258255,10264,431685,California
San Bernardino,2021-03-24,15398,693740,7913,374963,7170,305810,315,12967,10033,178460,5319,263574,10349,442034,California
San Bernardino,2021-03-25,17321,711061,8478,383441,8532,314342,311,13278,10802,183112,6455,270029,11107,453141,California
San Bernardino,2021-03-26,18561,729622,8791,392232,8998,323340,772,14050,10940,187243,7581,277610,11712,464853,California
San Bernardino,2021-03-27,11014,740636,7079,399311,3173,326513,762,14812,6220,189457,4766,282376,6980,471833,California
San Bernardino,2021-03-28,3711,744347,2603,401914,989,327502,119,14931,2552,190980,1147,283523,2670,474503,California
San Bernardino,2021-03-29,12208,756555,6208,408122,5598,333100,402,15333,7997,195193,4186,287709,8399,482902,California
San Bernardino,2021-03-30,17153,773708,9563,417685,6870,339970,720,16053,10529,199851,6579,294288,11237,494139,California
San Bernardino,2021-03-31,16798,790506,9446,427131,6705,346675,647,16700,10921,205587,5829,300117,11565,505704,California
San Bernardino,2021-04-01,20071,810577,10608,437739,8022,354697,1441,18141,12794,212583,7221,307338,14217,519921,California
San Bernardino,2021-04-02,19105,829682,9585,447324,8220,362917,1300,19441,11488,217831,7579,314917,12827,532748,California
San Bernardino,2021-04-03,11255,840937,7022,454346,3083,366000,1150,20591,6122,219980,5112,320029,7261,540009,California
San Bernardino,2021-04-04,2546,843483,1532,455878,757,366757,257,20848,1270,220243,1262,321291,1525,541534,California
San Bernardino,2021-04-05,12007,855490,5368,461246,4830,371587,1809,22657,6060,222185,5915,327206,7857,549391,California
San Bernardino,2021-04-06,20009,875499,11255,472501,6621,378208,2133,24790,10521,225388,9436,336642,12639,562030,California
San Bernardino,2021-04-07,21352,896851,11459,483960,7365,385573,2528,27318,11552,229686,9759,346401,14057,576087,California
San Bernardino,2021-04-08,22231,919082,11403,495363,8167,393740,2661,29979,12152,234429,10047,356448,14790,590877,California
San Bernardino,2021-04-09,22130,941212,11248,506611,8227,401967,2655,32634,11962,238907,10113,366561,14591,605468,California
San Bernardino,2021-04-10,15881,957093,8224,514835,3903,405870,3754,36388,7882,242545,7974,374535,11612,617080,California
San Bernardino,2021-04-11,4542,961635,2643,517478,907,406777,992,37380,2077,243145,2457,376992,3057,620137,California
San Bernardino,2021-04-12,13663,975298,6316,523794,5677,412454,1670,39050,6493,244150,7141,384133,8146,628283,California
San Bernardino,2021-04-13,19642,994940,11192,534986,8429,420883,21,39071,11235,247041,8366,392499,11257,639540,California
San Bernardino,2021-04-14,19697,1014637,10499,545485,9195,430078,3,39074,11042,249477,8612,401111,11048,650588,California
San Bernardino,2021-04-15,20728,1035365,11554,557039,9167,439245,7,39081,10897,250605,9777,410888,10905,661493,California
San Bernardino,2021-04-16,19072,1054437,10788,567827,8282,447527,2,39083,9272,250129,9751,420639,9275,670768,California
San Bernardino,2021-04-17,12180,1066617,8028,575855,4151,451678,1,39084,6301,250601,5830,426469,6302,677070,California
San Bernardino,2021-04-18,3294,1069911,2359,578214,935,452613,0,39084,1402,250128,1875,428344,1402,678472,California
San Bernardino,2021-04-19,12766,1082677,6806,585020,5959,458572,1,39085,4879,247159,7856,436200,4887,683359,California
San Bernardino,2021-04-20,18363,1101040,10376,595396,7984,466556,3,39088,8241,245323,10084,446284,8248,691607,California
San Bernardino,2021-04-21,19298,1120338,11347,606743,7945,474501,6,39094,8354,242818,10867,457151,8362,699969,California
San Bernardino,2021-04-22,20066,1140404,11655,618398,8407,482908,4,39098,8092,239011,11909,469060,8102,708071,California
San Bernardino,2021-04-23,19280,1159684,11188,629586,8090,490998,2,39100,8269,236336,10948,480008,8273,716344,California
San Bernardino,2021-04-24,13151,1172835,9660,639246,3489,494487,2,39102,7056,237324,6071,486079,7059,723403,California
San Bernardino,2021-04-25,3482,1176317,2276,641522,1206,495693,0,39102,1705,237276,1756,487835,1708,725111,California
San Bernardino,2021-04-26,11547,1187864,6304,647826,5153,500846,90,39192,4911,235687,6591,494426,5002,730113,California
San Bernardino,2021-04-27,17026,1204890,10330,658156,6480,507326,216,39408,6967,232865,10004,504430,7182,737295,California
San Bernardino,2021-04-28,15400,1220290,9280,667436,5842,513168,278,39686,5555,228878,9810,514240,5823,743118,California
San Bernardino,2021-04-29,16945,1237235,9881,677317,6789,519957,275,39961,5682,223611,11221,525461,5954,749072,California
San Bernardino,2021-04-30,17241,1254476,10966,688283,5988,525945,287,40248,6377,219467,10808,536269,6664,755736,California
San Bernardino,2021-05-01,11045,1265521,8597,696880,2128,528073,320,40568,3818,216391,7208,543477,4132,759868,California
San Bernardino,2021-05-02,3015,1268536,2185,699065,698,528771,132,40700,1075,215670,1926,545403,1205,761073,California
San Bernardino,2021-05-03,10269,1278805,5929,704994,3929,532700,411,41111,2932,211693,7319,552722,3342,764415,California
San Bernardino,2021-05-04,16306,1295111,10033,715027,5809,538509,464,41575,4759,205415,11498,564220,5220,769635,California
San Bernardino,2021-05-05,15989,1311100,9382,724409,6194,544703,413,41988,4515,198917,11420,575640,4922,774557,California
San Bernardino,2021-05-06,16376,1327476,9479,733888,6473,551176,424,42412,4488,191992,11835,587475,4910,779467,California
San Bernardino,2021-05-07,15917,1343393,9005,742893,6539,557715,373,42785,4713,185948,11124,598599,5080,784547,California
San Bernardino,2021-05-08,9787,1353180,6569,749462,2948,560663,270,43055,3382,183236,6365,604964,3653,788200,California
San Bernardino,2021-05-09,2110,1355290,1408,750870,611,561274,91,43146,837,182899,1265,606229,928,789128,California
San Bernardino,2021-05-10,7845,1363135,3620,754490,3906,565180,319,43465,2388,180195,5410,611639,2706,791834,California
San Bernardino,2021-05-11,12927,1376062,7232,761722,5331,570511,364,43829,4147,175974,8732,620371,4511,796345,California
San Bernardino,2021-05-12,13136,1389198,7160,768882,5640,576151,336,44165,3749,170728,9328,629699,4082,800427,California
San Bernardino,2021-05-13,13823,1403021,8371,777253,5094,581245,358,44523,5379,168067,8392,638091,5731,806158,California
San Bernardino,2021-05-14,14282,1417303,9497,786750,4436,585681,349,44872,5937,166063,8290,646381,6286,812444,California
San Bernardino,2021-05-15,11632,1428935,8667,795417,2770,588451,195,45067,4717,164094,6874,653255,4905,817349,California
San Bernardino,2021-05-16,3151,1432086,2396,797813,691,589142,64,45131,1571,164168,1561,654816,1635,818984,California
San Bernardino,2021-05-17,10210,1442296,6857,804670,3070,592212,283,45414,4503,163285,5665,660481,4782,823766,California
San Bernardino,2021-05-18,14029,1456325,9302,813972,4463,596675,264,45678,6278,162111,7712,668193,6538,830304,California
San Bernardino,2021-05-19,11741,1468066,7350,821322,4014,600689,377,46055,5291,161370,6404,674597,5663,835967,California
San Bernardino,2021-05-20,11857,1479923,7123,828445,4419,605108,315,46370,5124,160124,6687,681284,5441,841408,California
San Bernardino,2021-05-21,12813,1492736,8507,836952,3925,609033,381,46751,5396,158545,7350,688634,5771,847179,California
San Bernardino,2021-05-22,9174,1501910,6837,843789,2127,611160,210,46961,4369,158365,4755,693389,4575,851754,California
San Bernardino,2021-05-23,2473,1504383,1577,845366,802,611962,94,47055,1141,158287,1314,694703,1236,852990,California
San Bernardino,2021-05-24,7120,1511503,4538,849904,2270,614232,312,47367,3150,157839,3909,698612,3461,856451,California
San Bernardino,2021-05-25,9578,1521081,5861,855765,3444,617676,273,47640,4225,157023,5308,703920,4492,860943,California
San Bernardino,2021-05-26,8363,1529444,5306,861071,2798,620474,259,47899,3797,156555,4516,708436,4048,864991,California
San Bernardino,2021-05-27,7804,1537248,4745,865816,2822,623296,237,48136,3487,156007,4269,712705,3721,868712,California
San Bernardino,2021-05-28,9035,1546283,5613,871429,3140,626436,282,48418,4502,156307,4482,717187,4782,873494,California
San Bernardino,2021-05-29,5164,1551447,3457,874886,1587,628023,120,48538,2597,156476,2547,719734,2716,876210,California
San Bernardino,2021-05-30,1786,1553233,1254,876140,447,628470,85,48623,859,156501,918,720652,943,877153,California
San Bernardino,2021-05-31,913,1554146,579,876719,316,628786,18,48641,326,156267,579,721231,345,877498,California
San Bernardino,2021-06-01,8868,1563014,5707,882426,2910,631696,251,48892,3446,154615,5345,726576,3693,881191,California
San Bernardino,2021-06-02,7039,1570053,4438,886864,2350,634046,251,49143,2974,153816,4020,730596,3221,884412,California
San Bernardino,2021-06-03,8212,1578265,5564,892428,2448,636494,200,49343,2798,151427,5387,735983,2998,887410,California
San Bernardino,2021-06-04,9401,1587666,6364,898792,2735,639229,302,49645,3225,148843,6112,742095,3528,890938,California
San Bernardino,2021-06-05,6685,1594351,5096,903888,1461,640690,128,49773,2287,146878,4377,746472,2412,893350,California
San Bernardino,2021-06-06,2057,1596408,1721,905609,272,640962,64,49837,680,146253,1369,747841,744,894094,California
San Bernardino,2021-06-07,6408,1602816,4982,910591,1213,642175,213,50050,2025,144138,4351,752192,2236,896330,California
San Bernardino,2021-06-08,8537,1611353,6197,916788,2116,644291,224,50274,2636,141171,5822,758014,2855,899185,California
San Bernardino,2021-06-09,7113,1618466,5064,921852,1858,646149,191,50465,2301,138907,4759,762773,2495,901680,California
San Bernardino,2021-06-10,7230,1625696,5090,926942,1929,648078,211,50676,2244,136430,4929,767702,2452,904132,California
San Bernardino,2021-06-11,8231,1633927,5745,932687,2249,650327,237,50913,2961,134408,5216,772918,3194,907326,California
San Bernardino,2021-06-12,6029,1639956,4744,937431,1163,651490,122,51035,1742,132017,4258,777176,1867,909193,California
San Bernardino,2021-06-13,1517,1641473,1075,938506,367,651857,75,51110,413,131406,1098,778274,487,909680,California
San Bernardino,2021-06-14,5017,1646490,3626,942132,1163,653020,228,51338,1831,130308,3155,781429,2057,911737,California
San Bernardino,2021-06-15,7347,1653837,5198,947330,1899,654919,250,51588,2614,128496,4673,786102,2861,914598,California
San Bernardino,2021-06-16,6532,1660369,4663,951993,1641,656560,228,51816,2408,127075,4055,790157,2634,917232,California
San Bernardino,2021-06-17,5809,1666178,4064,956057,1579,658139,166,51982,2264,125999,3506,793663,2430,919662,California
San Bernardino,2021-06-18,7020,1673198,4716,960773,2060,660199,244,52226,2624,124512,4352,798015,2865,922527,California
San Bernardino,2021-06-19,4097,1677295,3056,963829,905,661104,136,52362,1751,124072,2324,800339,1884,924411,California
San Bernardino,2021-06-20,1475,1678770,1132,964961,284,661388,59,52421,590,123844,876,801215,648,925059,California
San Bernardino,2021-06-21,3620,1682390,2348,967309,1040,662428,232,52653,1992,124454,1612,802827,2222,927281,California
San Bernardino,2021-06-22,5768,1688158,3924,971233,1626,664054,218,52871,2276,123492,3457,806284,2495,929776,California
San Bernardino,2021-06-23,5109,1693267,3613,974846,1286,665340,210,53081,2119,122856,2958,809242,2322,932098,California
San Bernardino,2021-06-24,5020,1698287,3490,978336,1313,666653,217,53298,2110,122320,2859,812101,2323,934421,California
San Bernardino,2021-06-25,5942,1704229,4178,982514,1552,668205,212,53510,2573,121769,3335,815436,2784,937205,California
San Bernardino,2021-06-26,3621,1707850,2766,985280,777,668982,78,53588,1687,121622,1911,817347,1764,938969,California
San Bernardino,2021-06-27,1484,1709334,1185,986465,247,669229,52,53640,700,121599,775,818122,752,939721,California
San Bernardino,2021-06-28,3614,1712948,2847,989312,614,669843,153,53793,1742,121674,1816,819938,1891,941612,California
San Bernardino,2021-06-29,5287,1718235,3822,993134,1277,671120,188,53981,2412,121421,2847,822785,2594,944206,California
San Bernardino,2021-06-30,4763,1722998,3349,996483,1237,672357,177,54158,2395,121665,2324,825109,2568,946774,California
San Bernardino,2021-07-01,4333,1727331,3096,999579,1065,673422,172,54330,2140,121814,2162,827271,2311,949085,California
San Bernardino,2021-07-02,5294,1732625,3771,1003350,1347,674769,176,54506,2489,121710,2767,830038,2663,951748,California
San Bernardino,2021-07-03,2601,1735226,1957,1005307,588,675357,56,54562,1262,121705,1322,831360,1317,953065,California
San Bernardino,2021-07-04,215,1735441,146,1005453,64,675421,5,54567,116,121728,98,831458,121,953186,California
San Bernardino,2021-07-05,2338,1737779,1812,1007265,473,675894,53,54620,1146,121754,1175,832633,1201,954387,California
San Bernardino,2021-07-06,5264,1743043,3890,1011155,1209,677103,165,54785,2291,121262,2950,835583,2458,956845,California
San Bernardino,2021-07-07,4327,1747370,3181,1014336,1015,678118,131,54916,2002,121092,2301,837884,2131,958976,California
San Bernardino,2021-07-08,4118,1751488,3008,1017344,955,679073,155,55071,1863,120876,2235,840119,2019,960995,California
San Bernardino,2021-07-09,4892,1756380,3531,1020875,1167,680240,194,55265,2260,120723,2602,842721,2449,963444,California
San Bernardino,2021-07-10,2981,1759361,2235,1023110,637,680877,109,55374,1489,120842,1478,844199,1597,965041,California
San Bernardino,2021-07-11,1281,1760642,960,1024070,281,681158,40,55414,635,120880,639,844838,677,965718,California
San Bernardino,2021-07-12,3562,1764204,2686,1026756,710,681868,166,55580,1644,120780,1906,846744,1806,967524,California
San Bernardino,2021-07-13,4663,1768867,3419,1030175,1091,682959,153,55733,2192,120684,2443,849187,2347,969871,California
San Bernardino,2021-07-14,4096,1772963,2972,1033147,976,683935,148,55881,1955,120669,2115,851302,2100,971971,California
San Bernardino,2021-07-15,4112,1777075,3044,1036191,944,684879,124,56005,2021,120756,2058,853360,2145,974116,California
San Bernardino,2021-07-16,5108,1782183,3752,1039943,1211,686090,145,56150,2629,121083,2446,855806,2773,976889,California
San Bernardino,2021-07-17,3507,1785690,2691,1042634,766,686856,50,56200,1823,121297,1658,857464,1872,978761,California
San Bernardino,2021-07-18,1431,1787121,1133,1043767,276,687132,22,56222,777,121450,646,858110,799,979560,California
San Bernardino,2021-07-19,3809,1790930,2930,1046697,731,687863,148,56370,1980,121773,1803,859913,2126,981686,California
San Bernardino,2021-07-20,4988,1795918,3632,1050329,1171,689034,185,56555,2673,122344,2284,862197,2855,984541,California
San Bernardino,2021-07-21,4638,1800556,3476,1053805,1032,690066,130,56685,2453,122769,2157,864354,2582,987123,California
San Bernardino,2021-07-22,4835,1805391,3625,1057430,1089,691155,121,56806,2711,123513,2090,866444,2834,989957,California
San Bernardino,2021-07-23,5650,1811041,4155,1061585,1339,692494,156,56962,3248,124544,2373,868817,3404,993361,California
San Bernardino,2021-07-24,3536,1814577,2675,1064260,778,693272,83,57045,2077,125268,1437,870254,2161,995522,California
San Bernardino,2021-07-25,1598,1816175,1212,1065472,371,693643,15,57060,1178,126048,412,870666,1192,996714,California
San Bernardino,2021-07-26,4179,1820354,3005,1068477,1046,694689,128,57188,2739,127501,1416,872082,2869,999583,California
San Bernardino,2021-07-27,5589,1825943,4159,1072636,1248,695937,182,57370,3302,128735,2248,874330,3482,1003065,California
San Bernardino,2021-07-28,5368,1831311,3991,1076627,1232,697169,145,57515,3185,129921,2145,876475,3331,1006396,California
San Bernardino,2021-07-29,5047,1836358,3632,1080259,1243,698412,172,57687,3116,131304,1905,878380,3288,1009684,California
San Bernardino,2021-07-30,6064,1842422,4464,1084723,1397,699809,203,57890,3755,132994,2266,880646,3956,1013640,California
San Bernardino,2021-07-31,3625,1846047,2809,1087532,763,700572,53,57943,2268,133977,1338,881984,2321,1015961,California
San Bernardino,2021-08-01,1799,1847846,1433,1088965,346,700918,20,57963,1224,134656,565,882549,1244,1017205,California
San Bernardino,2021-08-02,4734,1852580,3630,1092595,977,701895,127,58090,3110,136288,1605,884154,3237,1020442,California
San Bernardino,2021-08-03,5718,1858298,4267,1096862,1270,703165,181,58271,3392,137574,2285,886439,3571,1024013,California
San Bernardino,2021-08-04,5430,1863728,4100,1100962,1140,704305,190,58461,3374,139115,2020,888459,3561,1027574,California
San Bernardino,2021-08-05,5240,1868968,3885,1104847,1161,705466,194,58655,3212,140517,2002,890461,3404,1030978,California
San Bernardino,2021-08-06,6502,1875470,4889,1109736,1385,706851,228,58883,3918,142113,2549,893010,4145,1035123,California
San Bernardino,2021-08-07,3851,1879321,2967,1112703,798,707649,86,58969,2345,143056,1488,894498,2431,1037554,California
San Bernardino,2021-08-08,2091,1881412,1589,1114292,490,708139,12,58981,1329,143649,749,895247,1342,1038896,California
San Bernardino,2021-08-09,4793,1886205,3684,1117976,947,709086,162,59143,2761,144568,2004,897251,2923,1041819,California
San Bernardino,2021-08-10,5326,1891531,3984,1121960,1183,710269,159,59302,2914,145257,2381,899632,3070,1044889,California
San Bernardino,2021-08-11,4910,1896441,3721,1125681,1036,711305,153,59455,2770,146076,2101,901733,2920,1047809,California
San Bernardino,2021-08-12,5115,1901556,3795,1129476,1136,712441,184,59639,2857,146893,2220,903953,3037,1050846,California
San Bernardino,2021-08-13,7389,1908945,5641,1135117,1511,713952,237,59876,4096,147994,3229,907182,4330,1055176,California
San Bernardino,2021-08-14,4480,1913425,3514,1138631,878,714830,88,59964,2559,148821,1821,909003,2648,1057824,California
San Bernardino,2021-08-15,2181,1915606,1613,1140244,549,715379,19,59983,1177,149093,924,909927,1196,1059020,California
San Bernardino,2021-08-16,5348,1920954,3987,1144231,1185,716564,176,60159,2739,149622,2381,912308,2910,1061930,California
San Bernardino,2021-08-17,6257,1927211,4651,1148882,1375,717939,231,60390,3071,149995,2927,915235,3300,1065230,California
San Bernardino,2021-08-18,5987,1933198,4443,1153325,1360,719299,184,60574,2952,150370,2763,917998,3138,1068368,California
San Bernardino,2021-08-19,6009,1939207,4340,1157665,1475,720774,194,60768,2970,150793,2740,920738,3163,1071531,California
San Bernardino,2021-08-20,7578,1946785,5689,1163354,1664,722438,225,60993,3595,150956,3658,924396,3821,1075352,California
San Bernardino,2021-08-21,4358,1951143,3383,1166737,850,723288,125,61118,2067,151035,2113,926509,2192,1077544,California
San Bernardino,2021-08-22,2242,1953385,1709,1168446,516,723804,17,61135,1084,151066,1069,927578,1100,1078644,California
San Bernardino,2021-08-23,5772,1959157,4324,1172770,1304,725108,144,61279,2529,150765,2973,930551,2672,1081316,California
San Bernardino,2021-08-24,6217,1965374,4902,1177672,1122,726230,193,61472,2866,150740,3082,933633,3057,1084373,California
San Bernardino,2021-08-25,5897,1971271,4724,1182396,1031,727261,142,61614,2708,150620,2970,936603,2850,1087223,California
San Bernardino,2021-08-26,5694,1976965,4340,1186736,1182,728443,172,61786,2536,150429,2898,939501,2707,1089930,California
San Bernardino,2021-08-27,7219,1984184,5650,1192386,1373,729816,196,61982,3009,149867,3759,943260,3197,1093127,California
San Bernardino,2021-08-28,4226,1988410,3403,1195789,760,730576,63,62045,1854,149572,2210,945470,1915,1095042,California
San Bernardino,2021-08-29,2293,1990703,1814,1197603,468,731044,11,62056,1025,149424,1184,946654,1036,1096078,California
San Bernardino,2021-08-30,2667,1993370,1905,1199508,624,731668,138,62194,1063,149208,1415,948069,1199,1097277,California
San Diego,2020-12-15,175,175,175,175,0,0,0,0,175,175,0,0,175,175,California
San Diego,2020-12-16,1145,1320,1145,1320,0,0,0,0,1145,1320,0,0,1145,1320,California
San Diego,2020-12-17,2397,3717,2397,3717,0,0,0,0,2397,3717,0,0,2397,3717,California
San Diego,2020-12-18,3679,7396,3674,7391,5,5,0,0,3679,7396,0,0,3679,7396,California
San Diego,2020-12-19,2286,9682,2283,9674,3,8,0,0,2286,9682,0,0,2286,9682,California
San Diego,2020-12-20,1187,10869,1176,10850,11,19,0,0,1187,10869,0,0,1187,10869,California
San Diego,2020-12-21,3519,14388,3509,14359,10,29,0,0,3519,14388,0,0,3519,14388,California
San Diego,2020-12-22,4082,18470,3402,17761,680,709,0,0,4082,18470,0,0,4082,18470,California
San Diego,2020-12-23,3281,21751,2004,19765,1277,1986,0,0,3281,21751,0,0,3281,21751,California
San Diego,2020-12-24,2769,24520,2224,21989,545,2531,0,0,2768,24519,0,0,2768,24519,California
San Diego,2020-12-25,893,25413,885,22874,8,2539,0,0,893,25412,0,0,893,25412,California
San Diego,2020-12-26,3298,28711,2161,25035,1137,3676,0,0,3298,28710,0,0,3298,28710,California
San Diego,2020-12-27,2574,31285,1630,26665,944,4620,0,0,2573,31282,1,1,2573,31283,California
San Diego,2020-12-28,6002,37287,4238,30903,1764,6384,0,0,6001,37282,1,2,6001,37284,California
San Diego,2020-12-29,5897,43184,3257,34160,2640,9024,0,0,5897,43179,0,2,5897,43181,California
San Diego,2020-12-30,5911,49095,3053,37213,2858,11882,0,0,5911,49090,0,2,5911,49092,California
San Diego,2020-12-31,3062,52157,1068,38281,1994,13876,0,0,3061,52151,0,2,3061,52153,California
San Diego,2021-01-01,1373,53530,624,38905,749,14625,0,0,1366,53516,1,3,1366,53519,California
San Diego,2021-01-02,3714,57244,1300,40205,2414,17039,0,0,3712,57228,0,3,3712,57231,California
San Diego,2021-01-03,881,58125,641,40846,240,17279,0,0,880,58108,0,3,880,58111,California
San Diego,2021-01-04,3819,61944,2105,42951,1714,18993,0,0,3809,61916,1,4,3809,61920,California
San Diego,2021-01-05,4410,66354,2219,45170,2191,21184,0,0,3796,65122,609,613,3815,65735,California
San Diego,2021-01-06,5006,71360,2367,47537,2639,23823,0,0,3769,67689,1214,1827,3781,69516,California
San Diego,2021-01-07,5720,77080,3041,50578,2679,26502,0,0,3553,69095,2159,3986,3565,73081,California
San Diego,2021-01-08,8020,85100,5035,55613,2985,29487,0,0,4208,69542,3792,7778,4239,77320,California
San Diego,2021-01-09,3509,88609,1966,57579,1543,31030,0,0,1976,70005,1523,9301,1986,79306,California
San Diego,2021-01-10,1920,90529,1321,58900,599,31629,0,0,814,69740,1093,10394,828,80134,California
San Diego,2021-01-11,10354,100883,5866,64766,4488,36117,0,0,6867,73154,3477,13871,6891,87025,California
San Diego,2021-01-12,11263,112146,5365,70131,5898,42015,0,0,7873,77776,3373,17244,7995,95020,California
San Diego,2021-01-13,11575,123721,5112,75243,6463,48478,0,0,9004,84274,2556,19800,9054,104074,California
San Diego,2021-01-14,12230,135951,4611,79854,7619,56097,0,0,10070,92236,2149,21949,10111,114185,California
San Diego,2021-01-15,15133,151084,5395,85249,9738,65835,0,0,12461,102115,2650,24599,12529,126714,California
San Diego,2021-01-16,10913,161997,3775,89024,7138,72973,0,0,9292,109823,1614,26213,9322,136036,California
San Diego,2021-01-17,8434,170431,2314,91338,6120,79093,0,0,7581,116570,853,27066,7600,143636,California
San Diego,2021-01-18,12943,183374,6376,97714,6567,85660,0,0,10050,123843,2860,29926,10133,153769,California
San Diego,2021-01-19,14955,198329,5932,103646,9023,94683,0,0,11587,132335,3358,33284,11850,165619,California
San Diego,2021-01-20,18338,216667,6387,110033,11951,106634,0,0,14986,144185,3329,36613,15179,180798,California
San Diego,2021-01-21,17528,234195,5920,115953,11608,118242,0,0,16050,158934,1465,38078,16214,197012,California
San Diego,2021-01-22,17579,251774,4715,120668,12864,131106,0,0,15478,172422,2083,40161,15571,212583,California
San Diego,2021-01-23,14256,266030,5155,125823,9101,140207,0,0,11994,182235,2250,42411,12063,224646,California
San Diego,2021-01-24,11766,277796,3296,129119,8470,148677,0,0,10785,192093,978,43389,10836,235482,California
San Diego,2021-01-25,12348,290144,5804,134923,6544,155221,0,0,9252,198437,3080,46469,9424,244906,California
San Diego,2021-01-26,15192,305336,7822,142745,7370,162591,0,0,11756,206966,3430,49899,11959,256865,California
San Diego,2021-01-27,20609,325945,8050,150795,12559,175150,0,0,17534,221595,3061,52960,17690,274555,California
San Diego,2021-01-28,21450,347395,7820,158615,13630,188780,0,0,19107,238466,2328,55288,19199,293754,California
San Diego,2021-01-29,19710,367105,6539,165154,13171,201951,0,0,17190,253213,2505,57793,17252,311006,California
San Diego,2021-01-30,15709,382814,3576,168730,12133,214084,0,0,13011,263668,2682,60475,13137,324143,California
San Diego,2021-01-31,14657,397471,5722,174452,8935,223019,0,0,14284,277632,368,60843,14332,338475,California
San Diego,2021-02-01,21506,418977,7836,182288,13670,236689,0,0,17805,291843,3680,64523,17891,356366,California
San Diego,2021-02-02,23246,442223,8629,190917,14617,251306,0,0,19870,308541,3348,67871,20046,376412,California
San Diego,2021-02-03,27369,469592,11584,202501,15785,267091,0,0,23039,327474,4303,72174,23236,399648,California
San Diego,2021-02-04,24354,493946,10100,212601,14254,281345,0,0,19737,342913,4596,76770,20035,419683,California
San Diego,2021-02-05,24764,518710,8777,221378,15987,297332,0,0,18177,355056,6555,83325,18698,438381,California
San Diego,2021-02-06,20686,539396,8538,229916,12148,309480,0,0,17409,369453,3269,86594,17666,456047,California
San Diego,2021-02-07,12083,551479,5365,235281,6718,316198,0,0,10184,378028,1883,88477,10458,466505,California
San Diego,2021-02-08,20170,571649,8556,243837,11614,327812,0,0,12719,384024,7427,95904,13423,479928,California
San Diego,2021-02-09,20624,592273,8502,252339,12122,339934,0,0,13229,391045,7364,103268,14385,494313,California
San Diego,2021-02-10,23051,615324,9458,261797,13593,353527,0,0,13907,397280,9090,112358,15325,509638,California
San Diego,2021-02-11,23884,639208,10248,272045,13636,367163,0,0,12771,400679,11077,123435,14476,524114,California
San Diego,2021-02-12,23541,662749,7410,279455,16131,383294,0,0,11704,402824,11809,135244,13954,538068,California
San Diego,2021-02-13,19738,682487,8946,288401,10792,394086,0,0,10627,405548,9096,144340,11820,549888,California
San Diego,2021-02-14,10926,693413,7353,295754,3573,397659,0,0,5957,408073,4956,149296,7481,557369,California
San Diego,2021-02-15,15075,708488,7649,303403,7426,405085,0,0,7547,411199,7495,156791,10621,567990,California
San Diego,2021-02-16,19163,727651,11215,314618,7948,413033,0,0,9070,413137,10066,166857,12004,579994,California
San Diego,2021-02-17,23290,750941,10891,325509,12399,425432,0,0,7997,408861,15265,182122,10989,590983,California
San Diego,2021-02-18,23747,774688,12135,337644,11612,437044,0,0,7873,404920,15840,197962,11899,602882,California
San Diego,2021-02-19,15901,790589,11016,348660,4885,441929,0,0,6487,403919,9383,207345,8382,611264,California
San Diego,2021-02-20,10387,800976,6483,355143,3904,445833,0,0,5698,406867,4679,212024,7627,618891,California
San Diego,2021-02-21,11821,812797,10243,365386,1578,447411,0,0,5209,407088,6588,218612,6809,625700,California
San Diego,2021-02-22,13088,825885,11059,376445,2029,449440,0,0,6025,407780,7033,225645,7725,633425,California
San Diego,2021-02-23,25715,851600,14349,390794,11366,460806,0,0,9379,406723,16310,241955,15253,648678,California
San Diego,2021-02-24,29133,880733,12989,403783,16144,476950,0,0,6757,398561,22342,264297,14180,662858,California
San Diego,2021-02-25,33247,913980,14897,418680,18350,495300,0,0,9926,393659,23293,287590,18391,681249,California
San Diego,2021-02-26,33216,947196,12408,431088,20808,516108,0,0,11797,391125,21369,308959,18835,700084,California
San Diego,2021-02-27,21007,968203,9499,440587,11506,527614,2,2,11101,396561,9890,318849,15326,715410,California
San Diego,2021-02-28,15159,983362,9861,450448,5297,532911,1,3,9272,402753,5867,324716,12059,727469,California
San Diego,2021-03-01,25021,1008383,14561,465009,10431,543342,29,32,14950,411708,9966,334682,18921,746390,California
San Diego,2021-03-02,26320,1034703,14119,479128,12191,555533,10,42,12669,417514,13620,348302,19426,765816,California
San Diego,2021-03-03,34089,1068792,16073,495201,17996,573529,20,62,13958,418376,20082,368384,20944,786760,California
San Diego,2021-03-04,28258,1097050,14084,509285,14167,587696,7,69,12515,421889,15710,384094,19223,805983,California
San Diego,2021-03-05,28967,1126017,14834,524119,14049,601745,84,153,13397,426524,15501,399595,20136,826119,California
San Diego,2021-03-06,23193,1149210,9432,533551,13065,614810,696,849,10161,429008,13011,412606,15495,841614,California
San Diego,2021-03-07,18115,1167325,9166,542717,8318,623128,631,1480,6832,428829,11261,423867,11082,852696,California
San Diego,2021-03-08,22940,1190265,11114,553831,10930,634058,896,2376,11289,434209,11595,435462,16975,869671,California
San Diego,2021-03-09,25695,1215960,11798,565629,12156,646214,1741,4117,10080,434304,15586,451048,15681,885352,California
San Diego,2021-03-10,25383,1241343,10615,576244,12371,658585,2397,6514,10009,435369,15346,466394,16411,901763,California
San Diego,2021-03-11,28441,1269784,10959,587203,13945,672530,3537,10051,9874,434167,18537,484931,17335,919098,California
San Diego,2021-03-12,27032,1296816,9448,596651,14457,686987,3127,13178,9805,433516,17202,502133,16551,935649,California
San Diego,2021-03-13,25896,1322712,7244,603895,16886,703873,1766,14944,10047,433601,15824,517957,15909,951558,California
San Diego,2021-03-14,13554,1336266,5400,609295,7426,711299,728,15672,4757,432574,8778,526735,7751,959309,California
San Diego,2021-03-15,21841,1358107,10102,619397,10931,722230,808,16480,8952,432550,12826,539561,12802,972111,California
San Diego,2021-03-16,29656,1387763,15596,634993,13629,735859,431,16911,15460,437227,14161,553722,18838,990949,California
San Diego,2021-03-17,26603,1414366,12248,647241,13624,749483,731,17642,17018,447449,9556,563278,19778,1010727,California
San Diego,2021-03-18,31358,1445724,17603,664844,12811,762294,944,18586,16998,452569,14307,577585,19427,1030154,California
San Diego,2021-03-19,30322,1476046,14449,679293,14804,777098,1069,19655,19445,463413,10843,588428,21687,1051841,California
San Diego,2021-03-20,27793,1503839,8487,687780,17514,794612,1792,21447,21487,481475,6274,594702,24336,1076177,California
San Diego,2021-03-21,16486,1520325,11973,699753,3809,798421,704,22151,7769,482609,8683,603385,9817,1085994,California
San Diego,2021-03-22,22613,1542938,13115,712868,9205,807626,293,22444,14373,491834,8204,611589,17429,1103423,California
San Diego,2021-03-23,25850,1568788,13532,726400,12014,819640,304,22748,17107,502576,8721,620310,19463,1122886,California
San Diego,2021-03-24,29442,1598230,19679,746079,9366,829006,397,23145,17035,509669,12375,632685,19468,1142354,California
San Diego,2021-03-25,30313,1628543,18251,764330,11373,840379,689,23834,17945,518109,12334,645019,20774,1163128,California
San Diego,2021-03-26,31952,1660495,17949,782279,13480,853859,523,24357,17454,524415,14457,659476,20763,1183891,California
San Diego,2021-03-27,25382,1685877,11088,793367,13898,867757,396,24753,15681,533077,9670,669146,18332,1202223,California
San Diego,2021-03-28,15234,1701111,9423,802790,5753,873510,58,24811,9327,538242,5888,675034,11053,1213276,California
San Diego,2021-03-29,26826,1727937,13040,815830,13144,886654,642,25453,16408,547471,10395,685429,19624,1232900,California
San Diego,2021-03-30,33203,1761140,17999,833829,14464,901118,740,26193,21985,560907,11184,696613,24620,1257520,California
San Diego,2021-03-31,30374,1791514,18850,852679,10799,911917,725,26918,20599,573654,9746,706359,22493,1280013,California
San Diego,2021-04-01,34901,1826415,20395,873074,12950,924867,1556,28474,23583,588928,11254,717613,26528,1306541,California
San Diego,2021-04-02,35830,1862245,20794,893868,12200,937067,2836,31310,24154,605758,11645,729258,28475,1335016,California
San Diego,2021-04-03,30806,1893051,14471,908339,11699,948766,4636,35946,19623,620103,11155,740413,25500,1360516,California
San Diego,2021-04-04,8937,1901988,5169,913508,2842,951608,926,36872,4797,621888,4124,744537,5909,1366425,California
San Diego,2021-04-05,30004,1931992,15591,929099,11641,963249,2772,39644,19452,636110,10520,755057,24742,1391167,California
San Diego,2021-04-06,38890,1970882,20607,949706,12365,975614,5918,45562,22325,650039,16532,771589,30461,1421628,California
San Diego,2021-04-07,36221,2007103,22120,971826,9531,985145,4570,50132,20314,660329,15869,787458,26159,1447787,California
San Diego,2021-04-08,35290,2042393,21501,993327,9649,994794,4140,54272,21254,674358,14004,801462,28033,1475820,California
San Diego,2021-04-09,38313,2080706,22862,1016189,10210,1005004,5241,59513,20655,685939,17612,819074,29193,1505013,California
San Diego,2021-04-10,29118,2109824,11759,1027948,13326,1018330,4033,63546,14971,693825,14130,833204,22016,1527029,California
San Diego,2021-04-11,16149,2125973,9941,1037889,3873,1022203,2335,65881,7128,697281,9014,842218,12470,1539499,California
San Diego,2021-04-12,30752,2156725,12900,1050789,13522,1035725,4330,70211,17060,708665,13657,855875,25041,1564540,California
San Diego,2021-04-13,36875,2193600,17647,1068436,19184,1054909,44,70255,24434,723559,12409,868284,27303,1591843,California
San Diego,2021-04-14,32940,2226540,18921,1087357,13991,1068900,28,70283,17747,730497,15169,883453,22107,1613950,California
San Diego,2021-04-15,39592,2266132,20558,1107915,19007,1087907,27,70310,23920,741712,15630,899083,26845,1640795,California
San Diego,2021-04-16,33647,2299779,18495,1126410,15140,1103047,12,70322,19441,749395,14131,913214,21814,1662609,California
San Diego,2021-04-17,27944,2327723,13581,1139991,14360,1117407,3,70325,12318,749290,15521,928735,15416,1678025,California
San Diego,2021-04-18,14726,2342449,9146,1149137,5567,1122974,13,70338,6803,751196,7901,936636,9807,1687832,California
San Diego,2021-04-19,26611,2369060,13609,1162746,12995,1135969,7,70345,12448,751237,14131,950767,14172,1702004,California
San Diego,2021-04-20,39783,2408843,18521,1181267,21252,1157221,10,70355,20201,754901,19528,970295,23192,1725196,California
San Diego,2021-04-21,36469,2445312,22117,1203384,14332,1171553,20,70375,17437,756719,18962,989257,20780,1745976,California
San Diego,2021-04-22,45110,2490422,23468,1226852,21635,1193188,7,70382,22519,759734,22528,1011785,25543,1771519,California
San Diego,2021-04-23,42632,2533054,26508,1253360,16117,1209305,7,70389,15824,752027,26753,1038538,19046,1790565,California
San Diego,2021-04-24,35001,2568055,18960,1272320,16023,1225328,18,70407,15551,751409,19402,1057940,18784,1809349,California
San Diego,2021-04-25,12596,2580651,7656,1279976,4938,1230266,2,70409,5812,751859,6768,1064708,7218,1816567,California
San Diego,2021-04-26,33496,2614147,16843,1296819,16506,1246772,147,70556,11653,746273,21805,1086513,16219,1832786,California
San Diego,2021-04-27,44746,2658893,24695,1321514,19505,1266277,546,71102,19611,744455,25076,1111589,23258,1856044,California
San Diego,2021-04-28,38424,2697317,22875,1344389,14875,1281152,674,71776,17267,743585,21094,1132683,20224,1876268,California
San Diego,2021-04-29,38271,2735588,24472,1368861,13144,1294296,655,72431,15433,738603,22787,1155470,17805,1894073,California
San Diego,2021-04-30,38289,2773877,23278,1392139,13929,1308225,1082,73513,14950,733193,23287,1178757,17877,1911950,California
San Diego,2021-05-01,24487,2798364,10820,1402959,13015,1321240,652,74165,9589,730726,14877,1193634,12410,1924360,California
San Diego,2021-05-02,10536,2808900,7392,1410351,2560,1323800,584,74749,3192,727489,7335,1200969,4098,1928458,California
San Diego,2021-05-03,25239,2834139,12433,1422784,11654,1335454,1152,75901,9168,722556,16040,1217009,11107,1939565,California
San Diego,2021-05-04,31950,2866089,17760,1440544,12911,1348365,1279,77180,11424,715839,20486,1237495,13769,1953334,California
San Diego,2021-05-05,27943,2894032,17254,1457798,9413,1357778,1276,78456,10516,711272,17390,1254885,12823,1966157,California
San Diego,2021-05-06,28428,2922460,18926,1476724,8592,1366370,910,79366,10625,707471,17771,1272656,13970,1980127,California
San Diego,2021-05-07,29612,2952072,19422,1496146,9166,1375536,1024,80390,10929,701972,18643,1291299,13144,1993271,California
San Diego,2021-05-08,23047,2975119,11085,1507231,11232,1386768,730,81120,7177,695457,15839,1307138,9324,2002595,California
San Diego,2021-05-09,7708,2982827,5623,1512854,1675,1388443,410,81530,2542,693674,5156,1312294,3373,2005968,California
San Diego,2021-05-10,21754,3004581,8670,1521524,12269,1400712,815,82345,5847,685704,15872,1328166,7902,2013870,California
San Diego,2021-05-11,28763,3033344,12248,1533772,15705,1416417,810,83155,9983,679514,18742,1346908,12552,2026422,California
San Diego,2021-05-12,23039,3056383,12636,1546408,9534,1425951,869,84024,8112,674879,14879,1361787,10244,2036666,California
San Diego,2021-05-13,31422,3087805,19052,1565460,11731,1437682,639,84663,12867,672558,18497,1380284,16176,2052842,California
San Diego,2021-05-14,30838,3118643,19773,1585233,10212,1447894,853,85516,13922,672561,16861,1397145,16864,2069706,California
San Diego,2021-05-15,26249,3144892,16458,1601691,8969,1456863,822,86338,10806,669810,15387,1412532,12636,2082342,California
San Diego,2021-05-16,13684,3158576,10211,1611902,2905,1459768,568,86906,6759,670634,6912,1419444,7736,2090078,California
San Diego,2021-05-17,21298,3179874,12904,1624806,7648,1467416,746,87652,8779,668570,12475,1431919,10411,2100489,California
San Diego,2021-05-18,34086,3213960,19323,1644129,13900,1481316,863,88515,13185,663201,20867,1452786,15498,2115987,California
San Diego,2021-05-19,28322,3242282,17894,1662023,9647,1490963,781,89296,12015,660855,16270,1469056,13924,2129911,California
San Diego,2021-05-20,34782,3277064,19268,1681291,14695,1505658,819,90115,11687,651872,23051,1492107,14068,2143979,California
San Diego,2021-05-21,26923,3303987,17094,1698385,8831,1514489,998,91113,10796,648833,16080,1508187,13041,2157020,California
San Diego,2021-05-22,21410,3325397,12323,1710708,7850,1522339,1237,92350,8888,647607,12493,1520680,11267,2168287,California
San Diego,2021-05-23,7291,3332688,5194,1715902,1791,1524130,306,92656,3454,647947,3811,1524491,4151,2172438,California
San Diego,2021-05-24,17720,3350408,9075,1724977,6722,1530852,1923,94579,6312,645647,11382,1535873,9082,2181520,California
San Diego,2021-05-25,24210,3374618,13024,1738001,9306,1540158,1880,96459,8366,641271,15799,1551672,11423,2192943,California
San Diego,2021-05-26,18979,3393597,10527,1748528,6443,1546601,2009,98468,6515,638240,12430,1564102,9399,2202342,California
San Diego,2021-05-27,20516,3414113,11879,1760407,6245,1552846,2392,100860,6859,634978,13630,1577732,10368,2212710,California
San Diego,2021-05-28,21128,3435241,13097,1773504,7315,1560161,716,101576,8262,632252,12845,1590577,10119,2222829,California
San Diego,2021-05-29,11897,3447138,7511,1781015,3898,1564059,488,102064,5057,631509,6825,1597402,6082,2228911,California
San Diego,2021-05-30,4603,3451741,3148,1784163,1077,1565136,378,102442,1956,631434,2637,1600039,2562,2231473,California
San Diego,2021-05-31,2578,3454319,1745,1785908,663,1565799,170,102612,849,630859,1721,1601760,1146,2232619,California
San Diego,2021-06-01,21161,3475480,11253,1797161,8274,1574073,1634,104246,5701,623692,15428,1617188,8261,2240880,California
San Diego,2021-06-02,16945,3492425,8747,1805908,6109,1580182,2089,106335,5379,620384,11533,1628721,8225,2249105,California
San Diego,2021-06-03,19047,3511472,11907,1817815,5335,1585517,1805,108140,5072,614372,13946,1642667,7934,2257039,California
San Diego,2021-06-04,19656,3531128,13743,1831558,5286,1590803,627,108767,5613,608516,14009,1656676,8153,2265192,California
San Diego,2021-06-05,15714,3546842,11970,1843528,2968,1593771,776,109543,4391,603407,11304,1667980,6195,2271387,California
San Diego,2021-06-06,5557,3552399,4497,1848025,745,1594516,315,109858,1545,602105,4000,1671980,2698,2274085,California
San Diego,2021-06-07,12664,3565063,7955,1855980,3359,1597875,1350,111208,3452,598475,9189,1681169,5559,2279644,California
San Diego,2021-06-08,20331,3585394,14382,1870362,4071,1601946,1878,113086,4873,590871,15445,1696614,7841,2287485,California
San Diego,2021-06-09,16807,3602201,11160,1881522,3695,1605641,1952,115038,4237,585483,12551,1709165,7163,2294648,California
San Diego,2021-06-10,17813,3620014,11885,1893407,3848,1609489,2080,117118,4257,579494,13530,1722695,7541,2302189,California
San Diego,2021-06-11,15686,3635700,9994,1903401,4339,1613828,1353,118471,4219,574578,11436,1734131,6520,2308709,California
San Diego,2021-06-12,11051,3646751,8489,1911890,2142,1615970,420,118891,3083,570812,7949,1742080,4183,2312892,California
San Diego,2021-06-13,4098,3650849,3077,1914967,818,1616788,203,119094,973,569276,3118,1745198,1582,2314474,California
San Diego,2021-06-14,12459,3663308,7469,1922436,2810,1619598,2180,121274,3466,566608,8976,1754174,6308,2320782,California
San Diego,2021-06-15,17729,3681037,10141,1932577,4154,1623752,3434,124708,4605,562481,13105,1767279,8978,2329760,California
San Diego,2021-06-16,13924,3694961,8895,1941472,2715,1626467,2314,127022,4494,560681,9416,1776695,7616,2337376,California
San Diego,2021-06-17,14705,3709666,8419,1949891,3432,1629899,2854,129876,4122,557763,10567,1787262,7649,2345025,California
San Diego,2021-06-18,14032,3723698,8651,1958542,3554,1633453,1827,131703,4331,555037,9689,1796951,6963,2351988,California
San Diego,2021-06-19,7500,3731198,5531,1964073,1510,1634963,459,132162,2684,553952,4798,1801749,3713,2355701,California
San Diego,2021-06-20,3047,3734245,2213,1966286,638,1635601,196,132358,1112,553560,1928,1803677,1536,2357237,California
San Diego,2021-06-21,9129,3743374,5182,1971468,2400,1638001,1547,133905,3847,554288,5270,1808947,5998,2363235,California
San Diego,2021-06-22,11144,3754518,7474,1978942,2541,1640542,1129,135034,4338,553675,6790,1815737,6177,2369412,California
San Diego,2021-06-23,10681,3765199,6923,1985865,2284,1642826,1474,136508,4298,553749,6372,1822109,6446,2375858,California
San Diego,2021-06-24,9934,3775133,6431,1992296,2714,1645540,789,137297,3945,553128,5981,1828090,5360,2381218,California
San Diego,2021-06-25,10509,3785642,7280,1999576,2626,1648166,603,137900,4007,551910,6490,1834580,5272,2386490,California
San Diego,2021-06-26,6627,3792269,5197,2004773,1123,1649289,307,138207,2572,551365,4040,1838620,3495,2389985,California
San Diego,2021-06-27,2947,3795216,2259,2007032,481,1649770,207,138414,1276,551430,1668,1840288,1733,2391718,California
San Diego,2021-06-28,7093,3802309,5206,2012238,1374,1651144,513,138927,3258,551891,3827,1844115,4288,2396006,California
San Diego,2021-06-29,8668,3810977,6026,2018264,1960,1653104,682,139609,3558,551644,5095,1849210,4848,2400854,California
San Diego,2021-06-30,8105,3819082,5965,2024229,1616,1654720,524,140133,3444,551579,4647,1853857,4582,2405436,California
San Diego,2021-07-01,7221,3826303,4975,2029204,1842,1656562,404,140537,3095,551526,4114,1857971,4061,2409497,California
San Diego,2021-07-02,7477,3833780,5142,2034346,1918,1658480,417,140954,3146,551342,4309,1862280,4125,2413622,California
San Diego,2021-07-03,4089,3837869,3073,2037419,846,1659326,170,141124,1829,551430,2252,1864532,2340,2415962,California
San Diego,2021-07-04,422,3838291,280,2037699,60,1659386,82,141206,155,551460,265,1864797,295,2416257,California
San Diego,2021-07-05,3901,3842192,2787,2040486,825,1660211,289,141495,1783,551725,2113,1866910,2378,2418635,California
San Diego,2021-07-06,8344,3850536,6151,2046637,1769,1661980,424,141919,3044,550544,5293,1872203,4112,2422747,California
San Diego,2021-07-07,7541,3858077,5570,2052207,1463,1663443,508,142427,3025,550213,4505,1876708,4174,2426921,California
San Diego,2021-07-08,6872,3864949,4876,2057083,1508,1664951,488,142915,2783,549949,4063,1880771,3799,2430720,California
San Diego,2021-07-09,7409,3872358,4985,2062068,1879,1666830,545,143460,2988,549643,4400,1885171,4094,2434814,California
San Diego,2021-07-10,4718,3877076,3566,2065634,853,1667683,299,143759,2014,549641,2699,1887870,2697,2437511,California
San Diego,2021-07-11,2133,3879209,1577,2067211,379,1668062,177,143936,945,549726,1185,1889055,1270,2438781,California
San Diego,2021-07-12,6464,3885673,4664,2071875,1354,1669416,446,144382,2555,549333,3894,1892949,3501,2442282,California
San Diego,2021-07-13,7252,3892925,5360,2077235,1526,1670942,366,144748,3059,549073,4178,1897127,3918,2446200,California
San Diego,2021-07-14,6883,3899808,5109,2082344,1379,1672321,395,145143,2885,548890,3981,1901108,3798,2449998,California
San Diego,2021-07-15,6752,3906560,5068,2087412,1360,1673681,324,145467,2921,548832,3808,1904916,3750,2453748,California
San Diego,2021-07-16,7407,3913967,5229,2092641,1805,1675486,373,145840,3317,548946,4083,1908999,4197,2457945,California
San Diego,2021-07-17,4493,3918460,3330,2095971,942,1676428,221,146061,2064,549112,2422,1911421,2588,2460533,California
San Diego,2021-07-18,2420,3920880,1779,2097750,474,1676902,167,146228,1111,549232,1305,1912726,1425,2461958,California
San Diego,2021-07-19,6176,3927056,4519,2102269,1303,1678205,354,146582,2896,549672,3274,1916000,3714,2465672,California
San Diego,2021-07-20,7558,3934614,5476,2107745,1654,1679859,428,147010,3619,550311,3921,1919921,4560,2470232,California
San Diego,2021-07-21,7051,3941665,5177,2112922,1483,1681342,391,147401,3282,550708,3754,1923675,4151,2474383,California
San Diego,2021-07-22,6817,3948482,4923,2117845,1552,1682894,342,147743,3511,551702,3289,1926964,4283,2478666,California
San Diego,2021-07-23,7761,3956243,5654,2123499,1770,1684664,337,148080,4125,553032,3626,1930590,4956,2483622,California
San Diego,2021-07-24,4795,3961038,3485,2126984,1123,1685787,187,148267,2733,554144,2055,1932645,3167,2486789,California
San Diego,2021-07-25,2463,3963501,1772,2128756,517,1686304,174,148441,1689,555362,772,1933417,1990,2488779,California
San Diego,2021-07-26,6430,3969931,4520,2133276,1489,1687793,421,148862,3877,557467,2540,1935957,4645,2493424,California
San Diego,2021-07-27,7658,3977589,5549,2138825,1710,1689503,399,149261,4316,559224,3331,1939288,5088,2498512,California
San Diego,2021-07-28,7662,3985251,5672,2144497,1560,1691063,430,149691,4439,561301,3211,1942499,5288,2503800,California
San Diego,2021-07-29,7113,3992364,5232,2149729,1486,1692549,395,150086,4121,563240,2983,1945482,4922,2508722,California
San Diego,2021-07-30,8109,4000473,5672,2155401,2039,1694588,398,150484,4833,565702,3265,1948747,5727,2514449,California
San Diego,2021-07-31,5034,4005507,3747,2159148,1046,1695634,241,150725,3012,567241,2015,1950762,3554,2518003,California
San Diego,2021-08-01,2812,4008319,2158,2161306,460,1696094,194,150919,1765,568322,1043,1951805,2124,2520127,California
San Diego,2021-08-02,6929,4015248,5296,2166602,1280,1697374,353,151272,4441,570972,2473,1954278,5123,2525250,California
San Diego,2021-08-03,7673,4022921,5573,2172175,1649,1699023,451,151723,4508,573116,3156,1957434,5300,2530550,California
San Diego,2021-08-04,7394,4030315,5436,2177611,1550,1700573,408,152131,4433,575298,2944,1960378,5126,2535676,California
San Diego,2021-08-05,7367,4037682,5439,2183050,1506,1702079,422,152553,4356,577410,2988,1963366,5100,2540776,California
San Diego,2021-08-06,8356,4046038,5907,2188957,2041,1704120,408,152961,5066,579932,3273,1966639,5795,2546571,California
San Diego,2021-08-07,5227,4051265,4036,2192993,949,1705069,242,153203,3213,581605,2004,1968643,3677,2550248,California
San Diego,2021-08-08,2885,4054150,2197,2195190,528,1705597,160,153363,1853,582707,1029,1969672,2131,2552379,California
San Diego,2021-08-09,7381,4061531,5628,2200818,1318,1706915,435,153798,4370,584857,2999,1972671,5149,2557528,California
San Diego,2021-08-10,8143,4069674,6039,2206857,1671,1708586,433,154231,4688,586876,3441,1976112,5460,2562988,California
San Diego,2021-08-11,6502,4076176,4896,2211753,1223,1709809,383,154614,3582,588191,2911,1979023,4226,2567214,California
San Diego,2021-08-12,7418,4083594,5426,2217179,1601,1711410,391,155005,4253,589951,3150,1982173,4910,2572124,California
San Diego,2021-08-13,8813,4092407,6274,2223453,2169,1713579,370,155375,4987,591868,3805,1985978,5722,2577846,California
San Diego,2021-08-14,6070,4098477,4447,2227900,1363,1714942,260,155635,3536,593487,2477,1988455,4096,2581942,California
San Diego,2021-08-15,3284,4101761,2387,2230287,730,1715672,167,155802,1797,594183,1437,1989892,2133,2584075,California
San Diego,2021-08-16,8642,4110403,6160,2236447,2077,1717749,405,156207,4878,596209,3644,1993536,5670,2589745,California
San Diego,2021-08-17,8960,4119363,6303,2242750,2235,1719984,422,156629,4956,598111,3866,1997402,5768,2595513,California
San Diego,2021-08-18,9109,4128472,6241,2248991,2434,1722418,434,157063,4859,599900,3893,2001295,5682,2601195,California
San Diego,2021-08-19,9071,4137543,6165,2255156,2530,1724948,376,157439,4841,601767,3699,2004994,5566,2606761,California
San Diego,2021-08-20,10291,4147834,6952,2262108,2984,1727932,355,157794,5277,603355,4479,2009473,6067,2612828,California
San Diego,2021-08-21,6351,4154185,4647,2266755,1415,1729347,289,158083,3357,604420,2890,2012363,3955,2616783,California
San Diego,2021-08-22,3739,4157924,2687,2269442,927,1730274,125,158208,2055,605170,1613,2013976,2363,2619146,California
San Diego,2021-08-23,9058,4166982,6641,2276083,2116,1732390,301,158509,4779,606853,4031,2018007,5714,2624860,California
San Diego,2021-08-24,9089,4176071,6635,2282718,2102,1734492,352,158861,4726,608354,4124,2022131,5625,2630485,California
San Diego,2021-08-25,8658,4184729,6411,2289129,1920,1736412,327,159188,4477,609748,3934,2026065,5328,2635813,California
San Diego,2021-08-26,8397,4193126,6160,2295289,1957,1738369,280,159468,4343,611049,3813,2029878,5114,2640927,California
San Diego,2021-08-27,10241,4203367,7369,2302658,2575,1740944,297,159765,5111,612394,4803,2034681,6148,2647075,California
San Diego,2021-08-28,6331,4209698,4807,2307465,1344,1742288,180,159945,3191,613165,3070,2037751,3841,2650916,California
San Diego,2021-08-29,3746,4213444,2760,2310225,873,1743161,113,160058,1910,613691,1774,2039525,2300,2653216,California
San Diego,2021-08-30,2743,4216187,1929,2312154,631,1743792,183,160241,1246,613992,1404,2040929,1705,2654921,California
San Francisco,2020-12-15,9,9,9,9,0,0,0,0,9,9,0,0,9,9,California
San Francisco,2020-12-16,230,239,230,239,0,0,0,0,230,239,0,0,230,239,California
San Francisco,2020-12-17,422,661,422,661,0,0,0,0,422,661,0,0,422,661,California
San Francisco,2020-12-18,911,1572,910,1571,1,1,0,0,911,1572,0,0,911,1572,California
San Francisco,2020-12-19,614,2186,614,2185,0,1,0,0,614,2186,0,0,614,2186,California
San Francisco,2020-12-20,482,2668,482,2667,0,1,0,0,482,2668,0,0,482,2668,California
San Francisco,2020-12-21,1175,3843,1174,3841,1,2,0,0,1175,3843,0,0,1175,3843,California
San Francisco,2020-12-22,1411,5254,1375,5216,36,38,0,0,1411,5254,0,0,1411,5254,California
San Francisco,2020-12-23,1385,6639,1068,6284,317,355,0,0,1386,6640,0,0,1386,6640,California
San Francisco,2020-12-24,864,7503,500,6784,364,719,0,0,864,7504,0,0,864,7504,California
San Francisco,2020-12-25,38,7541,30,6814,8,727,0,0,38,7542,0,0,38,7542,California
San Francisco,2020-12-26,250,7791,152,6966,98,825,0,0,250,7792,0,0,250,7792,California
San Francisco,2020-12-27,274,8065,58,7024,216,1041,0,0,274,8066,0,0,274,8066,California
San Francisco,2020-12-28,1299,9364,698,7722,601,1642,0,0,1299,9365,0,0,1299,9365,California
San Francisco,2020-12-29,1402,10766,758,8480,644,2286,0,0,1402,10767,0,0,1402,10767,California
San Francisco,2020-12-30,1615,12381,890,9370,725,3011,0,0,1616,12383,0,0,1616,12383,California
San Francisco,2020-12-31,1004,13385,424,9794,580,3591,0,0,1004,13387,0,0,1004,13387,California
San Francisco,2021-01-01,110,13495,81,9875,29,3620,0,0,110,13497,0,0,110,13497,California
San Francisco,2021-01-02,357,13852,319,10194,38,3658,0,0,357,13854,0,0,357,13854,California
San Francisco,2021-01-03,298,14150,107,10301,191,3849,0,0,297,14150,1,1,297,14151,California
San Francisco,2021-01-04,1873,16023,1372,11673,501,4350,0,0,1870,16017,3,4,1870,16021,California
San Francisco,2021-01-05,2243,18266,1426,13099,817,5167,0,0,2201,18179,42,46,2204,18225,California
San Francisco,2021-01-06,1888,20154,1168,14267,720,5887,0,0,1616,19526,270,316,1617,19842,California
San Francisco,2021-01-07,2094,22248,1218,15485,876,6763,0,0,1611,20659,479,795,1612,21454,California
San Francisco,2021-01-08,2354,24602,1645,17130,709,7472,0,0,1486,21284,862,1657,1487,22941,California
San Francisco,2021-01-09,1416,26018,916,18046,500,7972,0,0,893,21656,523,2180,895,23836,California
San Francisco,2021-01-10,924,26942,544,18590,380,8352,0,0,464,21661,459,2639,464,24300,California
San Francisco,2021-01-11,2533,29475,1873,20463,660,9012,0,0,1421,21970,1113,3752,1422,25722,California
San Francisco,2021-01-12,3135,32610,2099,22562,1036,10048,0,0,1910,22657,1225,4977,1912,27634,California
San Francisco,2021-01-13,2867,35477,1632,24194,1235,11283,0,0,2019,23828,848,5825,2019,29653,California
San Francisco,2021-01-14,2484,37961,1112,25306,1372,12655,0,0,1921,25187,562,6387,1921,31574,California
San Francisco,2021-01-15,2777,40738,1156,26462,1621,14276,0,0,2372,27161,400,6787,2374,33948,California
San Francisco,2021-01-16,2244,42982,933,27395,1311,15587,0,0,2075,29069,169,6956,2077,36025,California
San Francisco,2021-01-17,1949,44931,531,27926,1418,17005,0,0,1636,30393,312,7268,1636,37661,California
San Francisco,2021-01-18,1412,46343,615,28541,797,17802,0,0,1135,31253,276,7544,1136,38797,California
San Francisco,2021-01-19,2622,48965,1490,30031,1132,18934,0,0,1750,32132,872,8416,1751,40548,California
San Francisco,2021-01-20,2894,51859,1207,31238,1687,20621,0,0,2100,33445,789,9205,2102,42650,California
San Francisco,2021-01-21,3494,55353,1050,32288,2444,23065,0,0,2598,35148,895,10100,2598,45248,California
San Francisco,2021-01-22,3321,58674,702,32990,2619,25684,0,0,2850,37529,470,10570,2851,48099,California
San Francisco,2021-01-23,3149,61823,630,33620,2519,28203,0,0,2761,39904,387,10957,2762,50861,California
San Francisco,2021-01-24,2451,64274,370,33990,2081,30284,0,0,2212,41880,236,11193,2212,53073,California
San Francisco,2021-01-25,4689,68963,1849,35839,2840,33124,0,0,3073,43341,1613,12806,3074,56147,California
San Francisco,2021-01-26,4817,73780,2204,38043,2613,35737,0,0,3145,44818,1669,14475,3146,59293,California
San Francisco,2021-01-27,4405,78185,1987,40030,2418,38155,0,0,3086,46587,1317,15792,3086,62379,California
San Francisco,2021-01-28,3876,82061,1614,41644,2262,40417,0,0,2682,48084,1186,16978,2683,65062,California
San Francisco,2021-01-29,4901,86962,1770,43414,3131,43548,0,0,3553,50324,1313,18291,3553,68615,California
San Francisco,2021-01-30,3841,90803,1854,45268,1987,45535,0,0,3374,53236,466,18757,3378,71993,California
San Francisco,2021-01-31,2378,93181,830,46098,1548,47083,0,0,2224,55307,154,18911,2225,74218,California
San Francisco,2021-02-01,4032,97213,1713,47811,2319,49402,0,0,2947,57172,1083,19994,2948,77166,California
San Francisco,2021-02-02,4590,101803,1833,49644,2757,52159,0,0,2970,58528,1614,21608,2970,80136,California
San Francisco,2021-02-03,5155,106958,2414,52058,2741,54900,0,0,3811,60998,1342,22950,3812,83948,California
San Francisco,2021-02-04,5118,112076,2441,54499,2677,57577,0,0,3917,63719,1196,24146,3917,87865,California
San Francisco,2021-02-05,6083,118159,3281,57780,2802,60379,0,0,4698,67036,1383,25529,4700,92565,California
San Francisco,2021-02-06,5521,123680,3683,61463,1838,62217,0,0,4644,70836,847,26376,4647,97212,California
San Francisco,2021-02-07,4406,128086,3247,64710,1159,63376,0,0,3818,74076,583,26959,3823,101035,California
San Francisco,2021-02-08,6854,134940,4718,69428,2136,65512,0,0,5600,78441,1237,28196,5602,106637,California
San Francisco,2021-02-09,6049,140989,4067,73495,1982,67494,0,0,4463,81317,1588,29784,4464,111101,California
San Francisco,2021-02-10,7089,148078,4308,77803,2781,70275,0,0,5183,84609,1896,31680,5188,116289,California
San Francisco,2021-02-11,6906,154984,4113,81916,2793,73068,0,0,4998,87711,1901,33581,5003,121292,California
San Francisco,2021-02-12,5455,160439,2753,84669,2702,75770,0,0,3548,89357,1903,35484,3549,124841,California
San Francisco,2021-02-13,4488,164927,2643,87312,1845,77615,0,0,3120,91113,1368,36852,3124,127965,California
San Francisco,2021-02-14,3507,168434,2311,89623,1196,78811,0,0,2340,92290,1165,38017,2342,130307,California
San Francisco,2021-02-15,2822,171256,1521,91144,1301,80112,0,0,1688,92848,1130,39147,1688,131995,California
San Francisco,2021-02-16,5258,176514,2872,94016,2386,82498,0,0,3067,93739,2184,41331,3075,135070,California
San Francisco,2021-02-17,5464,181978,2665,96681,2799,85297,0,0,3011,94312,2441,43772,3014,138084,California
San Francisco,2021-02-18,5527,187505,2695,99376,2832,88129,0,0,2824,94444,2698,46470,2830,140914,California
San Francisco,2021-02-19,5793,193298,2717,102093,3076,91205,0,0,2989,94638,2795,49265,2989,143903,California
San Francisco,2021-02-20,4717,198015,2281,104374,2436,93641,0,0,1740,93411,2968,52233,1741,145644,California
San Francisco,2021-02-21,3029,201044,1591,105965,1438,95079,0,0,1330,93056,1686,53919,1331,146975,California
San Francisco,2021-02-22,5566,206610,3440,109405,2126,97205,0,0,2767,93037,2789,56708,2770,149745,California
San Francisco,2021-02-23,6004,212614,3390,112795,2614,99819,0,0,3038,93117,2958,59666,3038,152783,California
San Francisco,2021-02-24,9672,222286,5483,118278,4189,104008,0,0,5155,93774,4500,64166,5157,157940,California
San Francisco,2021-02-25,10712,232998,7473,125751,3239,107247,0,0,6836,96744,3868,68034,6838,164778,California
San Francisco,2021-02-26,13158,246156,8525,134276,4633,111880,0,0,7693,98994,5444,73478,7694,172472,California
San Francisco,2021-02-27,10019,256175,6442,140718,3575,115455,2,2,4955,98913,5042,78520,4961,177433,California
San Francisco,2021-02-28,8431,264606,6029,146747,2402,117857,0,2,4111,98714,4311,82831,4112,181545,California
San Francisco,2021-03-01,12125,276731,8143,154890,3975,121832,7,9,5913,98457,6178,89009,5921,187466,California
San Francisco,2021-03-02,10675,287406,7141,162031,3533,125365,1,10,5996,99790,4665,93674,5998,193464,California
San Francisco,2021-03-03,12041,299447,7017,169048,5023,130388,1,11,6533,100841,5486,99160,6537,200001,California
San Francisco,2021-03-04,9264,308711,5799,174847,3464,133852,1,12,5186,101970,4061,103221,5190,205191,California
San Francisco,2021-03-05,9993,318704,5939,180786,4049,137901,5,17,6120,104239,3857,107078,6126,211317,California
San Francisco,2021-03-06,7529,326233,4844,185630,2465,140366,220,237,4669,106232,2865,109943,4858,216175,California
San Francisco,2021-03-07,5671,331904,4300,189930,1204,141570,167,404,3223,107143,2455,112398,3366,219541,California
San Francisco,2021-03-08,8044,339948,5626,195556,2202,143772,216,620,6280,111824,1790,114188,6471,226012,California
San Francisco,2021-03-09,8684,348632,5689,201245,2557,146329,438,1058,6225,115998,2459,116647,6633,232645,California
San Francisco,2021-03-10,11714,360346,6816,208061,4304,150633,594,1652,7183,119216,4510,121157,7728,240373,California
San Francisco,2021-03-11,10360,370706,6444,214505,2852,153485,1064,2716,6784,123417,3553,124710,7754,248127,California
San Francisco,2021-03-12,11084,381790,6413,220918,3251,156736,1420,4136,6229,126112,4827,129537,7522,255649,California
San Francisco,2021-03-13,6851,388641,3981,224899,1774,158510,1096,5232,4290,128903,2549,132086,5340,260989,California
San Francisco,2021-03-14,7624,396265,4948,229847,2417,160927,259,5491,3985,129518,3616,135702,4231,265220,California
San Francisco,2021-03-15,12256,408521,9351,239198,1954,162881,951,6442,8496,135140,3741,139443,9363,274583,California
San Francisco,2021-03-16,12388,420909,8411,247609,3491,166372,486,6928,8786,140824,3576,143019,9260,283843,California
San Francisco,2021-03-17,13816,434725,8530,256139,4629,171001,657,7585,9778,147213,4002,147021,10391,294234,California
San Francisco,2021-03-18,10440,445165,7126,263265,2670,173671,644,8229,5840,149077,4571,151592,6435,300669,California
San Francisco,2021-03-19,12765,457930,9340,272605,2940,176611,485,8714,6534,149863,6203,157795,6989,307658,California
San Francisco,2021-03-20,9099,467029,6698,279303,1919,178530,482,9196,5205,151669,3859,161654,5665,313323,California
San Francisco,2021-03-21,6764,473793,6197,285500,426,178956,141,9337,3704,152457,3035,164689,3823,317146,California
San Francisco,2021-03-22,10147,483940,7050,292550,2243,181199,854,10191,5175,153493,4948,169637,5984,323130,California
San Francisco,2021-03-23,11548,495488,7696,300246,3192,184391,660,10851,6300,155199,5215,174852,6921,330051,California
San Francisco,2021-03-24,12606,508094,9624,309870,2426,186817,556,11407,6123,155403,6432,181284,6636,336687,California
San Francisco,2021-03-25,12196,520290,8894,318764,2726,189543,576,11983,5736,155315,6380,187664,6292,342979,California
San Francisco,2021-03-26,12227,532517,8455,327219,3536,193079,236,12219,5766,154885,6419,194083,5989,348968,California
San Francisco,2021-03-27,9062,541579,6011,333230,2691,195770,360,12579,3814,153822,5216,199299,4153,353121,California
San Francisco,2021-03-28,6743,548322,5371,338601,1328,197098,44,12623,2916,152974,3802,203101,2954,356075,California
San Francisco,2021-03-29,11844,560166,8099,346700,3549,200647,196,12819,4760,150873,7046,210147,4945,361020,California
San Francisco,2021-03-30,11883,572049,7423,354123,4161,204808,299,13118,5483,150265,6370,216517,5762,366782,California
San Francisco,2021-03-31,12493,584542,8299,362422,3890,208698,304,13422,4910,147913,7545,224062,5193,371975,California
San Francisco,2021-04-01,14213,598755,7506,369928,4959,213657,1748,15170,6257,147740,7912,231974,7739,379714,California
San Francisco,2021-04-02,15058,613813,6639,376567,6506,220163,1913,17083,7112,148600,7921,239895,8781,388495,California
San Francisco,2021-04-03,10722,624535,4983,381550,3880,224043,1859,18942,5004,149571,5692,245587,6663,395158,California
San Francisco,2021-04-04,9134,633669,4843,386393,2602,226645,1689,20631,3755,149471,5359,250946,5259,400417,California
San Francisco,2021-04-05,16318,649987,9923,396316,4462,231107,1933,22564,6364,147680,9919,260865,8128,408545,California
San Francisco,2021-04-06,16305,666292,9609,405925,4589,235696,2107,24671,6298,145947,9974,270839,8241,416786,California
San Francisco,2021-04-07,17079,683371,10137,416062,4644,240340,2298,26969,7078,145196,9971,280810,9220,426006,California
San Francisco,2021-04-08,14435,697806,6856,422918,3086,243426,4493,31462,4996,144937,9393,290203,9134,435140,California
San Francisco,2021-04-09,16038,713844,7751,430669,4875,248301,3412,34874,6825,145790,9173,299376,10026,445166,California
San Francisco,2021-04-10,13479,727323,5754,436423,5919,254220,1806,36680,7261,148531,6185,305561,8926,454092,California
San Francisco,2021-04-11,10130,737453,7559,443982,1365,255585,1206,37886,5268,150080,4843,310404,6392,460484,California
San Francisco,2021-04-12,10789,748242,6978,450960,2631,258216,1180,39066,4966,150376,5796,316200,6092,466576,California
San Francisco,2021-04-13,10965,759207,7421,458381,3529,261745,15,39081,5456,150377,5474,321674,5475,472051,California
San Francisco,2021-04-14,13505,772712,8121,466502,5383,267128,1,39082,6347,149615,7115,328789,6353,478404,California
San Francisco,2021-04-15,13991,786703,9651,476153,4337,271465,3,39085,8044,151764,5907,334696,8056,486460,California
San Francisco,2021-04-16,13210,799913,8858,485011,4307,275772,45,39130,7638,153912,5539,340235,7687,494147,California
San Francisco,2021-04-17,10312,810225,7420,492431,2890,278662,2,39132,7212,158050,3081,343316,7219,501366,California
San Francisco,2021-04-18,7080,817305,5493,497924,1585,280247,2,39134,4383,159765,2676,345992,4391,505757,California
San Francisco,2021-04-19,11139,828444,8311,506235,2822,283069,6,39140,7002,162674,4112,350104,7021,512778,California
San Francisco,2021-04-20,13150,841594,7900,514135,5248,288317,2,39142,8857,167277,4258,354362,8861,521639,California
San Francisco,2021-04-21,12132,853726,8888,523023,3234,291551,10,39152,7280,169752,4817,359179,7292,528931,California
San Francisco,2021-04-22,11278,865004,8393,531416,2884,294435,1,39153,6429,171380,4811,363990,6439,535370,California
San Francisco,2021-04-23,11108,876112,6512,537928,4596,299031,0,39153,6538,173401,4528,368518,6549,541919,California
San Francisco,2021-04-24,8124,884236,5569,543497,2555,301586,0,39153,4762,174836,3338,371856,4773,546692,California
San Francisco,2021-04-25,5118,889354,4402,547899,710,302296,6,39159,2979,175701,2124,373980,2989,549681,California
San Francisco,2021-04-26,8667,898021,6164,554063,2487,304783,16,39175,4272,175645,4361,378341,4305,553986,California
San Francisco,2021-04-27,9122,907143,6199,560262,2748,307531,175,39350,4501,175740,4589,382930,4684,558670,California
San Francisco,2021-04-28,10077,917220,7035,567297,2847,310378,195,39545,5230,176364,4811,387741,5435,564105,California
San Francisco,2021-04-29,10014,927234,5950,573247,3864,314242,200,39745,4879,176359,5101,392842,5096,569201,California
San Francisco,2021-04-30,11515,938749,5693,578940,5613,319855,209,39954,4264,173633,7202,400044,4476,573677,California
San Francisco,2021-05-01,7103,945852,3650,582590,3332,323187,121,40075,1735,170158,5329,405373,1854,575531,California
San Francisco,2021-05-02,5399,951251,3128,585718,2172,325359,99,40174,999,166873,4386,409759,1101,576632,California
San Francisco,2021-05-03,9916,961167,6782,592500,2969,328328,165,40339,2462,162083,7423,417182,2633,579265,California
San Francisco,2021-05-04,9984,971151,6529,599029,3200,331528,255,40594,2409,157211,7539,424721,2667,581932,California
San Francisco,2021-05-05,9395,980546,6656,605685,2425,333953,314,40908,2300,152780,7047,431768,2616,584548,California
San Francisco,2021-05-06,11174,991720,8945,614630,1751,335704,478,41386,1929,145980,9205,440973,2405,586953,California
San Francisco,2021-05-07,10466,1002186,6769,621399,3422,339126,275,41661,1710,139243,8723,449696,1986,588939,California
San Francisco,2021-05-08,9066,1011252,4167,625566,4768,343894,131,41792,1115,132573,7918,457614,1248,590187,California
San Francisco,2021-05-09,6778,1018030,5875,631441,818,344712,85,41877,1025,127951,5726,463340,1104,591291,California
San Francisco,2021-05-10,7512,1025542,5411,636852,1841,346553,260,42137,1016,122764,6459,469799,1272,592563,California
San Francisco,2021-05-11,8369,1033911,6190,643042,1953,348506,226,42363,1496,117652,6831,476630,1719,594282,California
San Francisco,2021-05-12,8518,1042429,6248,649290,1812,350318,458,42821,1502,112628,6977,483607,1953,596235,California
San Francisco,2021-05-13,11567,1053996,8499,657789,2842,353160,226,43047,4223,109772,7309,490916,4453,600688,California
San Francisco,2021-05-14,9672,1063668,6867,664656,2629,355789,176,43223,2981,106282,6652,497568,3162,603850,California
San Francisco,2021-05-15,8235,1071903,6527,671183,1652,357441,56,43279,3243,104618,4975,502543,3311,607161,California
San Francisco,2021-05-16,5347,1077250,4492,675675,795,358236,60,43339,2029,103414,3293,505836,2089,609250,California
San Francisco,2021-05-17,7487,1084737,5569,681244,1753,359989,165,43504,2395,100907,5072,510908,2565,611815,California
San Francisco,2021-05-18,8821,1093558,5053,686297,3592,363581,176,43680,1843,95996,6929,517837,2018,613833,California
San Francisco,2021-05-19,7552,1101110,5584,691881,1732,365313,236,43916,2171,93049,5351,523188,2404,616237,California
San Francisco,2021-05-20,6286,1107396,4217,696098,1815,367128,254,44170,1531,90112,4715,527903,1778,618015,California
San Francisco,2021-05-21,7274,1114670,4115,700213,2971,370099,188,44358,1600,86270,5623,533526,1781,619796,California
San Francisco,2021-05-22,4900,1119570,3690,703903,1120,371219,90,44448,2217,85915,2660,536186,2305,622101,California
San Francisco,2021-05-23,1960,1121530,1503,705406,381,371600,76,44524,854,85749,1095,537281,929,623030,California
San Francisco,2021-05-24,4278,1125808,3025,708431,1089,372689,164,44688,1240,84142,3011,540292,1404,624434,California
San Francisco,2021-05-25,3751,1129559,2436,710867,1086,373775,229,44917,1044,82719,2684,542976,1261,625695,California
San Francisco,2021-05-26,4032,1133591,2598,713465,1288,375063,146,45063,1074,81003,2933,545909,1217,626912,California
San Francisco,2021-05-27,3768,1137359,2176,715641,1415,376478,177,45240,1174,79772,2580,548489,1349,628261,California
San Francisco,2021-05-28,3852,1141211,2191,717832,1496,377974,165,45405,1333,78780,2487,550976,1495,629756,California
San Francisco,2021-05-29,2072,1143283,1492,719324,475,378449,105,45510,802,78434,1247,552223,901,630657,California
San Francisco,2021-05-30,990,1144273,704,720028,249,378698,37,45547,394,78277,588,552811,431,631088,California
San Francisco,2021-05-31,273,1144546,223,720251,43,378741,7,45554,95,78206,173,552984,102,631190,California
San Francisco,2021-06-01,3632,1148178,2193,722444,1249,379990,190,45744,1082,76943,2533,555517,1270,632460,California
San Francisco,2021-06-02,2517,1150695,1817,724261,573,380563,127,45871,832,76228,1669,557186,954,633414,California
San Francisco,2021-06-03,4016,1154711,2760,727021,1052,381615,204,46075,926,74284,3070,560256,1126,634540,California
San Francisco,2021-06-04,5823,1160534,4923,731944,761,382376,139,46214,1270,71171,4518,564774,1405,635945,California
San Francisco,2021-06-05,3830,1164364,3242,735186,439,382815,149,46363,889,69279,2925,567699,1033,636978,California
San Francisco,2021-06-06,2350,1166714,2197,737383,114,382929,39,46402,389,67753,1954,569653,428,637406,California
San Francisco,2021-06-07,3697,1170411,3054,740437,504,383433,139,46541,886,65983,2791,572444,1021,638427,California
San Francisco,2021-06-08,2853,1173264,2241,742678,443,383876,169,46710,805,64919,2028,574472,964,639391,California
San Francisco,2021-06-09,2343,1175607,1877,744555,326,384202,140,46850,664,64055,1665,576137,801,640192,California
San Francisco,2021-06-10,2534,1178141,1930,746485,409,384611,195,47045,751,63232,1767,577904,944,641136,California
San Francisco,2021-06-11,3202,1181343,2528,749013,507,385118,167,47212,937,62094,2237,580141,1099,642235,California
San Francisco,2021-06-12,3076,1184419,2669,751682,277,385395,130,47342,723,60605,2339,582480,850,643085,California
San Francisco,2021-06-13,934,1185353,811,752493,76,385471,47,47389,223,60170,704,583184,269,643354,California
San Francisco,2021-06-14,2537,1187890,2050,754543,334,385805,153,47542,840,59478,1681,584865,989,644343,California
San Francisco,2021-06-15,1956,1189846,1510,756053,311,386116,135,47677,691,59054,1250,586115,826,645169,California
San Francisco,2021-06-16,1899,1191745,1438,757491,264,386380,197,47874,653,58667,1228,587343,841,646010,California
San Francisco,2021-06-17,2007,1193752,1545,759036,260,386640,202,48076,643,58156,1350,588693,839,646849,California
San Francisco,2021-06-18,2357,1196109,1739,760775,443,387083,175,48251,745,57475,1595,590288,914,647763,California
San Francisco,2021-06-19,1426,1197535,1189,761964,125,387208,112,48363,433,57037,979,591267,541,648304,California
San Francisco,2021-06-20,628,1198163,539,762503,56,387264,33,48396,257,56963,364,591631,290,648594,California
San Francisco,2021-06-21,1171,1199334,868,763371,189,387453,114,48510,601,57118,556,592187,711,649305,California
San Francisco,2021-06-22,1596,1200930,1256,764627,229,387682,111,48621,550,56743,1030,593217,655,649960,California
San Francisco,2021-06-23,1497,1202427,1178,765805,179,387861,140,48761,584,56560,900,594117,717,650677,California
San Francisco,2021-06-24,1552,1203979,1140,766945,245,388106,167,48928,514,56217,1020,595137,677,651354,California
San Francisco,2021-06-25,1849,1205828,1495,768440,252,388358,102,49030,663,55816,1164,596301,763,652117,California
San Francisco,2021-06-26,1414,1207242,1259,769699,69,388427,86,49116,498,55493,904,597205,581,652698,California
San Francisco,2021-06-27,565,1207807,502,770201,35,388462,28,49144,229,55419,330,597535,256,652954,California
San Francisco,2021-06-28,1507,1209314,1293,771494,117,388579,97,49241,539,55099,954,598489,634,653588,California
San Francisco,2021-06-29,1402,1210716,1076,772570,222,388801,104,49345,506,54818,882,599371,601,654189,California
San Francisco,2021-06-30,1304,1212020,1068,773638,167,388968,69,49414,505,54597,794,600165,573,654762,California
San Francisco,2021-07-01,1263,1213283,957,774595,182,389150,124,49538,492,54451,756,600921,610,655372,California
San Francisco,2021-07-02,1555,1214838,1242,775837,240,389390,73,49611,614,54202,932,601853,683,656055,California
San Francisco,2021-07-03,903,1215741,757,776594,72,389462,74,49685,336,54048,561,602414,407,656462,California
San Francisco,2021-07-04,13,1215754,11,776605,1,389463,1,49686,5,54046,8,602422,6,656468,California
San Francisco,2021-07-05,975,1216729,856,777461,74,389537,45,49731,393,53911,572,602994,437,656905,California
San Francisco,2021-07-06,1704,1218433,1410,778871,201,389738,93,49824,547,53410,1137,604131,636,657541,California
San Francisco,2021-07-07,1128,1219561,892,779763,139,389877,97,49921,398,53182,718,604849,490,658031,California
San Francisco,2021-07-08,1143,1220704,884,780647,148,390025,111,50032,415,52989,715,605564,522,658553,California
San Francisco,2021-07-09,1316,1222020,1019,781666,204,390229,93,50125,509,52803,784,606348,598,659151,California
San Francisco,2021-07-10,661,1222681,570,782236,47,390276,44,50169,287,52762,364,606712,323,659474,California
San Francisco,2021-07-11,499,1223180,423,782659,54,390330,22,50191,190,52672,301,607013,211,659685,California
San Francisco,2021-07-12,1301,1224481,1045,783704,169,390499,87,50278,505,52482,779,607792,589,660274,California
San Francisco,2021-07-13,975,1225456,765,784469,134,390633,76,50354,404,52399,558,608350,475,660749,California
San Francisco,2021-07-14,1067,1226523,825,785294,159,390792,83,50437,430,52281,627,608977,509,661258,California
San Francisco,2021-07-15,990,1227513,785,786079,157,390949,48,50485,469,52287,506,609483,512,661770,California
San Francisco,2021-07-16,1205,1228718,959,787038,202,391151,44,50529,558,52260,629,610112,602,662372,California
San Francisco,2021-07-17,811,1229529,737,787775,46,391197,28,50557,345,52182,449,610561,371,662743,California
San Francisco,2021-07-18,414,1229943,351,788126,48,391245,15,50572,194,52177,214,610775,209,662952,California
San Francisco,2021-07-19,1204,1231147,997,789123,139,391384,68,50640,568,52188,619,611394,630,663582,California
San Francisco,2021-07-20,942,1232089,753,789876,115,391499,74,50714,464,52264,460,611854,536,664118,California
San Francisco,2021-07-21,1134,1233223,940,790816,137,391636,57,50771,559,52317,557,612411,610,664728,California
San Francisco,2021-07-22,1088,1234311,870,791686,153,391789,65,50836,514,52338,556,612967,577,665305,California
San Francisco,2021-07-23,1205,1235516,958,792644,179,391968,68,50904,559,52339,623,613590,624,665929,California
San Francisco,2021-07-24,804,1236320,682,793326,81,392049,41,50945,341,52278,441,614031,380,666309,California
San Francisco,2021-07-25,362,1236682,314,793640,42,392091,6,50951,228,52388,123,614154,233,666542,California
San Francisco,2021-07-26,1219,1237901,944,794584,186,392277,89,51040,661,52604,532,614686,748,667290,California
San Francisco,2021-07-27,1145,1239046,918,795502,156,392433,71,51111,595,52737,529,615215,662,667952,California
San Francisco,2021-07-28,1138,1240184,895,796397,166,392599,77,51188,601,52905,502,615717,670,668622,California
San Francisco,2021-07-29,1139,1241323,870,797267,168,392767,101,51289,607,53106,503,616220,704,669326,California
San Francisco,2021-07-30,1285,1242608,959,798226,213,392980,113,51402,621,53225,603,616823,722,670048,California
San Francisco,2021-07-31,778,1243386,657,798883,77,393057,44,51446,423,53362,325,617148,462,670510,California
San Francisco,2021-08-01,397,1243783,349,799232,35,393092,13,51459,229,53446,158,617306,242,670752,California
San Francisco,2021-08-02,1270,1245053,1027,800259,165,393257,78,51537,689,53671,540,617846,765,671517,California
San Francisco,2021-08-03,1113,1246166,867,801126,169,393426,77,51614,579,53824,496,618342,649,672166,California
San Francisco,2021-08-04,1211,1247377,954,802080,183,393609,74,51688,574,53864,606,618948,646,672812,California
San Francisco,2021-08-05,1332,1248709,1006,803086,210,393819,116,51804,612,53895,688,619636,719,673531,California
San Francisco,2021-08-06,1471,1250180,1182,804268,231,394050,58,51862,680,53880,751,620387,736,674267,California
San Francisco,2021-08-07,936,1251116,821,805089,71,394121,44,51906,410,53830,500,620887,450,674717,California
San Francisco,2021-08-08,451,1251567,382,805471,65,394186,4,51910,225,53855,204,621091,229,674946,California
San Francisco,2021-08-09,1367,1252934,1107,806578,191,394377,69,51979,611,53802,731,621822,678,675624,California
San Francisco,2021-08-10,1137,1254071,877,807455,195,394572,65,52044,534,53821,579,622401,598,676222,California
San Francisco,2021-08-11,1225,1255296,895,808350,273,394845,57,52101,558,53810,621,623022,610,676832,California
San Francisco,2021-08-12,1364,1256660,971,809321,270,395115,123,52224,643,53899,672,623694,761,677593,California
San Francisco,2021-08-13,1545,1258205,1090,810411,379,395494,76,52300,712,53928,757,624451,786,678379,California
San Francisco,2021-08-14,1131,1259336,884,811295,199,395693,48,52348,546,54111,405,624856,588,678967,California
San Francisco,2021-08-15,613,1259949,474,811769,130,395823,9,52357,265,54170,215,625071,274,679241,California
San Francisco,2021-08-16,1779,1261728,1322,813091,375,396198,82,52439,725,54225,750,625821,805,680046,California
San Francisco,2021-08-17,1681,1263409,1196,814287,399,396597,86,52525,595,54208,693,626514,676,680722,California
San Francisco,2021-08-18,1695,1265104,1205,815492,415,397012,75,52600,594,54208,666,627180,666,681388,California
San Francisco,2021-08-19,1728,1266832,1149,816641,436,397448,143,52743,562,54204,697,627877,693,682081,California
San Francisco,2021-08-20,1991,1268823,1383,818024,544,397992,64,52807,710,54263,714,628591,773,682854,California
San Francisco,2021-08-21,1360,1270183,1084,819108,226,398218,50,52857,551,54341,518,629109,596,683450,California
San Francisco,2021-08-22,708,1270891,557,819665,144,398362,7,52864,315,54441,222,629331,322,683772,California
San Francisco,2021-08-23,2023,1272914,1484,821149,457,398819,82,52946,765,54561,724,630055,844,684616,California
San Francisco,2021-08-24,1727,1274641,1242,822391,404,399223,81,53027,606,54586,657,630712,682,685298,California
San Francisco,2021-08-25,1504,1276145,1109,823500,340,399563,55,53082,491,54528,604,631316,546,685844,California
San Francisco,2021-08-26,1739,1277884,1190,824690,436,399999,113,53195,561,54490,697,632013,659,686503,California
San Francisco,2021-08-27,1796,1279680,1281,825971,459,400458,56,53251,583,54423,705,632718,638,687141,California
San Francisco,2021-08-28,1205,1280885,927,826898,232,400690,46,53297,430,54407,487,633205,471,687612,California
San Francisco,2021-08-29,581,1281466,455,827353,124,400814,2,53299,199,54392,216,633421,201,687813,California
San Francisco,2021-08-30,1102,1282568,790,828143,257,401071,55,53354,343,54344,446,633867,398,688211,California
San Joaquin,2020-12-15,21,21,21,21,0,0,0,0,21,21,0,0,21,21,California
San Joaquin,2020-12-16,506,527,506,527,0,0,0,0,506,527,0,0,506,527,California
San Joaquin,2020-12-17,416,943,416,943,0,0,0,0,416,943,0,0,416,943,California
San Joaquin,2020-12-18,691,1634,683,1626,8,8,0,0,691,1634,0,0,691,1634,California
San Joaquin,2020-12-19,224,1858,220,1846,4,12,0,0,224,1858,0,0,224,1858,California
San Joaquin,2020-12-20,126,1984,124,1970,2,14,0,0,126,1984,0,0,126,1984,California
San Joaquin,2020-12-21,605,2589,601,2571,4,18,0,0,605,2589,0,0,605,2589,California
San Joaquin,2020-12-22,1088,3677,962,3533,126,144,0,0,1087,3676,0,0,1087,3676,California
San Joaquin,2020-12-23,1086,4763,1026,4559,60,204,0,0,1084,4760,2,2,1086,4762,California
San Joaquin,2020-12-24,233,4996,203,4762,30,234,0,0,232,4992,1,3,233,4995,California
San Joaquin,2020-12-25,19,5015,19,4781,0,234,0,0,19,5011,0,3,19,5014,California
San Joaquin,2020-12-26,105,5120,33,4814,72,306,0,0,105,5116,0,3,105,5119,California
San Joaquin,2020-12-27,50,5170,36,4850,14,320,0,0,50,5166,0,3,50,5169,California
San Joaquin,2020-12-28,697,5867,490,5340,207,527,0,0,697,5863,0,3,697,5866,California
San Joaquin,2020-12-29,860,6727,725,6065,135,662,0,0,859,6721,1,4,859,6725,California
San Joaquin,2020-12-30,1087,7814,789,6854,298,960,0,0,1085,7806,2,6,1087,7812,California
San Joaquin,2020-12-31,468,8282,204,7058,264,1224,0,0,467,8272,2,8,468,8280,California
San Joaquin,2021-01-01,31,8313,16,7074,15,1239,0,0,31,8303,0,8,31,8311,California
San Joaquin,2021-01-02,275,8588,250,7324,25,1264,0,0,275,8578,0,8,275,8586,California
San Joaquin,2021-01-03,39,8627,20,7344,19,1283,0,0,38,8615,1,9,38,8624,California
San Joaquin,2021-01-04,584,9211,435,7779,149,1432,0,0,582,9196,1,10,582,9206,California
San Joaquin,2021-01-05,1183,10394,814,8593,369,1801,0,0,911,9877,269,279,950,10156,California
San Joaquin,2021-01-06,1430,11824,895,9488,535,2336,0,0,1002,10462,421,700,1006,11162,California
San Joaquin,2021-01-07,1233,13057,822,10310,411,2747,0,0,832,10900,394,1094,832,11994,California
San Joaquin,2021-01-08,1461,14518,1049,11359,412,3159,0,0,830,11111,627,1721,838,12832,California
San Joaquin,2021-01-09,388,14906,305,11664,83,3242,0,0,252,11229,136,1857,254,13086,California
San Joaquin,2021-01-10,234,15140,124,11788,110,3352,0,0,174,11344,59,1916,174,13260,California
San Joaquin,2021-01-11,1707,16847,1473,13261,234,3586,0,0,947,11603,757,2673,1016,14276,California
San Joaquin,2021-01-12,1826,18673,1300,14561,526,4112,0,0,888,11633,930,3603,960,15236,California
San Joaquin,2021-01-13,1680,20353,971,15532,709,4821,0,0,1054,12075,618,4221,1060,16296,California
San Joaquin,2021-01-14,2025,22378,1030,16562,995,5816,0,0,1642,13389,354,4575,1668,17964,California
San Joaquin,2021-01-15,1737,24115,591,17153,1146,6962,0,0,1463,14625,255,4830,1491,19455,California
San Joaquin,2021-01-16,1151,25266,183,17336,968,7930,0,0,1117,15708,34,4864,1117,20572,California
San Joaquin,2021-01-17,1651,26917,144,17480,1507,9437,0,0,1600,17260,51,4915,1603,22175,California
San Joaquin,2021-01-18,789,27706,267,17747,522,9959,0,0,650,17775,135,5050,650,22825,California
San Joaquin,2021-01-19,2084,29790,967,18714,1117,11076,0,0,1340,18389,738,5788,1352,24177,California
San Joaquin,2021-01-20,2310,32100,1362,20076,948,12024,0,0,1598,19292,703,6491,1606,25783,California
San Joaquin,2021-01-21,2200,34300,979,21055,1221,13245,0,0,1752,20614,439,6930,1761,27544,California
San Joaquin,2021-01-22,2186,36486,959,22014,1227,14472,0,0,2006,22447,175,7105,2008,29552,California
San Joaquin,2021-01-23,912,37398,397,22411,515,14987,0,0,618,22777,291,7396,621,30173,California
San Joaquin,2021-01-24,376,37774,142,22553,234,15221,0,0,353,23110,20,7416,353,30526,California
San Joaquin,2021-01-25,2258,40032,1248,23801,1010,16231,0,0,1589,24042,663,8079,1595,32121,California
San Joaquin,2021-01-26,2455,42487,1191,24992,1264,17495,0,0,1740,25095,701,8780,1754,33875,California
San Joaquin,2021-01-27,1931,44418,827,25819,1104,18599,0,0,1374,25924,551,9331,1380,35255,California
San Joaquin,2021-01-28,2345,46763,866,26685,1479,20078,0,0,1575,26750,762,10093,1588,36843,California
San Joaquin,2021-01-29,2421,49184,1105,27790,1316,21394,0,0,1992,28334,419,10512,2003,38846,California
San Joaquin,2021-01-30,2195,51379,359,28149,1836,23230,0,0,2008,30158,186,10698,2010,40856,California
San Joaquin,2021-01-31,1560,52939,173,28322,1387,24617,0,0,1484,31571,73,10771,1486,42342,California
San Joaquin,2021-02-01,2652,55591,1354,29676,1298,25915,0,0,1811,32548,838,11609,1815,44157,California
San Joaquin,2021-02-02,2762,58353,1217,30893,1545,27460,0,0,2081,34018,616,12225,2086,46243,California
San Joaquin,2021-02-03,3258,61611,1276,32169,1982,29442,0,0,2318,35418,932,13157,2332,48575,California
San Joaquin,2021-02-04,3674,65285,1826,33995,1848,31290,0,0,2726,37209,943,14100,2734,51309,California
San Joaquin,2021-02-05,3355,68640,1790,35785,1565,32855,0,0,2445,38794,879,14979,2464,53773,California
San Joaquin,2021-02-06,1034,69674,661,36446,373,33228,0,0,880,39524,151,15130,881,54654,California
San Joaquin,2021-02-07,636,70310,500,36946,136,33364,0,0,424,39743,206,15336,425,55079,California
San Joaquin,2021-02-08,2019,72329,1069,38015,950,34314,0,0,1626,41018,361,15697,1636,56715,California
San Joaquin,2021-02-09,2350,74679,1160,39175,1190,35504,0,0,1715,42184,555,16252,1721,58436,California
San Joaquin,2021-02-10,2887,77566,1277,40452,1610,37114,0,0,1522,42387,1322,17574,1525,59961,California
San Joaquin,2021-02-11,3202,80768,1529,41981,1673,38787,0,0,1780,42823,1352,18926,1788,61749,California
San Joaquin,2021-02-12,3082,83850,1149,43130,1933,40720,0,0,1708,43206,1332,20258,1715,63464,California
San Joaquin,2021-02-13,2262,86112,413,43543,1849,42569,0,0,964,42903,1278,21536,975,64439,California
San Joaquin,2021-02-14,1942,88054,267,43810,1675,44244,0,0,709,42415,1198,22734,710,65149,California
San Joaquin,2021-02-15,2092,90146,838,44648,1254,45498,0,0,1246,42858,805,23539,1248,66397,California
San Joaquin,2021-02-16,3411,93557,1418,46066,1993,47491,0,0,1868,43219,1520,25059,1881,68278,California
San Joaquin,2021-02-17,3617,97174,1313,47379,2304,49795,0,0,1986,43623,1585,26644,1989,70267,California
San Joaquin,2021-02-18,3597,100771,1427,48806,2170,51965,0,0,1991,44077,1543,28187,1997,72264,California
San Joaquin,2021-02-19,4435,105206,2464,51270,1971,53936,0,0,2453,44629,1902,30089,2454,74718,California
San Joaquin,2021-02-20,1630,106836,704,51974,926,54862,0,0,1092,45189,532,30621,1092,75810,California
San Joaquin,2021-02-21,726,107562,535,52509,191,55053,0,0,439,45350,282,30903,443,76253,California
San Joaquin,2021-02-22,3844,111406,2624,55133,1220,56273,0,0,2637,46832,1158,32061,2640,78893,California
San Joaquin,2021-02-23,4680,116086,2710,57843,1970,58243,0,0,2773,47790,1825,33886,2783,81676,California
San Joaquin,2021-02-24,6023,122109,3520,61363,2503,60746,0,0,4231,50288,1737,35623,4235,85911,California
San Joaquin,2021-02-25,6857,128966,4098,65461,2759,63505,0,0,4233,52003,2535,38158,4250,90161,California
San Joaquin,2021-02-26,5802,134768,2987,68448,2815,66320,0,0,3860,53987,1884,40042,3868,94029,California
San Joaquin,2021-02-27,5666,140434,1760,70208,3905,70225,1,1,2693,53790,2901,42943,2704,96733,California
San Joaquin,2021-02-28,3178,143612,1160,71368,2018,72243,0,1,2085,54823,1057,44000,2090,98823,California
San Joaquin,2021-03-01,4616,148228,1896,73264,2716,74959,4,5,2484,55250,2071,46071,2498,101321,California
San Joaquin,2021-03-02,4507,152735,1748,75012,2759,77718,0,5,2815,56465,1654,47725,2869,104190,California
San Joaquin,2021-03-03,6133,158868,3540,78552,2592,80310,1,6,4402,59183,1686,49411,4404,108594,California
San Joaquin,2021-03-04,5970,164838,2343,80895,3624,83934,3,9,3901,61053,2036,51447,3906,112500,California
San Joaquin,2021-03-05,4862,169700,1962,82857,2895,86829,5,14,3328,62918,1473,52920,3338,115838,California
San Joaquin,2021-03-06,3395,173095,2223,85080,1041,87870,131,145,2766,65201,617,53537,2900,118738,California
San Joaquin,2021-03-07,1327,174422,580,85660,645,88515,102,247,975,65929,333,53870,1061,119799,California
San Joaquin,2021-03-08,3342,177764,1294,86954,1911,90426,137,384,2166,67089,1143,55013,2303,122102,California
San Joaquin,2021-03-09,4383,182147,1894,88848,2356,92782,133,517,2772,68449,1553,56566,2913,125015,California
San Joaquin,2021-03-10,5052,187199,2556,91404,2356,95138,140,657,3483,70535,1538,58104,3624,128639,California
San Joaquin,2021-03-11,5377,192576,2500,93904,2271,97409,606,1263,3007,71804,2344,60448,3613,132252,California
San Joaquin,2021-03-12,6773,199349,3303,97207,3128,100537,342,1605,4185,73793,2542,62990,4531,136783,California
San Joaquin,2021-03-13,3272,202621,1530,98737,1616,102153,126,1731,2210,75099,1041,64031,2347,139130,California
San Joaquin,2021-03-14,2194,204815,683,99420,1207,103360,304,2035,1033,75286,1153,65184,1340,140470,California
San Joaquin,2021-03-15,6235,211050,3562,102982,2262,105622,411,2446,3178,75893,2999,68183,3606,144076,California
San Joaquin,2021-03-16,7111,218161,3991,106973,2862,108484,258,2704,4127,77346,2940,71123,4393,148469,California
San Joaquin,2021-03-17,8133,226294,4807,111780,3256,111740,70,2774,4446,78258,3609,74732,4521,152990,California
San Joaquin,2021-03-18,7889,234183,4603,116383,2774,114514,512,3286,3875,78709,3940,78672,4391,157381,California
San Joaquin,2021-03-19,8193,242376,4737,121120,2904,117418,552,3838,4893,80949,3264,81936,5504,162885,California
San Joaquin,2021-03-20,3764,246140,2180,123300,1339,118757,245,4083,1848,81164,1891,83827,2106,164991,California
San Joaquin,2021-03-21,2172,248312,1536,124836,427,119184,209,4292,1166,81627,981,84808,1444,166435,California
San Joaquin,2021-03-22,4239,252551,2120,126956,1703,120887,416,4708,2494,82834,1708,86516,2915,169350,California
San Joaquin,2021-03-23,5593,258144,2739,129695,2686,123573,168,4876,3837,85130,1716,88232,4012,173362,California
San Joaquin,2021-03-24,7103,265247,4349,134044,2659,126232,95,4971,3110,84422,3919,92151,3211,176573,California
San Joaquin,2021-03-25,5859,271106,3426,137470,2385,128617,48,5019,3451,85568,2356,94507,3502,180075,California
San Joaquin,2021-03-26,6586,277692,2655,140125,3776,132393,155,5174,3372,85982,3133,97640,3547,183622,California
San Joaquin,2021-03-27,4741,282433,2669,142794,1997,134390,75,5249,1808,84976,2899,100539,1893,185515,California
San Joaquin,2021-03-28,2789,285222,1850,144644,915,135305,24,5273,1267,84884,1498,102037,1406,186921,California
San Joaquin,2021-03-29,4231,289453,2222,146866,1984,137289,25,5298,2125,84980,2073,104110,2169,189090,California
San Joaquin,2021-03-30,6498,295951,3234,150100,3170,140459,94,5392,3552,85752,2890,107000,3662,192752,California
San Joaquin,2021-03-31,6926,302877,4228,154328,2630,143089,68,5460,3507,85982,3371,110371,3601,196353,California
San Joaquin,2021-04-01,6757,309634,3067,157395,3596,146685,94,5554,2990,85413,3716,114087,3147,199500,California
San Joaquin,2021-04-02,6617,316251,2929,160324,3187,149872,501,6055,2611,84611,3948,118035,3146,202646,California
San Joaquin,2021-04-03,4264,320515,2429,162753,1509,151381,326,6381,2038,84786,2204,120239,2379,205025,California
San Joaquin,2021-04-04,2323,322838,1384,164137,730,152111,209,6590,1543,85800,764,121003,1778,206803,California
San Joaquin,2021-04-05,5058,327896,2911,167048,1903,154014,244,6834,2739,86519,2271,123274,2990,209793,California
San Joaquin,2021-04-06,7417,335313,4613,171661,2525,156539,279,7113,3475,86418,3867,127141,3766,213559,California
San Joaquin,2021-04-07,8575,343888,4629,176290,2353,158892,1593,8706,3598,86685,4933,132074,5200,218759,California
San Joaquin,2021-04-08,9044,352932,4805,181095,2066,160958,2173,10879,3414,86684,5585,137659,5584,224343,California
San Joaquin,2021-04-09,9242,362174,4444,185539,3217,164175,1581,12460,3385,85849,5812,143471,4977,229320,California
San Joaquin,2021-04-10,5308,367482,1684,187223,1702,165877,1922,14382,1804,86086,3483,146954,3720,233040,California
San Joaquin,2021-04-11,4344,371826,1800,189023,1374,167251,1170,15552,2000,86916,2330,149284,3160,236200,California
San Joaquin,2021-04-12,6268,378094,2543,191566,2170,169421,1555,17107,2470,87180,3760,153044,4024,240224,California
San Joaquin,2021-04-13,7780,385874,4456,196022,3315,172736,9,17116,4714,88885,3027,156071,4732,244956,California
San Joaquin,2021-04-14,7955,393829,4106,200128,3846,176582,3,17119,4796,90573,3123,159194,4811,249767,California
San Joaquin,2021-04-15,8310,402139,5028,205156,3281,179863,1,17120,4635,91603,3620,162814,4650,254417,California
San Joaquin,2021-04-16,8166,410305,4523,209679,3639,183502,4,17124,4954,93407,3170,165984,4974,259391,California
San Joaquin,2021-04-17,5281,415586,2886,212565,2393,185895,2,17126,3736,95637,1525,167509,3755,263146,California
San Joaquin,2021-04-18,2819,418405,1708,214273,1111,187006,0,17126,1502,95849,1296,168805,1508,264654,California
San Joaquin,2021-04-19,5368,423773,2874,217147,2493,189499,1,17127,2776,96089,2550,171355,2790,267444,California
San Joaquin,2021-04-20,6529,430302,3519,220666,3009,192508,1,17128,3037,95687,3452,174807,3050,270494,California
San Joaquin,2021-04-21,6141,436443,3524,224190,2616,195124,1,17129,3128,95882,2942,177749,3137,273631,California
San Joaquin,2021-04-22,5631,442074,3366,227556,2263,197387,2,17131,3168,96650,2419,180168,3187,276818,California
San Joaquin,2021-04-23,6287,448361,3077,230633,3209,200596,1,17132,3912,98229,2342,182510,3921,280739,California
San Joaquin,2021-04-24,5333,453694,3674,234307,1657,202253,2,17134,3440,99826,1856,184366,3453,284192,California
San Joaquin,2021-04-25,3111,456805,2622,236929,489,202742,0,17134,2050,100855,1026,185392,2055,286247,California
San Joaquin,2021-04-26,4310,461115,2785,239714,1521,204263,4,17138,2199,100979,2085,187477,2209,288456,California
San Joaquin,2021-04-27,4910,466025,2831,242545,2017,206280,62,17200,2056,100284,2822,190299,2127,290583,California
San Joaquin,2021-04-28,5959,471984,3578,246123,2298,208578,83,17283,2891,100246,3023,193322,2985,293568,California
San Joaquin,2021-04-29,5237,477221,3078,249201,2101,210679,58,17341,2633,100379,2570,195892,2703,296271,California
San Joaquin,2021-04-30,5308,482529,2630,251831,2610,213289,68,17409,2696,100578,2577,198469,2776,299047,California
San Joaquin,2021-05-01,3405,485934,1961,253792,1387,214676,57,17466,2151,101559,1240,199709,2221,301268,California
San Joaquin,2021-05-02,2348,488282,1647,255439,644,215320,57,17523,1179,101632,1164,200873,1237,302505,California
San Joaquin,2021-05-03,3506,491788,2370,257809,1056,216376,80,17603,1439,101114,2046,202919,1528,304033,California
San Joaquin,2021-05-04,5175,496963,3489,261298,1525,217901,161,17764,1874,99892,3268,206187,2046,306079,California
San Joaquin,2021-05-05,5446,502409,3785,265083,1497,219398,164,17928,2327,99316,3075,209262,2499,308578,California
San Joaquin,2021-05-06,4972,507381,3368,268451,1473,220871,131,18059,1994,98500,2954,212216,2138,310716,California
San Joaquin,2021-05-07,5410,512791,3196,271647,2060,222931,154,18213,1818,96932,3556,215772,1988,312704,California
San Joaquin,2021-05-08,3432,516223,2268,273915,1061,223992,103,18316,1261,96158,2147,217919,1373,314077,California
San Joaquin,2021-05-09,1529,517752,886,274801,573,224565,70,18386,494,95698,1030,218949,570,314647,California
San Joaquin,2021-05-10,2984,520736,1602,276403,1257,225822,125,18511,943,94756,2017,220966,1075,315722,California
San Joaquin,2021-05-11,4307,525043,2272,278675,1915,227737,120,18631,1290,93196,2997,223963,1437,317159,California
San Joaquin,2021-05-12,4571,529614,2213,280888,2229,229966,129,18760,1383,91558,3161,227124,1523,318682,California
San Joaquin,2021-05-13,4933,534547,2920,283808,1924,231890,89,18849,1873,90497,3039,230163,1978,320660,California
San Joaquin,2021-05-14,5977,540524,3619,287427,2251,234141,107,18956,2447,89562,3492,233655,2557,323217,California
San Joaquin,2021-05-15,5286,545810,3163,290590,2042,236183,81,19037,1649,87695,3600,237255,1733,324950,California
San Joaquin,2021-05-16,3616,549426,2854,293444,717,236900,45,19082,1464,87076,2134,239389,1515,326465,California
San Joaquin,2021-05-17,4174,553600,2517,295961,1559,238459,98,19180,1778,86588,2373,241762,1885,328350,California
San Joaquin,2021-05-18,4015,557615,2341,298302,1559,240018,115,19295,1852,86419,2139,243901,1970,330320,California
San Joaquin,2021-05-19,4830,562445,2831,301133,1864,241882,135,19430,2028,85827,2765,246666,2173,332493,California
San Joaquin,2021-05-20,4036,566481,2429,303562,1499,243381,108,19538,1728,85386,2278,248944,1837,334330,California
San Joaquin,2021-05-21,5146,571627,3048,306610,1974,245355,124,19662,2307,85021,2803,251747,2438,336768,California
San Joaquin,2021-05-22,4136,575763,2633,309243,1407,246762,96,19758,1824,84656,2296,254043,1931,338699,California
San Joaquin,2021-05-23,2555,578318,2103,311346,407,247169,45,19803,1462,85088,1079,255122,1511,340210,California
San Joaquin,2021-05-24,3107,581425,1832,313178,1181,248350,94,19897,1432,84962,1657,256779,1531,341741,California
San Joaquin,2021-05-25,3171,584596,1979,315157,1043,249393,149,20046,1449,84866,1693,258472,1597,343338,California
San Joaquin,2021-05-26,3939,588535,2431,317588,1434,250827,74,20120,1601,84223,2321,260793,1678,345016,California
San Joaquin,2021-05-27,3159,591694,1726,319314,1347,252174,86,20206,1268,83707,1872,262665,1356,346372,California
San Joaquin,2021-05-28,3170,594864,1714,321028,1365,253539,91,20297,1464,83594,1678,264343,1565,347937,California
San Joaquin,2021-05-29,2156,597020,1204,322232,917,254456,35,20332,916,83318,1233,265576,957,348894,California
San Joaquin,2021-05-30,967,597987,526,322758,415,254871,26,20358,395,83177,566,266142,425,349319,California
San Joaquin,2021-05-31,625,598612,266,323024,352,255223,7,20365,241,83044,381,266523,248,349567,California
San Joaquin,2021-06-01,2489,601101,1511,324535,876,256099,102,20467,1176,83025,1302,267825,1283,350850,California
San Joaquin,2021-06-02,2748,603849,1634,326169,1059,257158,55,20522,1136,82625,1593,269418,1193,352043,California
San Joaquin,2021-06-03,2860,606709,1784,327953,1021,258179,55,20577,1052,81949,1788,271206,1112,353155,California
San Joaquin,2021-06-04,3169,609878,1958,329911,1106,259285,105,20682,1059,81038,2079,273285,1168,354323,California
San Joaquin,2021-06-05,2525,612403,1931,331842,528,259813,66,20748,1144,80966,1286,274571,1214,355537,California
San Joaquin,2021-06-06,1110,613513,894,332736,178,259991,38,20786,433,80779,659,275230,472,356009,California
San Joaquin,2021-06-07,2834,616347,2110,334846,682,260673,42,20828,969,79943,1856,277086,1020,357029,California
San Joaquin,2021-06-08,2783,619130,2122,336968,615,261288,46,20874,876,78978,1890,278976,925,357954,California
San Joaquin,2021-06-09,2885,622015,2025,338993,815,262103,45,20919,990,78136,1878,280854,1036,358990,California
San Joaquin,2021-06-10,2691,624706,1958,340951,662,262765,71,20990,1006,77535,1678,282532,1077,360067,California
San Joaquin,2021-06-11,2989,627695,2086,343037,785,263550,118,21108,978,76634,1998,284530,1097,361164,California
San Joaquin,2021-06-12,1860,629555,1410,344447,420,263970,30,21138,620,76074,1231,285761,671,361835,California
San Joaquin,2021-06-13,1079,630634,835,345282,196,264166,48,21186,500,76050,574,286335,550,362385,California
San Joaquin,2021-06-14,2230,632864,1495,346777,659,264825,76,21262,932,75778,1281,287616,1009,363394,California
San Joaquin,2021-06-15,2259,635123,1517,348294,665,265490,77,21339,877,75374,1361,288977,957,364351,California
San Joaquin,2021-06-16,2804,637927,2048,350342,673,266163,83,21422,916,74499,1873,290850,998,365349,California
San Joaquin,2021-06-17,2615,640542,1875,352217,676,266839,64,21486,888,73736,1715,292565,952,366301,California
San Joaquin,2021-06-18,2876,643418,1943,354160,858,267697,75,21561,1182,73332,1661,294226,1257,367558,California
San Joaquin,2021-06-19,1389,644807,877,355037,252,267949,260,21821,498,73210,880,295106,758,368316,California
San Joaquin,2021-06-20,663,645470,528,355565,108,268057,27,21848,297,73173,360,295466,323,368639,California
San Joaquin,2021-06-21,1612,647082,965,356530,539,268596,108,21956,817,73308,789,296255,924,369563,California
San Joaquin,2021-06-22,1900,648982,1268,357798,560,269156,72,22028,822,73138,1063,297318,893,370456,California
San Joaquin,2021-06-23,1985,650967,1317,359115,593,269749,75,22103,779,72803,1190,298508,855,371311,California
San Joaquin,2021-06-24,1979,652946,1361,360476,527,270276,91,22194,878,72732,1038,299546,967,372278,California
San Joaquin,2021-06-25,1722,654668,1116,361592,530,270806,76,22270,770,72636,943,300489,847,373125,California
San Joaquin,2021-06-26,1328,655996,1021,362613,257,271063,50,22320,653,72721,620,301109,705,373830,California
San Joaquin,2021-06-27,605,656601,472,363085,92,271155,41,22361,280,72730,311,301420,320,374150,California
San Joaquin,2021-06-28,1607,658208,1180,364265,360,271515,67,22428,743,72748,791,302211,809,374959,California
San Joaquin,2021-06-29,1745,659953,1125,365390,546,272061,74,22502,805,72731,891,303102,874,375833,California
San Joaquin,2021-06-30,1824,661777,1282,366672,468,272529,74,22576,800,72627,977,304079,873,376706,California
San Joaquin,2021-07-01,1811,663588,1278,367950,437,272966,96,22672,800,72559,963,305042,895,377601,California
San Joaquin,2021-07-02,1769,665357,1202,369152,514,273480,53,22725,822,72509,926,305968,876,378477,California
San Joaquin,2021-07-03,875,666232,630,369782,219,273699,26,22751,488,72658,365,306333,514,378991,California
San Joaquin,2021-07-04,159,666391,106,369888,40,273739,13,22764,65,72644,92,306425,78,379069,California
San Joaquin,2021-07-05,852,667243,621,370509,189,273928,42,22806,407,72659,434,306859,449,379518,California
San Joaquin,2021-07-06,1566,668809,1043,371552,467,274395,56,22862,681,72569,830,307689,740,380258,California
San Joaquin,2021-07-07,1555,670364,1166,372718,322,274717,67,22929,724,72584,780,308469,795,381053,California
San Joaquin,2021-07-08,1527,671891,1089,373807,382,275099,56,22985,714,72575,779,309248,770,381823,California
San Joaquin,2021-07-09,1749,673640,1285,375092,404,275503,60,23045,815,72543,909,310157,877,382700,California
San Joaquin,2021-07-10,1064,674704,834,375926,194,275697,36,23081,479,72486,578,310735,521,383221,California
San Joaquin,2021-07-11,588,675292,459,376385,106,275803,23,23104,315,72555,270,311005,339,383560,California
San Joaquin,2021-07-12,1354,676646,906,377291,405,276208,43,23147,632,72536,698,311703,679,384239,California
San Joaquin,2021-07-13,1321,677967,868,378159,409,276617,44,23191,686,72642,626,312329,732,384971,California
San Joaquin,2021-07-14,1281,679248,952,379111,287,276904,42,23233,640,72694,635,312964,687,385658,California
San Joaquin,2021-07-15,1561,680809,1167,380278,361,277265,33,23266,775,72730,776,313740,812,386470,California
San Joaquin,2021-07-16,1690,682499,1185,381463,452,277717,53,23319,899,72902,784,314524,956,387426,California
San Joaquin,2021-07-17,999,683498,757,382220,227,277944,15,23334,538,73002,455,314979,555,387981,California
San Joaquin,2021-07-18,528,684026,414,382634,90,278034,24,23358,280,73063,243,315222,304,388285,California
San Joaquin,2021-07-19,1333,685359,943,383577,353,278387,37,23395,712,73197,617,315839,751,389036,California
San Joaquin,2021-07-20,1479,686838,1006,384583,435,278822,38,23433,805,73370,672,316511,845,389881,California
San Joaquin,2021-07-21,1546,688384,1134,385717,383,279205,29,23462,857,73576,679,317190,885,390766,California
San Joaquin,2021-07-22,1731,690115,1272,386989,417,279622,42,23504,1005,73902,723,317913,1049,391815,California
San Joaquin,2021-07-23,1774,691889,1276,388265,464,280086,34,23538,1055,74283,715,318628,1096,392911,California
San Joaquin,2021-07-24,1005,692894,739,389004,250,280336,16,23554,587,74473,415,319043,605,393516,California
San Joaquin,2021-07-25,550,693444,431,389435,96,280432,23,23577,401,74752,146,319189,425,393941,California
San Joaquin,2021-07-26,1468,694912,999,390434,423,280855,46,23623,920,75179,540,319729,967,394908,California
San Joaquin,2021-07-27,2008,696920,1426,391860,511,281366,71,23694,1304,75862,695,320424,1378,396286,California
San Joaquin,2021-07-28,1735,698655,1343,393203,356,281722,36,23730,1083,76339,647,321071,1124,397410,California
San Joaquin,2021-07-29,1867,700522,1381,394584,450,282172,36,23766,1234,76981,629,321700,1271,398681,California
San Joaquin,2021-07-30,2125,702647,1548,396132,535,282707,42,23808,1317,77546,798,322498,1363,400044,California
San Joaquin,2021-07-31,1145,703792,826,396958,285,282992,34,23842,732,77903,408,322906,765,400809,California
San Joaquin,2021-08-01,703,704495,545,397503,140,283132,18,23860,476,78174,224,323130,495,401304,California
San Joaquin,2021-08-02,1613,706108,1156,398659,395,283527,62,23922,1055,78737,555,323685,1118,402422,California
San Joaquin,2021-08-03,1676,707784,1168,399827,460,283987,48,23970,1046,79208,623,324308,1094,403516,California
San Joaquin,2021-08-04,1642,709426,1244,401071,354,284341,44,24014,1000,79622,633,324941,1047,404563,California
San Joaquin,2021-08-05,1748,711174,1245,402316,446,284787,57,24071,1113,80173,625,325566,1176,405739,California
San Joaquin,2021-08-06,2151,713325,1605,403921,489,285276,57,24128,1310,80709,834,326400,1370,407109,California
San Joaquin,2021-08-07,1224,714549,944,404865,248,285524,32,24160,764,81052,454,326854,797,407906,California
San Joaquin,2021-08-08,873,715422,662,405527,203,285727,8,24168,557,81308,311,327165,567,408473,California
San Joaquin,2021-08-09,1727,717149,1216,406743,467,286194,44,24212,1087,81815,631,327796,1138,409611,California
San Joaquin,2021-08-10,1789,718938,1244,407987,505,286699,40,24252,1109,82292,673,328469,1150,410761,California
San Joaquin,2021-08-11,1555,720493,1216,409203,297,286996,42,24294,949,82683,601,329070,992,411753,California
San Joaquin,2021-08-12,2019,722512,1484,410687,476,287472,59,24353,1234,83198,779,329849,1294,413047,California
San Joaquin,2021-08-13,2302,724814,1691,412378,549,288021,62,24415,1362,83692,931,330780,1425,414472,California
San Joaquin,2021-08-14,1339,726153,1059,413437,248,288269,32,24447,795,83998,523,331303,829,415301,California
San Joaquin,2021-08-15,885,727038,710,414147,160,288429,15,24462,579,84297,295,331598,594,415895,California
San Joaquin,2021-08-16,1760,728798,1123,415270,610,289039,27,24489,1045,84685,685,332283,1073,416968,California
San Joaquin,2021-08-17,2139,730937,1481,416751,611,289650,47,24536,1102,84848,989,333272,1152,418120,California
San Joaquin,2021-08-18,2128,733065,1567,418318,516,290166,45,24581,1195,85224,868,334140,1244,419364,California
San Joaquin,2021-08-19,2290,735355,1700,420018,541,290707,49,24630,1226,85525,976,335116,1277,420641,California
San Joaquin,2021-08-20,2479,737834,1822,421840,611,291318,46,24676,1327,85854,1050,336166,1379,422020,California
San Joaquin,2021-08-21,1354,739188,1066,422906,273,291591,15,24691,738,86033,576,336742,755,422775,California
San Joaquin,2021-08-22,874,740062,658,423564,185,291776,31,24722,476,86165,381,337123,513,423288,California
San Joaquin,2021-08-23,2253,742315,1606,425170,607,292383,40,24762,1250,86557,947,338070,1339,424627,California
San Joaquin,2021-08-24,2061,744376,1426,426596,576,292959,59,24821,1082,86811,919,338989,1173,425800,California
San Joaquin,2021-08-25,2124,746500,1621,428217,458,293417,45,24866,1118,87144,856,339845,1189,426989,California
San Joaquin,2021-08-26,2178,748678,1668,429885,492,293909,18,24884,1184,87457,917,340762,1230,428219,California
San Joaquin,2021-08-27,2469,751147,1875,431760,561,294470,33,24917,1298,87735,1089,341851,1367,429586,California
San Joaquin,2021-08-28,1421,752568,1113,432873,291,294761,17,24934,668,87716,718,342569,699,430285,California
San Joaquin,2021-08-29,913,753481,718,433591,192,294953,3,24937,471,87780,428,342997,492,430777,California
San Joaquin,2021-08-30,1038,754519,522,434113,492,295445,24,24961,487,87863,455,343452,538,431315,California
San Luis Obispo,2020-12-15,1,1,1,1,0,0,0,0,1,1,0,0,1,1,California
San Luis Obispo,2020-12-16,5,6,5,6,0,0,0,0,5,6,0,0,5,6,California
San Luis Obispo,2020-12-17,200,206,200,206,0,0,0,0,200,206,0,0,200,206,California
San Luis Obispo,2020-12-18,226,432,226,432,0,0,0,0,226,432,0,0,226,432,California
San Luis Obispo,2020-12-19,164,596,164,596,0,0,0,0,164,596,0,0,164,596,California
San Luis Obispo,2020-12-20,221,817,221,817,0,0,0,0,221,817,0,0,221,817,California
San Luis Obispo,2020-12-21,552,1369,551,1368,1,1,0,0,552,1369,0,0,552,1369,California
San Luis Obispo,2020-12-22,309,1678,305,1673,4,5,0,0,308,1676,1,1,308,1677,California
San Luis Obispo,2020-12-23,682,2360,368,2041,314,319,0,0,682,2358,0,1,682,2359,California
San Luis Obispo,2020-12-24,199,2559,20,2061,179,498,0,0,199,2557,0,1,199,2558,California
San Luis Obispo,2020-12-25,2,2561,1,2062,1,499,0,0,2,2559,0,1,2,2560,California
San Luis Obispo,2020-12-26,92,2653,13,2075,79,578,0,0,92,2651,0,1,92,2652,California
San Luis Obispo,2020-12-27,75,2728,0,2075,75,653,0,0,75,2726,0,1,75,2727,California
San Luis Obispo,2020-12-28,882,3610,430,2505,452,1105,0,0,882,3608,0,1,882,3609,California
San Luis Obispo,2020-12-29,905,4515,504,3009,401,1506,0,0,906,4514,0,1,906,4515,California
San Luis Obispo,2020-12-30,1173,5688,678,3687,495,2001,0,0,1173,5687,0,1,1173,5688,California
San Luis Obispo,2020-12-31,113,5801,5,3692,108,2109,0,0,113,5800,0,1,113,5801,California
San Luis Obispo,2021-01-01,32,5833,17,3709,15,2124,0,0,32,5832,0,1,32,5833,California
San Luis Obispo,2021-01-02,34,5867,7,3716,27,2151,0,0,34,5866,0,1,34,5867,California
San Luis Obispo,2021-01-03,17,5884,6,3722,11,2162,0,0,17,5883,0,1,17,5884,California
San Luis Obispo,2021-01-04,683,6567,523,4245,160,2322,0,0,683,6566,0,1,683,6567,California
San Luis Obispo,2021-01-05,978,7545,751,4996,227,2549,0,0,975,7538,3,4,975,7542,California
San Luis Obispo,2021-01-06,733,8278,481,5477,252,2801,0,0,721,8248,11,15,721,8263,California
San Luis Obispo,2021-01-07,1121,9399,940,6417,181,2982,0,0,680,8487,441,456,680,8943,California
San Luis Obispo,2021-01-08,894,10293,810,7227,84,3066,0,0,517,8629,375,831,517,9460,California
San Luis Obispo,2021-01-09,209,10502,198,7425,11,3077,0,0,29,8478,180,1011,29,9489,California
San Luis Obispo,2021-01-10,13,10515,8,7433,5,3082,0,0,9,8483,4,1015,9,9498,California
San Luis Obispo,2021-01-11,569,11084,515,7948,54,3136,0,0,302,8519,266,1281,302,9800,California
San Luis Obispo,2021-01-12,620,11704,386,8334,234,3370,0,0,324,8563,295,1576,339,10139,California
San Luis Obispo,2021-01-13,900,12604,266,8600,634,4004,0,0,660,8985,238,1814,660,10799,California
San Luis Obispo,2021-01-14,728,13332,238,8838,490,4494,0,0,607,9478,114,1928,607,11406,California
San Luis Obispo,2021-01-15,733,14065,287,9125,446,4940,0,0,559,9866,171,2099,559,11965,California
San Luis Obispo,2021-01-16,108,14173,87,9212,21,4961,0,0,96,9950,12,2111,96,12061,California
San Luis Obispo,2021-01-17,64,14237,56,9268,8,4969,0,0,64,10014,0,2111,64,12125,California
San Luis Obispo,2021-01-18,1386,15623,396,9664,990,5959,0,0,1120,10868,266,2377,1120,13245,California
San Luis Obispo,2021-01-19,1587,17210,420,10084,1167,7126,0,0,1173,11628,414,2791,1174,14419,California
San Luis Obispo,2021-01-20,1905,19115,599,10683,1306,8432,0,0,1314,12354,589,3380,1315,15734,California
San Luis Obispo,2021-01-21,1592,20707,474,11157,1118,9550,0,0,1216,13199,372,3752,1217,16951,California
San Luis Obispo,2021-01-22,1530,22237,512,11669,1018,10568,0,0,1212,14096,315,4067,1212,18163,California
San Luis Obispo,2021-01-23,314,22551,295,11964,19,10587,0,0,297,14376,17,4084,297,18460,California
San Luis Obispo,2021-01-24,452,23003,242,12206,210,10797,0,0,445,14814,7,4091,445,18905,California
San Luis Obispo,2021-01-25,2082,25085,605,12811,1477,12274,0,0,1246,15224,836,4927,1246,20151,California
San Luis Obispo,2021-01-26,2012,27097,708,13519,1304,13578,0,0,1143,15498,869,5796,1143,21294,California
San Luis Obispo,2021-01-27,1624,28721,292,13811,1332,14910,0,0,1160,16195,463,6259,1160,22454,California
San Luis Obispo,2021-01-28,1567,30288,393,14204,1174,16084,0,0,1297,17223,269,6528,1297,23751,California
San Luis Obispo,2021-01-29,1763,32051,697,14901,1066,17150,0,0,1467,18394,296,6824,1467,25218,California
San Luis Obispo,2021-01-30,41,32092,20,14921,21,17171,0,0,30,18414,10,6834,30,25248,California
San Luis Obispo,2021-01-31,242,32334,21,14942,221,17392,0,0,240,18652,2,6836,240,25488,California
San Luis Obispo,2021-02-01,1733,34067,756,15698,977,18369,0,0,1419,19757,314,7150,1419,26907,California
San Luis Obispo,2021-02-02,1915,35982,687,16385,1228,19597,0,0,1535,20913,380,7530,1536,28443,California
San Luis Obispo,2021-02-03,1730,37712,734,17119,996,20593,0,0,1304,21791,426,7956,1304,29747,California
San Luis Obispo,2021-02-04,1679,39391,812,17931,867,21460,0,0,1106,22324,573,8529,1106,30853,California
San Luis Obispo,2021-02-05,1628,41019,719,18650,909,22369,0,0,1078,22852,550,9079,1078,31931,California
San Luis Obispo,2021-02-06,179,41198,105,18755,74,22443,0,0,96,22867,82,9161,97,32028,California
San Luis Obispo,2021-02-07,124,41322,79,18834,45,22488,0,0,72,22888,52,9213,73,32101,California
San Luis Obispo,2021-02-08,871,42193,476,19310,395,22883,0,0,499,23016,371,9584,499,32600,California
San Luis Obispo,2021-02-09,1141,43334,453,19763,688,23571,0,0,553,22996,573,10157,553,33153,California
San Luis Obispo,2021-02-10,1460,44794,498,20261,962,24533,0,0,536,22615,917,11074,536,33689,California
San Luis Obispo,2021-02-11,1348,46142,856,21117,492,25025,0,0,662,22593,684,11758,662,34351,California
San Luis Obispo,2021-02-12,808,46950,371,21488,437,25462,0,0,421,22627,387,12145,421,34772,California
San Luis Obispo,2021-02-13,404,47354,137,21625,267,25729,0,0,288,22800,115,12260,288,35060,California
San Luis Obispo,2021-02-14,326,47680,46,21671,280,26009,0,0,285,23046,40,12300,286,35346,California
San Luis Obispo,2021-02-15,738,48418,140,21811,598,26607,0,0,480,23270,256,12556,480,35826,California
San Luis Obispo,2021-02-16,3007,51425,1204,23015,1803,28410,0,0,1371,23006,1635,14191,1371,37197,California
San Luis Obispo,2021-02-17,2814,54239,1266,24281,1548,29958,0,0,1024,22249,1781,15972,1024,38221,California
San Luis Obispo,2021-02-18,2865,57104,1488,25769,1377,31335,0,0,1101,21598,1754,17726,1103,39324,California
San Luis Obispo,2021-02-19,1484,58588,1357,27126,127,31462,0,0,1142,22400,340,18066,1142,40466,California
San Luis Obispo,2021-02-20,265,58853,89,27215,176,31638,0,0,224,22583,41,18107,224,40690,California
San Luis Obispo,2021-02-21,59,58912,55,27270,4,31642,0,0,30,22584,29,18136,30,40720,California
San Luis Obispo,2021-02-22,2455,61367,1899,29169,556,32198,0,0,1480,23095,970,19106,1481,42201,California
San Luis Obispo,2021-02-23,1878,63245,1757,30926,121,32319,0,0,1363,23946,513,19619,1364,43565,California
San Luis Obispo,2021-02-24,2702,65947,1332,32258,1370,33689,0,0,839,22927,1858,21477,839,44404,California
San Luis Obispo,2021-02-25,2181,68128,1278,33536,903,34592,0,0,1229,23213,944,22421,1230,45634,California
San Luis Obispo,2021-02-26,2716,70844,1181,34717,1535,36127,0,0,1356,23222,1347,23768,1356,46990,California
San Luis Obispo,2021-02-27,615,71459,378,35095,237,36364,0,0,559,23726,55,23823,559,47549,California
San Luis Obispo,2021-02-28,603,72062,69,35164,534,36898,0,0,170,23466,430,24253,170,47719,California
San Luis Obispo,2021-03-01,3057,75119,1906,37070,1149,38047,2,2,2094,24601,962,25215,2097,49816,California
San Luis Obispo,2021-03-02,3109,78228,1945,39015,1164,39211,0,2,1928,25354,1176,26391,1929,51745,California
San Luis Obispo,2021-03-03,2409,80637,376,39391,2033,41244,0,2,876,24708,1523,27914,877,52622,California
San Luis Obispo,2021-03-04,2261,82898,1187,40578,1073,42317,1,3,1218,24894,1036,28950,1222,53844,California
San Luis Obispo,2021-03-05,2337,85235,1038,41616,1226,43543,73,76,1316,25278,1005,29955,1389,55233,California
San Luis Obispo,2021-03-06,846,86081,317,41933,425,43968,104,180,622,25774,223,30178,719,55952,California
San Luis Obispo,2021-03-07,241,86322,35,41968,100,44068,106,286,95,25824,145,30323,195,56147,California
San Luis Obispo,2021-03-08,2776,89098,767,42735,1688,45756,321,607,1567,26502,1204,31527,1882,58029,California
San Luis Obispo,2021-03-09,3003,92101,999,43734,1751,47507,253,860,1548,26849,1451,32978,1798,59827,California
San Luis Obispo,2021-03-10,3234,95335,1248,44982,1695,49202,291,1151,1833,27573,1396,34374,2120,61947,California
San Luis Obispo,2021-03-11,3400,98735,1345,46327,1731,50933,324,1475,1824,28157,1564,35938,2148,64095,California
San Luis Obispo,2021-03-12,3254,101989,1267,47594,1651,52584,336,1811,1624,28490,1623,37561,1956,66051,California
San Luis Obispo,2021-03-13,924,102913,268,47862,546,53130,110,1921,539,28754,383,37944,647,66698,California
San Luis Obispo,2021-03-14,522,103435,61,47923,350,53480,111,2032,139,28623,381,38325,250,66948,California
San Luis Obispo,2021-03-15,3086,106521,1110,49033,1878,55358,98,2130,1530,28702,1553,39878,1632,68580,California
San Luis Obispo,2021-03-16,2865,109386,1514,50547,1241,56599,110,2240,1441,28834,1417,41295,1549,70129,California
San Luis Obispo,2021-03-17,3475,112861,1457,52004,1754,58353,264,2504,2002,29642,1457,42752,2265,72394,California
San Luis Obispo,2021-03-18,2898,115759,1475,53479,1209,59562,214,2718,1377,29718,1512,44264,1588,73982,California
San Luis Obispo,2021-03-19,2629,118388,1585,55064,721,60283,323,3041,962,29351,1654,45918,1287,75269,California
San Luis Obispo,2021-03-20,855,119243,508,55572,307,60590,40,3081,383,29303,471,46389,423,75692,California
San Luis Obispo,2021-03-21,197,119440,49,55621,143,60733,5,3086,162,29435,34,46423,166,75858,California
San Luis Obispo,2021-03-22,2805,122245,1193,56814,1564,62297,48,3134,1940,30564,859,47282,1988,77846,California
San Luis Obispo,2021-03-23,3398,125643,2257,59071,1113,63410,28,3162,2239,31679,1152,48434,2267,80113,California
San Luis Obispo,2021-03-24,3635,129278,2231,61302,1318,64728,86,3248,2683,33502,945,49379,2768,82881,California
San Luis Obispo,2021-03-25,3759,133037,2365,63667,1382,66110,12,3260,2678,35118,1073,50452,2689,85570,California
San Luis Obispo,2021-03-26,3401,136438,1852,65519,1061,67171,488,3748,1880,35970,1514,51966,2366,87936,California
San Luis Obispo,2021-03-27,1014,137452,511,66030,412,67583,91,3839,445,35940,566,52532,536,88472,California
San Luis Obispo,2021-03-28,632,138084,162,66192,414,67997,56,3895,416,36199,213,52745,472,88944,California
San Luis Obispo,2021-03-29,2669,140753,1339,67531,1198,69195,132,4027,1684,37049,968,53713,1818,90762,California
San Luis Obispo,2021-03-30,3566,144319,1959,69490,1467,70662,140,4167,2343,38315,1216,54929,2482,93244,California
San Luis Obispo,2021-03-31,3917,148236,2497,71987,1272,71934,148,4315,2499,39555,1401,56330,2641,95885,California
San Luis Obispo,2021-04-01,3971,152207,2515,74502,1337,73271,119,4434,2743,41214,1200,57530,2859,98744,California
San Luis Obispo,2021-04-02,1763,153970,687,75189,756,74027,320,4754,948,41670,810,58340,1266,100010,California
San Luis Obispo,2021-04-03,1120,155090,558,75747,434,74461,128,4882,495,41675,617,58957,622,100632,California
San Luis Obispo,2021-04-04,385,155475,132,75879,213,74674,40,4922,234,41799,150,59107,274,100906,California
San Luis Obispo,2021-04-05,3682,159157,1956,77835,1607,76281,119,5041,2050,42338,1628,60735,2167,103073,California
San Luis Obispo,2021-04-06,4196,163353,2226,80061,1645,77926,325,5366,1984,42442,2203,62938,2307,105380,California
San Luis Obispo,2021-04-07,4330,167683,2366,82427,1596,79522,368,5734,2481,43457,1831,64769,2846,108226,California
San Luis Obispo,2021-04-08,4033,171716,2209,84636,1410,80932,414,6148,2144,44137,1876,66645,2556,110782,California
San Luis Obispo,2021-04-09,3730,175446,1773,86409,1180,82112,777,6925,1496,44182,2220,68865,2265,113047,California
San Luis Obispo,2021-04-10,1700,177146,572,86981,459,82571,669,7594,496,44140,1201,70066,1159,114206,California
San Luis Obispo,2021-04-11,322,177468,67,87048,187,82758,68,7662,130,44146,190,70256,196,114402,California
San Luis Obispo,2021-04-12,3512,180980,1762,88810,1587,84345,163,7825,1400,43601,2107,72363,1562,115964,California
San Luis Obispo,2021-04-13,3774,184754,2177,90987,1596,85941,1,7826,1988,43811,1780,74143,1990,117954,California
San Luis Obispo,2021-04-14,3605,188359,2065,93052,1535,87476,5,7831,1740,43711,1844,75987,1744,119698,California
San Luis Obispo,2021-04-15,3836,192195,2494,95546,1341,88817,1,7832,2021,43944,1791,77778,2024,121722,California
San Luis Obispo,2021-04-16,3705,195900,2251,97797,1450,90267,4,7836,1745,43744,1947,79725,1747,123469,California
San Luis Obispo,2021-04-17,1103,197003,434,98231,667,90934,2,7838,712,44068,390,80115,714,124183,California
San Luis Obispo,2021-04-18,330,197333,106,98337,223,91157,1,7839,114,43971,212,80327,115,124298,California
San Luis Obispo,2021-04-19,3263,200596,1366,99703,1859,93016,38,7877,1102,42961,2153,82480,1143,125441,California
San Luis Obispo,2021-04-20,3670,204266,2034,101737,1636,94652,0,7877,1296,41899,2359,84839,1297,126738,California
San Luis Obispo,2021-04-21,4068,208334,1868,103605,2198,96850,2,7879,1624,41107,2421,87260,1629,128367,California
San Luis Obispo,2021-04-22,4676,213010,2102,105707,2574,99424,0,7879,1404,39266,3247,90507,1406,129773,California
San Luis Obispo,2021-04-23,1456,214466,845,106552,607,100031,4,7883,731,39282,720,91227,736,130509,California
San Luis Obispo,2021-04-24,1095,215561,445,106997,626,100657,24,7907,513,39231,588,91815,537,131046,California
San Luis Obispo,2021-04-25,522,216083,167,107164,355,101012,0,7907,112,38939,404,92219,112,131158,California
San Luis Obispo,2021-04-26,1095,217178,401,107565,676,101688,18,7925,399,38670,685,92904,416,131574,California
San Luis Obispo,2021-04-27,3964,221142,2012,109577,1872,103560,80,8005,1529,37852,2426,95330,1608,133182,California
San Luis Obispo,2021-04-28,3865,225007,2136,111713,1658,105218,71,8076,1334,36743,2514,97844,1405,134587,California
San Luis Obispo,2021-04-29,3803,228810,2151,113864,1582,106800,70,8146,1244,35518,2540,100384,1315,135902,California
San Luis Obispo,2021-04-30,3053,231863,1716,115580,1262,108062,75,8221,909,34389,2113,102497,984,136886,California
San Luis Obispo,2021-05-01,507,232370,176,115756,287,108349,44,8265,113,34157,387,102884,155,137041,California
San Luis Obispo,2021-05-02,176,232546,55,115811,100,108449,21,8286,44,34090,132,103016,65,137106,California
San Luis Obispo,2021-05-03,916,233462,301,116112,505,108954,110,8396,229,33742,684,103700,336,137442,California
San Luis Obispo,2021-05-04,3049,236511,1973,118085,1003,109957,73,8469,893,32558,2147,105847,963,138405,California
San Luis Obispo,2021-05-05,2910,239421,1910,119995,926,110883,74,8543,675,31094,2213,108060,749,139154,California
San Luis Obispo,2021-05-06,2893,242314,1953,121948,876,111759,64,8607,713,29713,2157,110217,776,139930,California
San Luis Obispo,2021-05-07,2407,244721,1797,123745,534,112293,76,8683,593,28589,1794,112011,670,140600,California
San Luis Obispo,2021-05-08,612,245333,347,124092,236,112529,29,8712,203,28432,389,112400,232,140832,California
San Luis Obispo,2021-05-09,163,245496,39,124131,104,112633,20,8732,43,28376,119,112519,63,140895,California
San Luis Obispo,2021-05-10,750,246246,168,124299,529,113162,53,8785,157,27999,586,113105,209,141104,California
San Luis Obispo,2021-05-11,1215,247461,595,124894,546,113708,74,8859,384,27633,824,113929,458,141562,California
San Luis Obispo,2021-05-12,2541,250002,1635,126529,822,114530,84,8943,692,26579,1829,115758,775,142337,California
San Luis Obispo,2021-05-13,1202,251204,727,127256,411,114941,64,9007,497,26439,700,116458,560,142897,California
San Luis Obispo,2021-05-14,2312,253516,1674,128930,584,115525,54,9061,945,26090,1347,117805,998,143895,California
San Luis Obispo,2021-05-15,999,254515,456,129386,508,116033,35,9096,462,26054,534,118339,498,144393,California
San Luis Obispo,2021-05-16,305,254820,162,129548,137,116170,6,9102,173,26102,131,118470,179,144572,California
San Luis Obispo,2021-05-17,1718,256538,994,130542,662,116832,62,9164,672,25803,1034,119504,735,145307,California
San Luis Obispo,2021-05-18,1927,258465,1177,131719,714,117546,36,9200,731,25381,1190,120694,768,146075,California
San Luis Obispo,2021-05-19,1478,259943,632,132351,782,118328,64,9264,402,24778,1066,121760,463,146538,California
San Luis Obispo,2021-05-20,1159,261102,500,132851,621,118949,38,9302,336,24340,812,122572,374,146912,California
San Luis Obispo,2021-05-21,1116,262218,574,133425,497,119446,45,9347,513,24307,591,123163,558,147470,California
San Luis Obispo,2021-05-22,705,262923,331,133756,345,119791,29,9376,344,24328,352,123515,373,147843,California
San Luis Obispo,2021-05-23,148,263071,69,133825,73,119864,6,9382,51,24289,96,123611,57,147900,California
San Luis Obispo,2021-05-24,583,263654,268,134093,270,120134,45,9427,209,24173,370,123981,254,148154,California
San Luis Obispo,2021-05-25,890,264544,436,134529,426,120560,28,9455,346,24009,537,124518,373,148527,California
San Luis Obispo,2021-05-26,2164,266708,1003,135532,1101,121661,60,9515,661,23234,1495,126013,720,149247,California
San Luis Obispo,2021-05-27,1927,268635,689,136221,1204,122865,34,9549,501,22352,1417,127430,535,149782,California
San Luis Obispo,2021-05-28,942,269577,481,136702,430,123295,31,9580,493,22429,447,127877,524,150306,California
San Luis Obispo,2021-05-29,381,269958,153,136855,216,123511,12,9592,205,22472,175,128052,218,150524,California
San Luis Obispo,2021-05-30,90,270048,36,136891,46,123557,8,9600,36,22463,52,128104,43,150567,California
San Luis Obispo,2021-05-31,44,270092,6,136897,25,123582,13,9613,17,22467,25,128129,29,150596,California
San Luis Obispo,2021-06-01,775,270867,329,137226,413,123995,33,9646,277,22285,492,128621,310,150906,California
San Luis Obispo,2021-06-02,648,271515,294,137520,310,124305,44,9690,181,22048,461,129082,224,151130,California
San Luis Obispo,2021-06-03,928,272443,464,137984,431,124736,33,9723,254,21664,671,129753,287,151417,California
San Luis Obispo,2021-06-04,2525,274968,1546,139530,935,125671,44,9767,717,20628,1794,131547,758,152175,California
San Luis Obispo,2021-06-05,671,275639,291,139821,358,126029,22,9789,327,20634,343,131890,349,152524,California
San Luis Obispo,2021-06-06,190,275829,135,139956,46,126075,9,9798,48,20549,142,132032,57,152581,California
San Luis Obispo,2021-06-07,554,276383,359,140315,150,126225,45,9843,154,20352,396,132428,199,152780,California
San Luis Obispo,2021-06-08,818,277201,532,140847,245,126470,41,9884,248,20075,566,132994,289,153069,California
San Luis Obispo,2021-06-09,646,277847,362,141209,253,126723,31,9915,190,19845,451,133445,221,153290,California
San Luis Obispo,2021-06-10,762,278609,365,141574,357,127080,40,9955,220,19566,539,133984,260,153550,California
San Luis Obispo,2021-06-11,953,279562,549,142123,365,127445,39,9994,340,19338,608,134592,380,153930,California
San Luis Obispo,2021-06-12,395,279957,269,142392,122,127567,4,9998,164,19276,230,134822,168,154098,California
San Luis Obispo,2021-06-13,162,280119,93,142485,66,127633,3,10001,44,19206,117,134939,47,154145,California
San Luis Obispo,2021-06-14,474,280593,307,142792,128,127761,39,10040,132,19038,337,135276,169,154314,California
San Luis Obispo,2021-06-15,646,281239,399,143191,207,127968,40,10080,235,18906,406,135682,274,154588,California
San Luis Obispo,2021-06-16,635,281874,372,143563,227,128195,36,10116,184,18682,442,136124,218,154806,California
San Luis Obispo,2021-06-17,607,282481,347,143910,235,128430,25,10141,197,18496,408,136532,222,155028,California
San Luis Obispo,2021-06-18,796,283277,506,144416,241,128671,49,10190,275,18304,517,137049,325,155353,California
San Luis Obispo,2021-06-19,273,283550,154,144570,104,128775,15,10205,104,18257,166,137215,119,155472,California
San Luis Obispo,2021-06-20,113,283663,74,144644,31,128806,8,10213,46,18245,66,137281,54,155526,California
San Luis Obispo,2021-06-21,357,284020,226,144870,102,128908,29,10242,155,18230,199,137480,184,155710,California
San Luis Obispo,2021-06-22,626,284646,362,145232,229,129137,35,10277,274,18190,349,137829,309,156019,California
San Luis Obispo,2021-06-23,512,285158,285,145517,207,129344,20,10297,245,18188,267,138096,265,156284,California
San Luis Obispo,2021-06-24,481,285639,269,145786,185,129529,27,10324,213,18166,262,138358,240,156524,California
San Luis Obispo,2021-06-25,535,286174,212,145998,297,129826,26,10350,209,18079,320,138678,233,156757,California
San Luis Obispo,2021-06-26,283,286457,155,146153,110,129936,18,10368,128,18071,154,138832,146,156903,California
San Luis Obispo,2021-06-27,151,286608,99,146252,48,129984,4,10372,79,18083,71,138903,83,156986,California
San Luis Obispo,2021-06-28,349,286957,251,146503,82,130066,16,10388,132,18017,213,139116,147,157133,California
San Luis Obispo,2021-06-29,494,287451,314,146817,153,130219,27,10415,205,17964,283,139399,230,157363,California
San Luis Obispo,2021-06-30,466,287917,263,147080,165,130384,38,10453,170,17881,290,139689,207,157570,California
San Luis Obispo,2021-07-01,481,288398,319,147399,144,130528,18,10471,210,17841,268,139957,228,157798,California
San Luis Obispo,2021-07-02,440,288838,211,147610,204,130732,25,10496,176,17782,260,140217,201,157999,California
San Luis Obispo,2021-07-03,431,289269,177,147787,241,130973,13,10509,124,17615,305,140522,138,158137,California
San Luis Obispo,2021-07-04,28,289297,16,147803,11,130984,1,10510,11,17610,17,140539,12,158149,California
San Luis Obispo,2021-07-05,170,289467,94,147897,65,131049,11,10521,82,17617,84,140623,91,158240,California
San Luis Obispo,2021-07-06,485,289952,302,148199,150,131199,33,10554,198,17564,284,140907,231,158471,California
San Luis Obispo,2021-07-07,410,290362,224,148423,130,131329,56,10610,162,17534,245,141152,215,158686,California
San Luis Obispo,2021-07-08,397,290759,238,148661,147,131476,12,10622,181,17513,214,141366,193,158879,California
San Luis Obispo,2021-07-09,437,291196,209,148870,202,131678,26,10648,167,17440,266,141632,193,159072,California
San Luis Obispo,2021-07-10,202,291398,131,149001,64,131742,7,10655,86,17418,115,141747,93,159165,California
San Luis Obispo,2021-07-11,74,291472,46,149047,21,131763,7,10662,37,17426,36,141783,44,159209,California
San Luis Obispo,2021-07-12,277,291749,220,149267,50,131813,7,10669,120,17398,155,141938,127,159336,California
San Luis Obispo,2021-07-13,401,292150,271,149538,122,131935,8,10677,154,17320,240,142178,162,159498,California
San Luis Obispo,2021-07-14,441,292591,274,149812,120,132055,47,10724,188,17303,252,142430,235,159733,California
San Luis Obispo,2021-07-15,347,292938,197,150009,142,132197,8,10732,156,17279,188,142618,164,159897,California
San Luis Obispo,2021-07-16,395,293333,186,150195,186,132383,23,10755,212,17339,175,142793,235,160132,California
San Luis Obispo,2021-07-17,174,293507,91,150286,78,132461,5,10760,83,17338,89,142882,88,160220,California
San Luis Obispo,2021-07-18,125,293632,83,150369,32,132493,10,10770,61,17346,63,142945,71,160291,California
San Luis Obispo,2021-07-19,378,294010,255,150624,97,132590,26,10796,183,17362,191,143136,207,160498,California
San Luis Obispo,2021-07-20,516,294526,302,150926,194,132784,20,10816,263,17397,248,143384,283,160781,California
San Luis Obispo,2021-07-21,385,294911,205,151131,147,132931,33,10849,210,17470,170,143554,243,161024,California
San Luis Obispo,2021-07-22,359,295270,162,151293,178,133109,19,10868,178,17486,181,143735,197,161221,California
San Luis Obispo,2021-07-23,465,295735,279,151572,170,133279,16,10884,253,17546,209,143944,269,161490,California
San Luis Obispo,2021-07-24,319,296054,215,151787,90,133369,14,10898,169,17583,146,144090,183,161673,California
San Luis Obispo,2021-07-25,101,296155,53,151840,46,133415,2,10900,56,17597,44,144134,58,161731,California
San Luis Obispo,2021-07-26,386,296541,231,152071,124,133539,31,10931,230,17707,150,144284,260,161991,California
San Luis Obispo,2021-07-27,399,296940,221,152292,146,133685,32,10963,198,17740,197,144481,230,162221,California
San Luis Obispo,2021-07-28,508,297448,330,152622,141,133826,37,11000,278,17829,226,144707,315,162536,California
San Luis Obispo,2021-07-29,416,297864,200,152822,162,133988,54,11054,224,17923,184,144891,278,162814,California
San Luis Obispo,2021-07-30,496,298360,256,153078,213,134201,27,11081,285,18029,206,145097,312,163126,California
San Luis Obispo,2021-07-31,242,298602,133,153211,98,134299,11,11092,129,18056,113,145210,140,163266,California
San Luis Obispo,2021-08-01,158,298760,121,153332,37,134336,0,11092,119,18137,38,145248,119,163385,California
San Luis Obispo,2021-08-02,453,299213,274,153606,149,134485,30,11122,289,18296,158,145406,317,163702,California
San Luis Obispo,2021-08-03,550,299763,366,153972,159,134644,25,11147,310,18396,235,145641,335,164037,California
San Luis Obispo,2021-08-04,503,300266,340,154312,130,134774,33,11180,276,18487,218,145859,309,164346,California
San Luis Obispo,2021-08-05,444,300710,243,154555,164,134938,37,11217,274,18632,166,146025,311,164657,California
San Luis Obispo,2021-08-06,456,301166,252,154807,182,135120,22,11239,263,18734,184,146209,286,164943,California
San Luis Obispo,2021-08-07,329,301495,223,155030,89,135209,17,11256,210,18848,114,146323,228,165171,California
San Luis Obispo,2021-08-08,199,301694,128,155158,46,135255,25,11281,130,18939,64,146387,155,165326,California
San Luis Obispo,2021-08-09,458,302152,302,155460,124,135379,32,11313,283,19084,171,146558,316,165642,California
San Luis Obispo,2021-08-10,533,302685,352,155812,134,135513,47,11360,284,19170,242,146800,328,165970,California
San Luis Obispo,2021-08-11,540,303225,314,156126,164,135677,62,11422,276,19251,257,147057,338,166308,California
San Luis Obispo,2021-08-12,483,303708,258,156384,191,135868,34,11456,252,19314,222,147279,285,166593,California
San Luis Obispo,2021-08-13,531,304239,305,156689,197,136065,29,11485,293,19415,220,147499,321,166914,California
San Luis Obispo,2021-08-14,360,304599,230,156919,121,136186,9,11494,198,19494,128,147627,207,167121,California
San Luis Obispo,2021-08-15,294,304893,223,157142,65,136251,6,11500,173,19590,83,147710,179,167300,California
San Luis Obispo,2021-08-16,694,305587,479,157621,186,136437,29,11529,302,19637,283,147993,330,167630,California
San Luis Obispo,2021-08-17,639,306226,395,158016,224,136661,20,11549,276,19698,235,148228,296,167926,California
San Luis Obispo,2021-08-18,661,306887,400,158416,221,136882,40,11589,274,19770,241,148469,313,168239,California
San Luis Obispo,2021-08-19,543,307430,277,158693,229,137111,37,11626,218,19830,194,148663,254,168493,California
San Luis Obispo,2021-08-20,722,308152,449,159142,245,137356,28,11654,302,19884,276,148939,330,168823,California
San Luis Obispo,2021-08-21,403,308555,296,159438,100,137456,7,11661,187,19915,163,149102,194,169017,California
San Luis Obispo,2021-08-22,240,308795,179,159617,59,137515,2,11663,106,19927,96,149198,108,169125,California
San Luis Obispo,2021-08-23,648,309443,430,160047,194,137709,24,11687,251,19943,259,149457,275,169400,California
San Luis Obispo,2021-08-24,658,310101,432,160479,187,137896,39,11726,277,20024,234,149691,315,169715,California
San Luis Obispo,2021-08-25,635,310736,380,160859,220,138116,35,11761,235,20044,250,149941,270,169985,California
San Luis Obispo,2021-08-26,634,311370,340,161199,260,138376,34,11795,224,20065,235,150176,256,170241,California
San Luis Obispo,2021-08-27,740,312110,493,161692,215,138591,32,11827,276,20059,314,150490,308,170549,California
San Luis Obispo,2021-08-28,420,312530,299,161991,119,138710,2,11829,155,20017,199,150689,157,170706,California
San Luis Obispo,2021-08-29,253,312783,169,162160,84,138794,0,11829,87,19999,105,150794,87,170793,California
San Luis Obispo,2021-08-30,385,313168,256,162416,124,138918,5,11834,108,19916,195,150989,112,170905,California
San Mateo,2020-12-15,25,25,25,25,0,0,0,0,25,25,0,0,25,25,California
San Mateo,2020-12-16,123,148,123,148,0,0,0,0,123,148,0,0,123,148,California
San Mateo,2020-12-17,175,323,175,323,0,0,0,0,175,323,0,0,175,323,California
San Mateo,2020-12-18,774,1097,772,1095,2,2,0,0,774,1097,0,0,774,1097,California
San Mateo,2020-12-19,514,1611,514,1609,0,2,0,0,514,1611,0,0,514,1611,California
San Mateo,2020-12-20,515,2126,514,2123,1,3,0,0,515,2126,0,0,515,2126,California
San Mateo,2020-12-21,1149,3275,1148,3271,1,4,0,0,1149,3275,0,0,1149,3275,California
San Mateo,2020-12-22,1525,4800,1516,4787,9,13,0,0,1524,4798,1,1,1524,4799,California
San Mateo,2020-12-23,1551,6351,1364,6151,187,200,0,0,1551,6349,0,1,1551,6350,California
San Mateo,2020-12-24,873,7224,608,6759,265,465,0,0,873,7222,0,1,873,7223,California
San Mateo,2020-12-25,116,7340,112,6871,4,469,0,0,116,7338,0,1,116,7339,California
San Mateo,2020-12-26,569,7909,428,7299,141,610,0,0,569,7907,0,1,569,7908,California
San Mateo,2020-12-27,300,8209,167,7466,133,743,0,0,300,8207,0,1,300,8208,California
San Mateo,2020-12-28,1078,9287,728,8194,350,1093,0,0,1078,9285,0,1,1078,9286,California
San Mateo,2020-12-29,1269,10556,843,9037,426,1519,0,0,1269,10554,0,1,1269,10555,California
San Mateo,2020-12-30,1349,11905,831,9868,518,2037,0,0,1349,11903,0,1,1349,11904,California
San Mateo,2020-12-31,711,12616,226,10094,485,2522,0,0,710,12612,1,2,710,12614,California
San Mateo,2021-01-01,113,12729,78,10172,35,2557,0,0,113,12725,0,2,113,12727,California
San Mateo,2021-01-02,396,13125,270,10442,126,2683,0,0,396,13121,0,2,396,13123,California
San Mateo,2021-01-03,281,13406,206,10648,75,2758,0,0,278,13396,3,5,278,13401,California
San Mateo,2021-01-04,1058,14464,680,11328,378,3136,0,0,1058,14454,0,5,1058,14459,California
San Mateo,2021-01-05,1223,15687,722,12050,501,3637,0,0,1187,15606,36,41,1188,15647,California
San Mateo,2021-01-06,1487,17174,980,13030,507,4144,0,0,1292,16705,194,235,1293,16940,California
San Mateo,2021-01-07,1458,18632,816,13846,642,4786,0,0,1151,17556,300,535,1151,18091,California
San Mateo,2021-01-08,1888,20520,1230,15076,658,5444,0,0,1160,17992,724,1259,1160,19251,California
San Mateo,2021-01-09,1177,21697,778,15854,399,5843,0,0,716,18248,461,1720,717,19968,California
San Mateo,2021-01-10,702,22399,575,16429,127,5970,0,0,261,18068,441,2161,261,20229,California
San Mateo,2021-01-11,2635,25034,1521,17950,1114,7084,0,0,1546,18530,1088,3249,1550,21779,California
San Mateo,2021-01-12,3450,28484,1935,19885,1515,8599,0,0,2230,19550,1215,4464,2235,24014,California
San Mateo,2021-01-13,3417,31901,1666,21551,1751,10350,0,0,2374,20882,1043,5507,2375,26389,California
San Mateo,2021-01-14,3823,35724,1638,23189,2185,12535,0,0,3109,23286,710,6217,3114,29503,California
San Mateo,2021-01-15,4348,40072,1733,24922,2615,15150,0,0,3785,26517,556,6773,3787,33290,California
San Mateo,2021-01-16,3121,43193,783,25705,2338,17488,0,0,2783,28964,337,7110,2784,36074,California
San Mateo,2021-01-17,1326,44519,316,26021,1010,18498,0,0,1075,29790,249,7359,1075,37149,California
San Mateo,2021-01-18,1377,45896,550,26571,827,19325,0,0,988,30393,385,7744,988,38137,California
San Mateo,2021-01-19,2816,48712,1802,28373,1014,20339,0,0,1922,31425,890,8634,1922,40059,California
San Mateo,2021-01-20,3006,51718,1745,30118,1261,21600,0,0,2135,32693,868,9502,2136,42195,California
San Mateo,2021-01-21,2930,54648,1362,31480,1568,23168,0,0,2311,34391,616,10118,2314,44509,California
San Mateo,2021-01-22,2847,57495,1172,32652,1675,24843,0,0,2538,36624,306,10424,2539,47048,California
San Mateo,2021-01-23,2870,60365,1671,34323,1199,26042,0,0,2511,38776,359,10783,2511,49559,California
San Mateo,2021-01-24,1504,61869,374,34697,1130,27172,0,0,1197,39668,306,11089,1198,50757,California
San Mateo,2021-01-25,4417,66286,3148,37845,1269,28441,0,0,3513,42285,900,11989,3517,54274,California
San Mateo,2021-01-26,4346,70632,3008,40853,1338,29779,0,0,3402,44748,941,12930,3404,57678,California
San Mateo,2021-01-27,2826,73458,1478,42331,1348,31127,0,0,1788,45503,1034,13964,1789,59467,California
San Mateo,2021-01-28,2848,76306,1384,43715,1464,32591,0,0,1968,46608,863,14827,1968,61435,California
San Mateo,2021-01-29,3009,79315,1367,45082,1642,34233,0,0,2147,47901,857,15684,2150,63585,California
San Mateo,2021-01-30,3519,82834,1496,46578,2023,36256,0,0,3058,50501,459,16143,3059,66644,California
San Mateo,2021-01-31,1684,84518,899,47477,785,37041,0,0,1520,51860,161,16304,1520,68164,California
San Mateo,2021-02-01,2952,87470,1359,48836,1593,38634,0,0,2216,53346,732,17036,2218,70382,California
San Mateo,2021-02-02,3249,90719,1751,50587,1498,40132,0,0,2205,54511,1040,18076,2205,72587,California
San Mateo,2021-02-03,5050,95769,2053,52640,2997,43129,0,0,3901,57268,1145,19221,3902,76489,California
San Mateo,2021-02-04,6278,102047,2505,55145,3773,46902,0,0,4966,60932,1306,20527,4970,81459,California
San Mateo,2021-02-05,6841,108888,2558,57703,4283,51185,0,0,4985,64081,1837,22364,4986,86445,California
San Mateo,2021-02-06,3301,112189,1929,59632,1372,52557,0,0,2628,66043,668,23032,2630,89075,California
San Mateo,2021-02-07,1890,114079,1345,60977,545,53102,0,0,1696,67547,192,23224,1696,90771,California
San Mateo,2021-02-08,5301,119380,2275,63252,3026,56128,0,0,3116,68543,2120,25344,3116,93887,California
San Mateo,2021-02-09,6150,125530,3174,66426,2976,59104,0,0,3295,68992,2846,28190,3295,97182,California
San Mateo,2021-02-10,6598,132128,3328,69754,3270,62374,0,0,3301,69014,3279,31469,3301,100483,California
San Mateo,2021-02-11,7106,139234,3614,73368,3492,65866,0,0,3781,69478,3319,34788,3783,104266,California
San Mateo,2021-02-12,6693,145927,3018,76386,3675,69541,0,0,4721,72237,1964,36752,4723,108989,California
San Mateo,2021-02-13,6262,152189,4147,80533,2115,71656,0,0,2654,71291,3601,40353,2655,111644,California
San Mateo,2021-02-14,4758,156947,3136,83669,1622,73278,0,0,1988,70518,2762,43115,1989,113633,California
San Mateo,2021-02-15,3160,160107,1458,85127,1702,74980,0,0,1770,70907,1382,44497,1771,115404,California
San Mateo,2021-02-16,7191,167298,1897,87024,5294,80274,0,0,5298,74317,1890,46387,5300,120704,California
San Mateo,2021-02-17,7134,174432,1965,88989,5169,85443,0,0,5049,77289,2078,48465,5050,125754,California
San Mateo,2021-02-18,6810,181242,4716,93705,2094,87537,0,0,4519,79531,2281,50746,4523,130277,California
San Mateo,2021-02-19,7896,189138,5882,99587,2014,89551,0,0,5839,83326,2046,52792,5841,136118,California
San Mateo,2021-02-20,3864,193002,2478,102065,1386,90937,0,0,2374,84219,1482,54274,2375,138493,California
San Mateo,2021-02-21,2683,195685,1828,103893,855,91792,0,0,1591,84726,1085,55359,1592,140085,California
San Mateo,2021-02-22,4627,200312,3368,107261,1259,93051,0,0,2898,85903,1722,57081,2899,142984,California
San Mateo,2021-02-23,4518,204830,3246,110507,1272,94323,0,0,2606,86610,1899,58980,2606,145590,California
San Mateo,2021-02-24,7609,212439,3424,113931,4185,98508,0,0,5030,89075,2566,61546,5031,150621,California
San Mateo,2021-02-25,9697,222136,4302,118233,5395,103903,0,0,6346,92091,3332,64878,6348,156969,California
San Mateo,2021-02-26,10305,232441,3986,122219,6319,110222,0,0,7102,96012,3183,68061,7104,164073,California
San Mateo,2021-02-27,7244,239685,3734,125953,3510,113732,0,0,3899,96583,3334,71395,3905,167978,California
San Mateo,2021-02-28,4602,244287,2834,128787,1768,115500,0,0,2754,97503,1835,73230,2755,170733,California
San Mateo,2021-03-01,6261,250548,3941,132728,2315,117815,5,5,3081,97429,3162,76392,3088,173821,California
San Mateo,2021-03-02,6469,257017,4582,137310,1886,119701,1,6,3693,98361,2764,79156,3696,177517,California
San Mateo,2021-03-03,8875,265892,4098,141408,4775,124476,2,8,3716,96940,5140,84296,3719,181236,California
San Mateo,2021-03-04,8919,274811,4149,145557,4766,129242,4,12,3924,95899,4970,89266,3929,185165,California
San Mateo,2021-03-05,9640,284451,6426,151983,3209,132451,5,17,6701,99696,2914,92180,6711,191876,California
San Mateo,2021-03-06,8072,292523,5615,157598,2278,134729,179,196,5908,103632,2149,94329,6085,197961,California
San Mateo,2021-03-07,3716,296239,2446,160044,1111,135840,159,355,2144,104367,1566,95895,2301,200262,California
San Mateo,2021-03-08,4610,300849,2573,162617,1803,137643,234,589,3324,106637,1279,97174,3549,203811,California
San Mateo,2021-03-09,5526,306375,2892,165509,2334,139977,300,889,3859,109130,1652,98826,4145,207956,California
San Mateo,2021-03-10,7319,313694,2946,168455,4070,144047,303,1192,4864,111847,2438,101264,5155,213111,California
San Mateo,2021-03-11,9183,322877,5753,174208,3032,147079,398,1590,3666,110410,5481,106745,4044,217155,California
San Mateo,2021-03-12,10645,333522,6714,180922,3540,150619,391,1981,3594,107345,7028,113773,3963,221118,California
San Mateo,2021-03-13,8296,341818,3521,184443,3136,153755,1639,3620,4062,108786,4217,117990,5658,226776,California
San Mateo,2021-03-14,5013,346831,3391,187834,1515,155270,107,3727,2663,109208,2342,120332,2764,229540,California
San Mateo,2021-03-15,7203,354034,4650,192484,2368,157638,185,3912,3732,109659,3460,123792,3911,233451,California
San Mateo,2021-03-16,12019,366053,4418,196902,7479,165117,122,4034,4818,107423,7178,130970,4942,238393,California
San Mateo,2021-03-17,10991,377044,4486,201388,6356,171473,149,4183,4915,106437,6044,137014,5058,243451,California
San Mateo,2021-03-18,7413,384457,4184,205572,3035,174508,194,4377,4376,107976,3026,140040,4565,248016,California
San Mateo,2021-03-19,7576,392033,4904,210476,1994,176502,678,5055,3617,108315,3944,143984,4283,252299,California
San Mateo,2021-03-20,8568,400601,6610,217086,1613,178115,345,5400,5425,110955,3125,147109,5765,258064,California
San Mateo,2021-03-21,4271,404872,3254,220340,787,178902,230,5630,2271,111456,1986,149095,2487,260551,California
San Mateo,2021-03-22,5361,410233,3651,223991,1289,180191,421,6051,2806,112136,2539,151634,3219,263770,California
San Mateo,2021-03-23,9997,420230,4602,228593,5199,185390,196,6247,4413,111196,5548,157182,4608,268378,California
San Mateo,2021-03-24,9640,429870,5550,234143,3944,189334,146,6393,4071,109915,5491,162673,4210,272588,California
San Mateo,2021-03-25,10312,440182,5032,239175,4965,194299,315,6708,4383,108798,5816,168489,4699,277287,California
San Mateo,2021-03-26,11426,451608,7844,247019,3405,197704,177,6885,4219,106036,7156,175645,4394,281681,California
San Mateo,2021-03-27,10726,462334,8227,255246,2392,200096,107,6992,4747,104925,5956,181601,4845,286526,California
San Mateo,2021-03-28,4280,466614,2786,258032,1383,201479,111,7103,1969,104705,2297,183898,2077,288603,California
San Mateo,2021-03-29,6131,472745,3797,261829,2079,203558,255,7358,2700,104245,3408,187306,2948,291551,California
San Mateo,2021-03-30,7264,480009,4116,265945,2994,206552,154,7512,3861,104871,3385,190691,4011,295562,California
San Mateo,2021-03-31,7391,487400,4638,270583,2605,209157,148,7660,3848,105344,3522,194213,3995,299557,California
San Mateo,2021-04-01,10754,498154,5305,275888,4228,213385,1221,8881,5821,107423,4874,199087,6953,306510,California
San Mateo,2021-04-02,11008,509162,5228,281116,4106,217491,1674,10555,5732,109521,5253,204340,7351,313861,California
San Mateo,2021-04-03,10128,519290,5801,286917,2467,219958,1860,12415,5150,111506,4965,209305,6950,320811,California
San Mateo,2021-04-04,5465,524755,2636,289553,1574,221532,1255,13670,1728,110731,3721,213026,2946,323757,California
San Mateo,2021-04-05,9047,533802,4795,294348,2509,224041,1743,15413,3910,111196,5116,218142,5581,329338,California
San Mateo,2021-04-06,13382,547184,8279,302627,3241,227282,1862,17275,7595,114832,5768,223910,9404,338742,California
San Mateo,2021-04-07,11489,558673,5330,307957,4464,231746,1695,18970,4882,114772,6587,230497,6527,345269,California
San Mateo,2021-04-08,10307,568980,5092,313049,2577,234323,2638,21608,4605,116267,5680,236177,7175,352444,California
San Mateo,2021-04-09,11469,580449,5586,318635,3389,237712,2494,24102,5195,117616,6265,242442,7614,360058,California
San Mateo,2021-04-10,11469,591918,5809,324444,4191,241903,1469,25571,4747,117097,6684,249126,6165,366223,California
San Mateo,2021-04-11,6729,598647,3328,327772,886,242789,2515,28086,2366,117584,4356,253482,4843,371066,California
San Mateo,2021-04-12,7401,606048,4506,332278,1909,244698,986,29072,3566,118305,3812,257294,4533,375599,California
San Mateo,2021-04-13,8347,614395,5183,337461,3154,247852,10,29082,4399,118784,3933,261227,4412,380011,California
San Mateo,2021-04-14,8531,622926,5557,343018,2973,250825,1,29083,4390,119061,4123,265350,4400,384411,California
San Mateo,2021-04-15,11396,634322,7564,350582,3829,254654,3,29086,7401,122511,3958,269308,7408,391819,California
San Mateo,2021-04-16,10148,644470,6979,357561,3151,257805,18,29104,6368,125155,3749,273057,6393,398212,California
San Mateo,2021-04-17,10005,654475,6657,364218,3346,261151,2,29106,6193,127564,3799,276856,6208,404420,California
San Mateo,2021-04-18,5815,660290,2937,367155,2877,264028,1,29107,3897,129568,1901,278757,3905,408325,California
San Mateo,2021-04-19,8512,668802,5536,372691,2976,267004,0,29107,5494,132076,2999,281756,5507,413832,California
San Mateo,2021-04-20,10842,679644,6205,378896,4635,271639,2,29109,6913,135097,3905,285661,6926,420758,California
San Mateo,2021-04-21,10000,689644,6962,385858,3035,274674,3,29112,6179,137495,3790,289451,6188,426946,California
San Mateo,2021-04-22,10358,700002,7017,392875,3338,278012,3,29115,5747,138688,4569,294020,5762,432708,California
San Mateo,2021-04-23,10091,710093,6774,399649,3317,281329,0,29115,5670,139985,4391,298411,5688,438396,California
San Mateo,2021-04-24,11529,721622,8224,407873,3304,284633,1,29116,5916,140334,5578,303989,5927,444323,California
San Mateo,2021-04-25,5626,727248,3911,411784,1713,286346,2,29118,4010,142761,1597,305586,4024,448347,California
San Mateo,2021-04-26,6991,734239,5065,416849,1916,288262,10,29128,4026,143864,2948,308534,4051,452398,California
San Mateo,2021-04-27,11675,745914,8231,425080,3287,291549,157,29285,4774,141944,6863,315397,4943,457341,California
San Mateo,2021-04-28,8326,754240,4850,429930,3267,294816,209,29494,4440,142735,3865,319262,4656,461997,California
San Mateo,2021-04-29,8568,762808,4117,434047,4276,299092,175,29669,3870,142129,4666,323928,4060,466057,California
San Mateo,2021-04-30,8544,771352,5415,439462,2965,302057,164,29833,3654,141108,4860,328788,3839,469896,California
San Mateo,2021-05-01,6305,777657,4229,443691,1958,304015,118,29951,2752,140464,3530,332318,2886,472782,California
San Mateo,2021-05-02,3236,780893,1769,445460,1393,305408,74,30025,1165,139651,2058,334376,1245,474027,California
San Mateo,2021-05-03,6198,787091,4621,450081,1429,306837,148,30173,1864,137346,4320,338696,2015,476042,California
San Mateo,2021-05-04,7789,794880,5392,455473,2220,309057,177,30350,2578,134926,5195,343891,2775,478817,California
San Mateo,2021-05-05,7334,802214,4895,460368,2276,311333,163,30513,2451,132692,4849,348740,2615,481432,California
San Mateo,2021-05-06,9100,811314,7154,467522,1767,313100,179,30692,1795,127388,7283,356023,1979,483411,California
San Mateo,2021-05-07,8487,819801,6104,473626,2095,315195,288,30980,1856,122952,6597,362620,2161,485572,California
San Mateo,2021-05-08,7083,826884,4401,478027,2441,317636,241,31221,1947,120027,5118,367738,2193,487765,California
San Mateo,2021-05-09,3179,830063,2476,480503,632,318268,71,31292,915,118764,2251,369989,988,488753,California
San Mateo,2021-05-10,4928,834991,3563,484066,1192,319460,173,31465,745,115521,4169,374158,926,489679,California
San Mateo,2021-05-11,7442,842433,5647,489713,1665,321125,130,31595,1752,111734,5671,379829,1884,491563,California
San Mateo,2021-05-12,7218,849651,5228,494941,1774,322899,216,31811,1441,107631,5759,385588,1656,493219,California
San Mateo,2021-05-13,9872,859523,7411,502352,2365,325264,96,31907,3463,104829,6374,391962,3572,496791,California
San Mateo,2021-05-14,8650,868173,6400,508752,2131,327395,119,32026,2594,101519,6031,397993,2721,499512,California
San Mateo,2021-05-15,10797,878970,8469,517221,2227,329622,101,32127,4797,100457,5981,403974,4919,504431,California
San Mateo,2021-05-16,7380,886350,5261,522482,2048,331670,71,32198,2297,97770,5056,409030,2369,506800,California
San Mateo,2021-05-17,7296,893646,5184,527666,2002,333672,110,32308,2151,94917,5121,414151,2268,509068,California
San Mateo,2021-05-18,8616,902262,5964,533630,2554,336226,98,32406,3095,92723,5394,419545,3200,512268,California
San Mateo,2021-05-19,8049,910311,6013,539643,1913,338139,123,32529,3619,92096,4373,423918,3746,516014,California
San Mateo,2021-05-20,5887,916198,3687,543330,2064,340203,136,32665,2228,90836,3628,427546,2368,518382,California
San Mateo,2021-05-21,7091,923289,4830,548160,2117,342320,144,32809,1886,87686,5182,432728,2032,520414,California
San Mateo,2021-05-22,6514,929803,4441,552601,2003,344323,70,32879,2684,86635,3808,436536,2757,523171,California
San Mateo,2021-05-23,3176,932979,1811,554412,1275,345598,90,32969,1203,85970,1958,438494,1293,524464,California
San Mateo,2021-05-24,3731,936710,2463,556875,1119,346717,149,33118,1258,84932,2444,440938,1406,525870,California
San Mateo,2021-05-25,4842,941552,3061,559936,1604,348321,177,33295,1588,83470,3231,444169,1769,527639,California
San Mateo,2021-05-26,5788,947340,3134,563070,2534,350855,120,33415,1804,81436,3958,448127,1924,529563,California
San Mateo,2021-05-27,3823,951163,2217,565287,1504,352359,102,33517,1211,80161,2583,450710,1308,530871,California
San Mateo,2021-05-28,3558,954721,2238,567525,1234,353593,86,33603,1323,79380,2189,452899,1408,532279,California
San Mateo,2021-05-29,3290,958011,2327,569852,910,354503,53,33656,1249,78673,2007,454906,1300,533579,California
San Mateo,2021-05-30,1666,959677,1125,570977,480,354983,61,33717,652,78383,1003,455909,713,534292,California
San Mateo,2021-05-31,442,960119,278,571255,155,355138,9,33726,158,78270,280,456189,167,534459,California
San Mateo,2021-06-01,3372,963491,1997,573252,1280,356418,95,33821,967,76943,2388,458577,1061,535520,California
San Mateo,2021-06-02,2818,966309,1862,575114,874,357292,82,33903,1078,76378,1723,460300,1158,536678,California
San Mateo,2021-06-03,3894,970203,3066,578180,714,358006,114,34017,848,74306,3030,463330,958,537636,California
San Mateo,2021-06-04,4181,974384,3221,581401,864,358870,96,34113,1137,72505,3023,466353,1222,538858,California
San Mateo,2021-06-05,5243,979627,4586,585987,558,359428,99,34212,959,69311,4252,470605,1058,539916,California
San Mateo,2021-06-06,2546,982173,2092,588079,391,359819,63,34275,475,67798,2048,472653,535,540451,California
San Mateo,2021-06-07,3148,985321,2639,590718,427,360246,82,34357,709,66156,2430,475083,788,541239,California
San Mateo,2021-06-08,4110,989431,3472,594190,533,360779,105,34462,965,64117,3109,478192,1070,542309,California
San Mateo,2021-06-09,4169,993600,3589,597779,511,361290,69,34531,611,61251,3545,481737,679,542988,California
San Mateo,2021-06-10,3021,996621,2447,600226,457,361747,117,34648,743,59851,2260,483997,860,543848,California
San Mateo,2021-06-11,2907,999528,2333,602559,463,362210,111,34759,933,58934,1961,485958,1044,544892,California
San Mateo,2021-06-12,3208,1002736,2862,605421,265,362475,81,34840,782,57386,2410,488368,862,545754,California
San Mateo,2021-06-13,1468,1004204,1106,606527,299,362774,63,34903,350,56699,1100,489468,413,546167,California
San Mateo,2021-06-14,2487,1006691,2154,608681,250,363024,83,34986,711,55752,1741,491209,794,546961,California
San Mateo,2021-06-15,2282,1008973,1811,610492,350,363374,121,35107,674,54956,1590,492799,794,547755,California
San Mateo,2021-06-16,2482,1011455,2062,612554,263,363637,157,35264,684,54040,1753,494552,837,548592,California
San Mateo,2021-06-17,1984,1013439,1643,614197,254,363891,87,35351,703,53603,1228,495780,791,549383,California
San Mateo,2021-06-18,2130,1015569,1779,615976,271,364162,80,35431,604,52778,1505,497285,680,550063,California
San Mateo,2021-06-19,1796,1017365,1576,617552,163,364325,57,35488,594,52296,1131,498416,649,550712,California
San Mateo,2021-06-20,777,1018142,706,618258,60,364385,11,35499,288,52139,456,498872,299,551011,California
San Mateo,2021-06-21,1257,1019399,939,619197,240,364625,78,35577,581,52131,668,499540,660,551671,California
San Mateo,2021-06-22,1597,1020996,1297,620494,207,364832,93,35670,593,51829,988,500528,686,552357,California
San Mateo,2021-06-23,1860,1022856,1576,622070,180,365012,104,35774,620,51346,1207,501735,724,553081,California
San Mateo,2021-06-24,1479,1024335,1101,623171,274,365286,104,35878,530,51048,927,502662,629,553710,California
San Mateo,2021-06-25,1808,1026143,1504,624675,227,365513,77,35955,668,50669,1124,503786,745,554455,California
San Mateo,2021-06-26,1259,1027402,1063,625738,138,365651,58,36013,496,50476,746,504532,553,555008,California
San Mateo,2021-06-27,662,1028064,538,626276,78,365729,46,36059,294,50450,366,504898,340,555348,California
San Mateo,2021-06-28,1265,1029329,1080,627356,107,365836,78,36137,500,50277,750,505648,577,555925,California
San Mateo,2021-06-29,1449,1030778,1166,628522,199,366035,84,36221,494,49906,946,506594,575,556500,California
San Mateo,2021-06-30,1291,1032069,1060,629582,131,366166,100,36321,582,49891,696,507290,681,557181,California
San Mateo,2021-07-01,1262,1033331,1067,630649,130,366296,65,36386,511,49741,725,508015,575,557756,California
San Mateo,2021-07-02,1492,1034823,1239,631888,179,366475,74,36460,571,49478,908,508923,645,558401,California
San Mateo,2021-07-03,1079,1035902,919,632807,117,366592,43,36503,421,49295,644,509567,461,558862,California
San Mateo,2021-07-04,51,1035953,45,632852,0,366592,6,36509,25,49301,25,509592,31,558893,California
San Mateo,2021-07-05,827,1036780,694,633546,106,366698,27,36536,356,49218,463,510055,380,559273,California
San Mateo,2021-07-06,1365,1038145,1128,634674,149,366847,88,36624,557,49062,798,510853,642,559915,California
San Mateo,2021-07-07,1151,1039296,934,635608,137,366984,80,36704,414,48834,721,511574,493,560408,California
San Mateo,2021-07-08,1167,1040463,947,636555,157,367141,63,36767,373,48486,786,512360,438,560846,California
San Mateo,2021-07-09,1180,1041643,929,637484,173,367314,78,36845,543,48481,623,512983,618,561464,California
San Mateo,2021-07-10,832,1042475,676,638160,108,367422,48,36893,328,48360,494,513477,373,561837,California
San Mateo,2021-07-11,485,1042960,389,638549,64,367486,32,36925,214,48346,259,513736,245,562082,California
San Mateo,2021-07-12,1083,1044043,940,639489,107,367593,36,36961,406,48116,672,514408,442,562524,California
San Mateo,2021-07-13,1063,1045106,853,640342,152,367745,58,37019,444,48010,608,515016,502,563026,California
San Mateo,2021-07-14,1102,1046208,931,641273,117,367862,54,37073,458,47887,636,515652,513,563539,California
San Mateo,2021-07-15,1025,1047233,816,642089,145,368007,64,37137,415,47763,601,516253,477,564016,California
San Mateo,2021-07-16,1097,1048330,884,642973,158,368165,55,37192,467,47663,621,516874,521,564537,California
San Mateo,2021-07-17,905,1049235,781,643754,88,368253,36,37228,419,47643,475,517349,455,564992,California
San Mateo,2021-07-18,533,1049768,445,644199,69,368322,19,37247,250,47644,268,517617,269,565261,California
San Mateo,2021-07-19,1103,1050871,918,645117,129,368451,56,37303,513,47634,579,518196,569,565830,California
San Mateo,2021-07-20,1060,1051931,832,645949,164,368615,64,37367,486,47632,550,518746,548,566378,California
San Mateo,2021-07-21,1145,1053076,923,646872,156,368771,66,37433,583,47733,548,519294,649,567027,California
San Mateo,2021-07-22,1149,1054225,899,647771,176,368947,74,37507,525,47722,609,519903,598,567625,California
San Mateo,2021-07-23,1060,1055285,849,648620,162,369109,49,37556,541,47806,506,520409,590,568215,California
San Mateo,2021-07-24,959,1056244,800,649420,117,369226,42,37598,449,47806,490,520899,490,568705,California
San Mateo,2021-07-25,408,1056652,317,649737,59,369285,32,37630,272,47979,131,521030,304,569009,California
San Mateo,2021-07-26,965,1057617,745,650482,159,369444,61,37691,563,48215,387,521417,623,569632,California
San Mateo,2021-07-27,1194,1058811,996,651478,134,369578,64,37755,605,48308,574,521991,667,570299,California
San Mateo,2021-07-28,1012,1059823,793,652271,134,369712,85,37840,525,48442,475,522466,609,570908,California
San Mateo,2021-07-29,1047,1060870,847,653118,131,369843,69,37909,559,48594,476,522942,628,571536,California
San Mateo,2021-07-30,1169,1062039,935,654053,179,370022,55,37964,586,48680,553,523495,639,572175,California
San Mateo,2021-07-31,872,1062911,705,654758,127,370149,40,38004,489,48844,365,523860,529,572704,California
San Mateo,2021-08-01,557,1063468,478,655236,49,370198,30,38034,315,48957,232,524092,345,573049,California
San Mateo,2021-08-02,1015,1064483,818,656054,126,370324,71,38105,589,49204,411,524503,658,573707,California
San Mateo,2021-08-03,1138,1065621,908,656962,162,370486,68,38173,645,49438,479,524982,713,574420,California
San Mateo,2021-08-04,1173,1066794,958,657920,150,370636,65,38238,653,49655,498,525480,715,575135,California
San Mateo,2021-08-05,1178,1067972,988,658908,131,370767,59,38297,664,49879,497,525977,721,575856,California
San Mateo,2021-08-06,1179,1069151,919,659827,172,370939,88,38385,643,50101,506,526483,728,576584,California
San Mateo,2021-08-07,998,1070149,838,660665,103,371042,57,38442,564,50299,423,526906,621,577205,California
San Mateo,2021-08-08,555,1070704,473,661138,62,371104,20,38462,295,50372,241,527147,314,577519,California
San Mateo,2021-08-09,1200,1071904,1022,662160,133,371237,45,38507,613,50465,565,527712,658,578177,California
San Mateo,2021-08-10,1206,1073110,974,663134,169,371406,63,38570,620,50584,561,528273,680,578857,California
San Mateo,2021-08-11,1115,1074225,891,664025,173,371579,51,38621,579,50697,516,528789,629,579486,California
San Mateo,2021-08-12,1217,1075442,952,664977,174,371753,91,38712,612,50835,563,529352,701,580187,California
San Mateo,2021-08-13,1274,1076716,971,665948,228,371981,75,38787,655,50998,566,529918,729,580916,California
San Mateo,2021-08-14,1074,1077790,890,666838,146,372127,38,38825,506,51068,474,530392,544,581460,California
San Mateo,2021-08-15,645,1078435,500,667338,126,372253,19,38844,298,51133,251,530643,316,581776,California
San Mateo,2021-08-16,1260,1079695,940,668278,267,372520,53,38897,540,51190,533,531176,590,582366,California
San Mateo,2021-08-17,1398,1081093,1032,669310,294,372814,72,38969,593,51259,597,531773,666,583032,California
San Mateo,2021-08-18,1499,1082592,1102,670412,308,373122,89,39058,635,51377,606,532379,724,583756,California
San Mateo,2021-08-19,1399,1083991,957,671369,352,373474,90,39148,503,51405,562,532941,590,584346,California
San Mateo,2021-08-20,1673,1085664,1170,672539,437,373911,66,39214,629,51452,648,533589,695,585041,California
San Mateo,2021-08-21,1153,1086817,866,673405,241,374152,46,39260,433,51470,460,534049,478,585519,California
San Mateo,2021-08-22,782,1087599,591,673996,162,374314,29,39289,310,51492,318,534367,340,585859,California
San Mateo,2021-08-23,1495,1089094,1041,675037,386,374700,68,39357,560,51564,555,534922,627,586486,California
San Mateo,2021-08-24,1520,1090614,1124,676161,336,375036,60,39417,497,51512,609,535531,557,587043,California
San Mateo,2021-08-25,1522,1092136,1148,677309,319,375355,55,39472,538,51490,616,536147,594,587637,California
San Mateo,2021-08-26,1562,1093698,1142,678451,346,375701,74,39546,513,51453,622,536769,585,588222,California
San Mateo,2021-08-27,1561,1095259,1161,679612,344,376045,56,39602,524,51346,687,537456,580,588802,California
San Mateo,2021-08-28,1198,1096457,932,680544,237,376282,29,39631,372,51151,595,538051,400,589202,California
San Mateo,2021-08-29,685,1097142,504,681048,163,376445,18,39649,223,51071,321,538372,241,589443,California
San Mateo,2021-08-30,998,1098140,677,681725,267,376712,54,39703,287,51006,405,538777,340,589783,California
Santa Barbara,2020-12-15,2,2,2,2,0,0,0,0,2,2,0,0,2,2,California
Santa Barbara,2020-12-16,2,4,2,4,0,0,0,0,2,4,0,0,2,4,California
Santa Barbara,2020-12-17,165,169,165,169,0,0,0,0,165,169,0,0,165,169,California
Santa Barbara,2020-12-18,409,578,408,577,1,1,0,0,409,578,0,0,409,578,California
Santa Barbara,2020-12-19,345,923,345,922,0,1,0,0,344,922,0,0,344,922,California
Santa Barbara,2020-12-20,234,1157,234,1156,0,1,0,0,234,1156,0,0,234,1156,California
Santa Barbara,2020-12-21,678,1835,676,1832,2,3,0,0,678,1834,0,0,678,1834,California
Santa Barbara,2020-12-22,269,2104,267,2099,2,5,0,0,269,2103,0,0,269,2103,California
Santa Barbara,2020-12-23,337,2441,219,2318,118,123,0,0,336,2439,0,0,336,2439,California
Santa Barbara,2020-12-24,92,2533,43,2361,49,172,0,0,92,2531,0,0,92,2531,California
Santa Barbara,2020-12-26,334,2867,75,2436,259,431,0,0,334,2865,0,0,334,2865,California
Santa Barbara,2020-12-27,64,2931,1,2437,63,494,0,0,64,2929,0,0,64,2929,California
Santa Barbara,2020-12-28,373,3304,240,2677,133,627,0,0,373,3302,0,0,373,3302,California
Santa Barbara,2020-12-29,570,3874,368,3045,202,829,0,0,570,3872,0,0,570,3872,California
Santa Barbara,2020-12-30,592,4466,403,3448,189,1018,0,0,591,4463,0,0,591,4463,California
Santa Barbara,2020-12-31,252,4718,124,3572,128,1146,0,0,252,4715,0,0,252,4715,California
Santa Barbara,2021-01-01,127,4845,121,3693,6,1152,0,0,127,4842,0,0,127,4842,California
Santa Barbara,2021-01-02,602,5447,235,3928,367,1519,0,0,602,5444,0,0,602,5444,California
Santa Barbara,2021-01-03,24,5471,16,3944,8,1527,0,0,24,5468,0,0,24,5468,California
Santa Barbara,2021-01-04,307,5778,245,4189,62,1589,0,0,306,5774,0,0,306,5774,California
Santa Barbara,2021-01-05,767,6545,390,4579,377,1966,0,0,732,6471,35,35,732,6506,California
Santa Barbara,2021-01-06,668,7213,279,4858,389,2355,0,0,560,6924,107,142,560,7066,California
Santa Barbara,2021-01-07,1055,8268,734,5592,321,2676,0,0,484,6841,567,709,484,7550,California
Santa Barbara,2021-01-08,1217,9485,858,6450,359,3035,0,0,707,7038,510,1219,707,8257,California
Santa Barbara,2021-01-09,590,10075,313,6763,277,3312,0,0,323,7095,267,1486,324,8581,California
Santa Barbara,2021-01-10,64,10139,51,6814,13,3325,0,0,46,7123,18,1504,46,8627,California
Santa Barbara,2021-01-11,866,11005,698,7512,168,3493,0,0,619,7496,246,1750,619,9246,California
Santa Barbara,2021-01-12,1452,12457,659,8171,793,4286,0,0,1279,8602,173,1923,1279,10525,California
Santa Barbara,2021-01-13,1237,13694,284,8455,953,5239,0,0,1098,9562,139,2062,1099,11624,California
Santa Barbara,2021-01-14,1273,14967,148,8603,1125,6364,0,0,1211,10713,61,2123,1212,12836,California
Santa Barbara,2021-01-15,1823,16790,436,9039,1387,7751,0,0,1732,12356,89,2212,1732,14568,California
Santa Barbara,2021-01-16,1281,18071,208,9247,1073,8824,0,0,1237,13550,43,2255,1237,15805,California
Santa Barbara,2021-01-17,127,18198,24,9271,103,8927,0,0,124,13671,3,2258,124,15929,California
Santa Barbara,2021-01-18,1156,19354,426,9697,730,9657,0,0,964,14444,192,2450,965,16894,California
Santa Barbara,2021-01-19,1669,21023,574,10271,1095,10752,0,0,1380,15538,286,2736,1380,18274,California
Santa Barbara,2021-01-20,2245,23268,670,10941,1575,12327,0,0,1812,16919,432,3168,1813,20087,California
Santa Barbara,2021-01-21,3236,26504,1943,12884,1293,13620,0,0,3062,19810,173,3341,3064,23151,California
Santa Barbara,2021-01-22,2957,29461,1801,14685,1156,14776,0,0,2779,22414,175,3516,2779,25930,California
Santa Barbara,2021-01-23,1751,31212,1114,15799,637,15413,0,0,1230,23124,520,4036,1230,27160,California
Santa Barbara,2021-01-24,861,32073,761,16560,100,15513,0,0,851,23965,10,4046,851,28011,California
Santa Barbara,2021-01-25,1250,33323,504,17064,746,16259,0,0,1008,24731,242,4288,1008,29019,California
Santa Barbara,2021-01-26,2088,35411,509,17573,1579,17838,0,0,1704,26053,382,4670,1704,30723,California
Santa Barbara,2021-01-27,1173,36584,402,17975,771,18609,0,0,906,26695,266,4936,908,31631,California
Santa Barbara,2021-01-28,913,37497,305,18280,608,19217,0,0,690,27168,217,5153,690,32321,California
Santa Barbara,2021-01-29,1353,38850,526,18806,827,20044,0,0,986,27792,363,5516,987,33308,California
Santa Barbara,2021-01-30,1906,40756,1411,20217,495,20539,0,0,1483,28855,420,5936,1483,34791,California
Santa Barbara,2021-01-31,1463,42219,1210,21427,253,20792,0,0,1421,30235,42,5978,1422,36213,California
Santa Barbara,2021-02-01,965,43184,526,21953,439,21231,0,0,563,30396,402,6380,563,36776,California
Santa Barbara,2021-02-02,1815,44999,687,22640,1128,22359,0,0,1049,30682,763,7143,1049,37825,California
Santa Barbara,2021-02-03,1986,46985,1093,23733,893,23252,0,0,1524,31754,452,7595,1524,39349,California
Santa Barbara,2021-02-04,2830,49815,1893,25626,937,24189,0,0,2524,33978,301,7896,2525,41874,California
Santa Barbara,2021-02-05,2937,52752,2083,27709,854,25043,0,0,2278,35599,657,8553,2278,44152,California
Santa Barbara,2021-02-06,1215,53967,335,28044,880,25923,0,0,795,35975,420,8973,796,44948,California
Santa Barbara,2021-02-07,313,54280,269,28313,44,25967,0,0,273,36211,38,9011,274,45222,California
Santa Barbara,2021-02-08,956,55236,310,28623,646,26613,0,0,667,36589,289,9300,667,45889,California
Santa Barbara,2021-02-09,2465,57701,322,28945,2143,28756,0,0,1126,36387,1328,10628,1126,47015,California
Santa Barbara,2021-02-10,2793,60494,1509,30454,1284,30040,0,0,740,35089,2039,12667,741,47756,California
Santa Barbara,2021-02-11,4266,64760,2845,33299,1421,31461,0,0,651,32142,3598,16265,651,48407,California
Santa Barbara,2021-02-12,3319,68079,946,34245,2373,33834,0,0,775,30380,2537,18802,775,49182,California
Santa Barbara,2021-02-13,1254,69333,346,34591,908,34742,0,0,566,30261,686,19488,567,49749,California
Santa Barbara,2021-02-14,343,69676,43,34634,300,35042,0,0,291,30502,52,19540,293,50042,California
Santa Barbara,2021-02-15,992,70668,353,34987,639,35681,0,0,500,30515,489,20029,502,50544,California
Santa Barbara,2021-02-16,2193,72861,465,35452,1728,37409,0,0,731,29789,1457,21486,731,51275,California
Santa Barbara,2021-02-17,1471,74332,342,35794,1129,38538,0,0,524,29374,942,22428,527,51802,California
Santa Barbara,2021-02-18,3299,77631,2677,38471,622,39160,0,0,1537,29190,1722,24150,1538,53340,California
Santa Barbara,2021-02-19,3618,81249,2657,41128,961,40121,0,0,2338,30252,1277,25427,2339,55679,California
Santa Barbara,2021-02-20,2347,83596,1538,42666,809,40930,0,0,1762,31440,575,26002,1763,57442,California
Santa Barbara,2021-02-21,149,83745,119,42785,30,40960,0,0,65,31423,82,26084,65,57507,California
Santa Barbara,2021-02-22,991,84736,269,43054,722,41682,0,0,286,31006,703,26787,286,57793,California
Santa Barbara,2021-02-23,3384,88120,1121,44175,2263,43945,0,0,438,28502,2943,29730,439,58232,California
Santa Barbara,2021-02-24,3394,91514,1165,45340,2229,46174,0,0,751,26625,2628,32358,751,58983,California
Santa Barbara,2021-02-25,3653,95167,2026,47366,1627,47801,0,0,1056,25100,2586,34944,1061,60044,California
Santa Barbara,2021-02-26,3858,99025,2309,49675,1549,49350,0,0,2081,25417,1765,36709,2082,62126,California
Santa Barbara,2021-02-27,1764,100789,591,50266,1173,50523,0,0,937,25538,821,37530,942,63068,California
Santa Barbara,2021-02-28,1171,101960,234,50500,937,51460,0,0,960,26297,203,37733,962,64030,California
Santa Barbara,2021-03-01,1771,103731,540,51040,1229,52689,2,2,1193,26938,555,38288,1196,65226,California
Santa Barbara,2021-03-02,2816,106547,458,51498,2357,55046,1,3,2285,28707,518,38806,2287,67513,California
Santa Barbara,2021-03-03,4804,111351,2201,53699,2601,57647,2,5,4180,32278,616,39422,4187,71700,California
Santa Barbara,2021-03-04,3586,114937,2397,56096,1189,58836,0,5,2992,34690,582,40004,2994,74694,California
Santa Barbara,2021-03-05,4063,119000,2269,58365,1734,60570,60,65,3281,37256,776,40780,3342,78036,California
Santa Barbara,2021-03-06,2516,121516,755,59120,1539,62109,222,287,1726,38411,785,41565,1940,79976,California
Santa Barbara,2021-03-07,731,122247,129,59249,358,62467,244,531,429,38782,301,41866,672,80648,California
Santa Barbara,2021-03-08,1626,123873,389,59638,875,63342,362,893,816,39153,803,42669,1174,81822,California
Santa Barbara,2021-03-09,2839,126712,367,60005,1691,65033,781,1674,760,38599,2075,44744,1521,83343,California
Santa Barbara,2021-03-10,2806,129518,564,60569,1185,66218,1057,2731,1073,38987,1727,46471,2115,85458,California
Santa Barbara,2021-03-11,5610,135128,3038,63607,1456,67674,1116,3847,2283,39065,3306,49777,3384,88842,California
Santa Barbara,2021-03-12,3776,138904,2156,65763,1179,68853,441,4288,2208,40144,1559,51336,2638,91480,California
Santa Barbara,2021-03-13,3608,142512,2015,67778,1385,70238,208,4496,2721,42194,879,52215,2929,94409,California
Santa Barbara,2021-03-14,859,143371,433,68211,370,70608,56,4552,532,42458,324,52539,588,94997,California
Santa Barbara,2021-03-15,2131,145502,703,68914,1133,71741,295,4847,1274,43173,849,53388,1564,96561,California
Santa Barbara,2021-03-16,3746,149248,1188,70102,2217,73958,341,5188,2744,45262,995,54383,3084,99645,California
Santa Barbara,2021-03-17,3346,152594,988,71090,1956,75914,402,5590,2345,47005,998,55381,2741,102386,California
Santa Barbara,2021-03-18,5298,157892,2808,73898,2286,78200,204,5794,4045,50014,1236,56617,4245,106631,California
Santa Barbara,2021-03-19,4509,162401,2787,76685,1384,79584,338,6132,3046,51937,1457,58074,3380,110011,California
Santa Barbara,2021-03-20,2261,164662,850,77535,1381,80965,30,6162,1368,52449,887,58961,1399,111410,California
Santa Barbara,2021-03-21,1188,165850,387,77922,769,81734,32,6194,853,53002,331,59292,884,112294,California
Santa Barbara,2021-03-22,2797,168647,1934,79856,817,82551,46,6240,2205,54669,584,59876,2251,114545,California
Santa Barbara,2021-03-23,4508,173155,2289,82145,2116,84667,103,6343,3696,57663,802,60678,3796,118341,California
Santa Barbara,2021-03-24,5474,178629,3166,85311,1535,86202,773,7116,2924,58825,2527,63205,3689,122030,California
Santa Barbara,2021-03-25,5616,184245,3294,88605,2118,88320,204,7320,2708,58849,2889,66094,2913,124943,California
Santa Barbara,2021-03-26,5145,189390,3249,91854,1584,89904,312,7632,2122,58277,3003,69097,2431,127374,California
Santa Barbara,2021-03-27,3002,192392,1238,93092,1720,91624,44,7676,1565,58453,1432,70529,1608,128982,California
Santa Barbara,2021-03-28,2815,195207,1674,94766,1112,92736,29,7705,1867,59409,943,71472,1899,130881,California
Santa Barbara,2021-03-29,4070,199277,2092,96858,1904,94640,74,7779,3210,61838,855,72327,3284,134165,California
Santa Barbara,2021-03-30,6837,206114,3526,100384,3161,97801,150,7929,4448,64067,2369,74696,4598,138763,California
Santa Barbara,2021-03-31,8713,214827,5539,105923,3107,100908,67,7996,4948,65341,3740,78436,5014,143777,California
Santa Barbara,2021-04-01,7095,221922,5240,111163,1593,102501,262,8258,4165,66868,2900,81336,4427,148204,California
Santa Barbara,2021-04-02,6668,228590,4573,115736,1501,104002,594,8852,3340,67482,3317,84653,3931,152135,California
Santa Barbara,2021-04-03,3833,232423,2122,117858,1643,105645,68,8920,2511,68745,1314,85967,2577,154712,California
Santa Barbara,2021-04-04,916,233339,447,118305,429,106074,40,8960,488,68848,426,86393,529,155241,California
Santa Barbara,2021-04-05,3520,236859,2315,120620,936,107010,269,9229,2186,69979,1323,87716,2454,157695,California
Santa Barbara,2021-04-06,5538,242397,2855,123475,2116,109126,567,9796,3371,71761,2146,89862,3928,161623,California
Santa Barbara,2021-04-07,6047,248444,3299,126774,2206,111332,542,10338,4098,74459,1938,91800,4636,166259,California
Santa Barbara,2021-04-08,7453,255897,5068,131842,655,111987,1730,12068,3442,75627,4000,95800,5168,171427,California
Santa Barbara,2021-04-09,7358,263255,4880,136722,1108,113095,1370,13438,3292,76227,4055,99855,4655,176082,California
Santa Barbara,2021-04-10,6726,269981,4659,141381,1449,114544,618,14056,4563,79252,2151,102006,5176,181258,California
Santa Barbara,2021-04-11,2687,272668,1967,143348,418,114962,302,14358,1854,80576,825,102831,2149,183407,California
Santa Barbara,2021-04-12,4425,277093,2841,146189,1028,115990,556,14914,1905,80526,2509,105340,2459,185866,California
Santa Barbara,2021-04-13,6387,283480,4185,150374,2196,118186,6,14920,2622,79398,3755,109095,2627,188493,California
Santa Barbara,2021-04-14,6827,290307,4428,154802,2397,120583,2,14922,4240,81065,2577,111672,4244,192737,California
Santa Barbara,2021-04-15,7016,297323,4116,158918,2899,123482,1,14923,3757,81576,3248,114920,3759,196496,California
Santa Barbara,2021-04-16,6445,303768,3778,162696,2657,126139,10,14933,4420,84004,2002,116922,4430,200926,California
Santa Barbara,2021-04-17,5356,309124,3873,166569,1483,127622,0,14933,4085,86834,1255,118177,4085,205011,California
Santa Barbara,2021-04-18,2198,311322,1532,168101,666,128288,0,14933,374,85395,1814,119991,375,205386,California
Santa Barbara,2021-04-19,3286,314608,2264,170365,1016,129304,6,14939,1030,84182,2248,122239,1035,206421,California
Santa Barbara,2021-04-20,5960,320568,3986,174351,1972,131276,2,14941,1650,81541,4291,126530,1650,208071,California
Santa Barbara,2021-04-21,5622,326190,3727,178078,1895,133171,0,14941,1775,79494,3824,130354,1777,209848,California
Santa Barbara,2021-04-22,5229,331419,2622,180700,2606,135777,1,14942,1499,77290,3707,134061,1503,211351,California
Santa Barbara,2021-04-23,5742,337161,3979,184679,1763,137540,0,14942,2018,75603,3705,137766,2018,213369,California
Santa Barbara,2021-04-24,4523,341684,2946,187625,1572,139112,5,14947,1649,74406,2852,140618,1655,215024,California
Santa Barbara,2021-04-25,1874,343558,1207,188832,667,139779,0,14947,502,73547,1361,141979,502,215526,California
Santa Barbara,2021-04-26,3310,346868,2014,190846,1275,141054,21,14968,580,71430,2719,144698,602,216128,California
Santa Barbara,2021-04-27,4074,350942,2242,193088,1728,142782,104,15072,1199,69869,2861,147559,1300,217428,California
Santa Barbara,2021-04-28,4963,355905,2885,195973,1961,144743,117,15189,1417,67881,3525,151084,1537,218965,California
Santa Barbara,2021-04-29,5379,361284,3896,199869,1250,145993,233,15422,1475,65704,3885,154969,1708,220673,California
Santa Barbara,2021-04-30,5052,366336,3781,203650,1106,147099,165,15587,1429,63695,3602,158571,1593,222266,California
Santa Barbara,2021-05-01,5339,371675,4122,207772,1182,148281,35,15622,912,60235,4409,162980,949,223215,California
Santa Barbara,2021-05-02,1146,372821,674,208446,343,148624,129,15751,315,59850,829,163809,444,223659,California
Santa Barbara,2021-05-03,2228,375049,1489,209935,600,149224,139,15890,444,58657,1775,165584,582,224241,California
Santa Barbara,2021-05-04,3371,378420,1716,211651,1581,150805,74,15964,1165,57707,2188,167772,1238,225479,California
Santa Barbara,2021-05-05,5531,383951,3716,215367,1666,152471,149,16113,648,53640,4865,172637,798,226277,California
Santa Barbara,2021-05-06,5141,389092,3977,219344,1057,153528,107,16220,990,50604,4133,176770,1097,227374,California
Santa Barbara,2021-05-07,4715,393807,3691,223035,844,154372,180,16400,1005,48093,3694,180464,1183,228557,California
Santa Barbara,2021-05-08,4378,398185,3247,226282,1031,155403,100,16500,920,45673,3441,183905,1021,229578,California
Santa Barbara,2021-05-09,705,398890,112,226394,553,155956,40,16540,465,45942,237,184142,506,230084,California
Santa Barbara,2021-05-10,1383,400273,675,227069,625,156581,83,16623,386,45417,994,185136,469,230553,California
Santa Barbara,2021-05-11,1956,402229,855,227924,804,157385,297,16920,455,44671,1492,186628,746,231299,California
Santa Barbara,2021-05-12,2103,404332,749,228673,1125,158510,229,17149,522,43856,1566,188194,751,232050,California
Santa Barbara,2021-05-13,3938,408270,2819,231492,919,159429,200,17349,1232,42597,2690,190884,1431,233481,California
Santa Barbara,2021-05-14,4187,412457,2534,234026,1559,160988,94,17443,1627,41775,2544,193428,1722,235203,California
Santa Barbara,2021-05-15,3567,416024,2596,236622,951,161939,20,17463,1853,41947,1702,195130,1874,237077,California
Santa Barbara,2021-05-16,1156,417180,534,237156,507,162446,115,17578,544,42000,606,195736,659,237736,California
Santa Barbara,2021-05-17,1652,418832,937,238093,651,163097,64,17642,863,42143,783,196519,926,238662,California
Santa Barbara,2021-05-18,1882,420714,1181,239274,603,163700,98,17740,986,42349,879,197398,1085,239747,California
Santa Barbara,2021-05-19,1789,422503,982,240256,766,164466,41,17781,815,42243,962,198360,856,240603,California
Santa Barbara,2021-05-20,1769,424272,965,241221,686,165152,118,17899,885,42377,870,199230,1004,241607,California
Santa Barbara,2021-05-21,3484,427756,2353,243574,1076,166228,55,17954,1261,41487,2207,201437,1317,242924,California
Santa Barbara,2021-05-22,2502,430258,1730,245304,728,166956,44,17998,1407,41851,1090,202527,1454,244378,California
Santa Barbara,2021-05-23,788,431046,351,245655,406,167362,31,18029,425,41946,361,202888,456,244834,California
Santa Barbara,2021-05-24,1028,432074,598,246253,367,167729,63,18092,488,41963,534,203422,551,245385,California
Santa Barbara,2021-05-25,1432,433506,582,246835,782,168511,68,18160,470,41545,956,204378,538,245923,California
Santa Barbara,2021-05-26,3050,436556,1731,248566,1195,169706,124,18284,840,40317,2190,206568,962,246885,California
Santa Barbara,2021-05-27,1981,438537,1215,249781,622,170328,144,18428,832,40153,1141,207709,977,247862,California
Santa Barbara,2021-05-28,1535,440072,708,250489,674,171002,153,18581,623,40021,908,208617,776,248638,California
Santa Barbara,2021-05-29,919,440991,326,250815,556,171558,37,18618,365,39874,549,209166,402,249040,California
Santa Barbara,2021-05-30,519,441510,183,250998,237,171795,99,18717,187,39831,329,209495,286,249326,California
Santa Barbara,2021-05-31,104,441614,49,251047,45,171840,10,18727,25,39788,77,209572,34,249360,California
Santa Barbara,2021-06-01,1150,442764,598,251645,492,172332,60,18787,448,39600,697,210269,509,249869,California
Santa Barbara,2021-06-02,992,443756,588,252233,320,172652,84,18871,428,39551,560,210829,511,250380,California
Santa Barbara,2021-06-03,2081,445837,1558,253791,465,173117,58,18929,627,38789,1445,212274,683,251063,California
Santa Barbara,2021-06-04,1481,447318,679,254470,660,173777,142,19071,492,38440,979,213253,630,251693,California
Santa Barbara,2021-06-05,2940,450258,2232,256702,656,174433,52,19123,488,36539,2440,215693,539,252232,California
Santa Barbara,2021-06-06,926,451184,487,257189,420,174853,19,19142,226,36087,697,216390,245,252477,California
Santa Barbara,2021-06-07,1178,452362,835,258024,291,175144,52,19194,307,35578,868,217258,359,252836,California
Santa Barbara,2021-06-08,1119,453481,716,258740,372,175516,31,19225,292,35080,820,218078,322,253158,California
Santa Barbara,2021-06-09,1038,454519,709,259449,245,175761,84,19309,326,34782,708,218786,410,253568,California
Santa Barbara,2021-06-10,2410,456929,2087,261536,248,176009,75,19384,525,33502,1880,220666,600,254168,California
Santa Barbara,2021-06-11,1329,458258,621,262157,604,176613,104,19488,401,33085,923,221589,506,254674,California
Santa Barbara,2021-06-12,903,459161,605,262762,274,176887,24,19512,238,32692,654,222243,261,254935,California
Santa Barbara,2021-06-13,497,459658,308,263070,92,176979,97,19609,126,32546,369,222612,223,255158,California
Santa Barbara,2021-06-14,1270,460928,863,263933,330,177309,77,19686,339,32039,922,223534,415,255573,California
Santa Barbara,2021-06-15,1170,462098,772,264705,361,177670,37,19723,402,31717,760,224294,438,256011,California
Santa Barbara,2021-06-16,942,463040,656,265361,238,177908,48,19771,358,31543,578,224872,404,256415,California
Santa Barbara,2021-06-17,1895,464935,1561,266922,245,178153,89,19860,625,30991,1264,226136,712,257127,California
Santa Barbara,2021-06-18,1119,466054,722,267644,298,178451,99,19959,364,30702,752,226888,463,257590,California
Santa Barbara,2021-06-19,542,466596,364,268008,146,178597,32,19991,250,30695,289,227177,282,257872,California
Santa Barbara,2021-06-20,371,466967,213,268221,148,178745,10,20001,153,30640,217,227394,162,258034,California
Santa Barbara,2021-06-21,531,467498,267,268488,211,178956,53,20054,274,30716,251,227645,327,258361,California
Santa Barbara,2021-06-22,771,468269,499,268987,241,179197,31,20085,301,30581,466,228111,331,258692,California
Santa Barbara,2021-06-23,787,469056,570,269557,185,179382,32,20117,336,30502,446,228557,367,259059,California
Santa Barbara,2021-06-24,1370,470426,1152,270709,154,179536,64,20181,579,30359,783,229340,640,259699,California
Santa Barbara,2021-06-25,990,471416,634,271343,294,179830,62,20243,461,30355,525,229865,521,260220,California
Santa Barbara,2021-06-26,519,471935,363,271706,125,179955,31,20274,205,30277,314,230179,236,260456,California
Santa Barbara,2021-06-27,405,472340,265,271971,76,180031,64,20338,195,30330,206,230385,259,260715,California
Santa Barbara,2021-06-28,469,472809,304,272275,129,180160,36,20374,237,30370,231,230616,271,260986,California
Santa Barbara,2021-06-29,575,473384,388,272663,172,180332,15,20389,278,30372,290,230906,292,261278,California
Santa Barbara,2021-06-30,667,474051,475,273138,153,180485,39,20428,326,30405,332,231238,365,261643,California
Santa Barbara,2021-07-01,1071,475122,801,273939,121,180606,149,20577,414,30312,655,231893,562,262205,California
Santa Barbara,2021-07-02,791,475913,527,274466,208,180814,56,20633,388,30355,401,232294,444,262649,California
Santa Barbara,2021-07-03,355,476268,222,274688,121,180935,12,20645,153,30322,198,232492,165,262814,California
Santa Barbara,2021-07-04,25,476293,15,274703,10,180945,0,20645,9,30315,16,232508,9,262823,California
Santa Barbara,2021-07-05,496,476789,322,275025,155,181100,19,20664,224,30287,271,232779,243,263066,California
Santa Barbara,2021-07-06,575,477364,403,275428,131,181231,41,20705,206,30171,362,233141,246,263312,California
Santa Barbara,2021-07-07,596,477960,421,275849,129,181360,46,20751,265,30155,329,233470,313,263625,California
Santa Barbara,2021-07-08,998,478958,854,276703,110,181470,34,20785,433,30060,561,234031,466,264091,California
Santa Barbara,2021-07-09,740,479698,510,277213,165,181635,65,20850,293,29980,437,234468,357,264448,California
Santa Barbara,2021-07-10,431,480129,317,277530,88,181723,26,20876,166,29911,261,234729,192,264640,California
Santa Barbara,2021-07-11,236,480365,177,277707,47,181770,12,20888,95,29878,139,234868,106,264746,California
Santa Barbara,2021-07-12,517,480882,316,278023,176,181946,25,20913,213,29812,304,235172,238,264984,California
Santa Barbara,2021-07-13,437,481319,300,278323,129,182075,8,20921,209,29807,222,235394,217,265201,California
Santa Barbara,2021-07-14,535,481854,358,278681,163,182238,14,20935,219,29728,312,235706,233,265434,California
Santa Barbara,2021-07-15,914,482768,767,279448,134,182372,13,20948,373,29578,535,236241,385,265819,California
Santa Barbara,2021-07-16,775,483543,548,279996,194,182566,33,20981,360,29563,405,236646,390,266209,California
Santa Barbara,2021-07-17,419,483962,297,280293,119,182685,3,20984,224,29599,191,236837,227,266436,California
Santa Barbara,2021-07-18,377,484339,288,280581,60,182745,29,21013,206,29666,168,237005,235,266671,California
Santa Barbara,2021-07-19,692,485031,346,280927,210,182955,136,21149,287,29686,403,237408,423,267094,California
Santa Barbara,2021-07-20,667,485698,441,281368,181,183136,45,21194,347,29762,316,237724,392,267486,California
Santa Barbara,2021-07-21,722,486420,561,281929,146,183282,15,21209,401,29864,313,238037,415,267901,California
Santa Barbara,2021-07-22,965,487385,761,282690,162,183444,42,21251,472,29894,483,238520,513,268414,California
Santa Barbara,2021-07-23,966,488351,583,283273,261,183705,122,21373,492,30043,465,238985,614,269028,California
Santa Barbara,2021-07-24,503,488854,372,283645,112,183817,19,21392,291,30147,205,239190,309,269337,California
Santa Barbara,2021-07-25,284,489138,200,283845,78,183895,6,21398,197,30268,82,239272,203,269540,California
Santa Barbara,2021-07-26,684,489822,444,284289,217,184112,23,21421,418,30445,263,239535,440,269980,California
Santa Barbara,2021-07-27,732,490554,445,284734,216,184328,71,21492,426,30639,302,239837,496,270476,California
Santa Barbara,2021-07-28,817,491371,615,285349,173,184501,29,21521,517,30896,289,240126,546,271022,California
Santa Barbara,2021-07-29,998,492369,818,286167,148,184649,32,21553,561,31062,428,240554,594,271616,California
Santa Barbara,2021-07-30,894,493263,574,286741,272,184921,48,21601,507,31236,379,240933,553,272169,California
Santa Barbara,2021-07-31,456,493719,331,287072,116,185037,9,21610,297,31387,155,241088,306,272475,California
Santa Barbara,2021-08-01,481,494200,384,287456,95,185132,2,21612,368,31649,108,241196,370,272845,California
Santa Barbara,2021-08-02,745,494945,482,287938,241,185373,22,21634,484,31901,254,241450,506,273351,California
Santa Barbara,2021-08-03,668,495613,449,288387,196,185569,23,21657,430,32124,230,241680,453,273804,California
Santa Barbara,2021-08-04,797,496410,570,288957,204,185773,23,21680,529,32416,260,241940,552,274356,California
Santa Barbara,2021-08-05,794,497204,586,289543,156,185929,52,21732,494,32672,289,242229,545,274901,California
Santa Barbara,2021-08-06,1057,498261,780,290323,220,186149,57,21789,695,33080,344,242573,752,275653,California
Santa Barbara,2021-08-07,581,498842,434,290757,137,186286,10,21799,391,33294,187,242760,401,276054,California
Santa Barbara,2021-08-08,528,499370,425,291182,89,186375,14,21813,337,33457,187,242947,350,276404,California
Santa Barbara,2021-08-09,788,500158,537,291719,216,186591,35,21848,498,33709,280,243227,532,276936,California
Santa Barbara,2021-08-10,765,500923,557,292276,187,186778,21,21869,469,33910,289,243516,490,277426,California
Santa Barbara,2021-08-11,899,501822,719,292995,161,186939,19,21888,551,34139,341,243857,570,277996,California
Santa Barbara,2021-08-12,825,502647,625,293620,179,187118,21,21909,479,34306,332,244189,499,278495,California
Santa Barbara,2021-08-13,1247,503894,848,294468,329,187447,70,21979,705,34574,507,244696,775,279270,California
Santa Barbara,2021-08-14,771,504665,561,295029,200,187647,10,21989,435,34747,271,244967,444,279714,California
Santa Barbara,2021-08-15,432,505097,318,295347,107,187754,7,21996,234,34844,143,245110,240,279954,California
Santa Barbara,2021-08-16,909,506006,612,295959,275,188029,22,22018,419,34917,366,245476,439,280393,California
Santa Barbara,2021-08-17,846,506852,567,296526,252,188281,27,22045,390,35034,301,245777,418,280811,California
Santa Barbara,2021-08-18,1162,508014,839,297365,268,188549,55,22100,520,35122,487,246264,575,281386,California
Santa Barbara,2021-08-19,989,509003,682,298047,276,188825,31,22131,435,35189,399,246663,466,281852,California
Santa Barbara,2021-08-20,1337,510340,801,298848,480,189305,56,22187,549,35202,591,247254,604,282456,California
Santa Barbara,2021-08-21,643,510983,451,299299,183,189488,9,22196,265,35195,281,247535,274,282730,California
Santa Barbara,2021-08-22,730,511713,562,299861,145,189633,23,22219,301,35159,360,247895,324,283054,California
Santa Barbara,2021-08-23,932,512645,679,300540,229,189862,24,22243,371,35109,444,248339,394,283448,California
Santa Barbara,2021-08-24,909,513554,623,301163,250,190112,36,22279,379,35131,393,248732,415,283863,California
Santa Barbara,2021-08-25,1140,514694,865,302028,235,190347,40,22319,518,35211,478,249210,558,284421,California
Santa Barbara,2021-08-26,1023,515717,773,302801,213,190560,37,22356,478,35324,402,249612,515,284936,California
Santa Barbara,2021-08-27,1626,517343,1106,303907,444,191004,76,22432,593,35240,748,250360,664,285600,California
Santa Barbara,2021-08-28,667,518010,496,304403,161,191165,10,22442,250,35172,328,250688,260,285860,California
Santa Barbara,2021-08-29,568,518578,451,304854,115,191280,2,22444,243,35153,264,250952,245,286105,California
Santa Barbara,2021-08-30,597,519175,414,305268,166,191446,17,22461,198,35057,311,251263,215,286320,California
Santa Clara,2020-12-15,67,67,67,67,0,0,0,0,67,67,0,0,67,67,California
Santa Clara,2020-12-16,167,234,167,234,0,0,0,0,167,234,0,0,167,234,California
Santa Clara,2020-12-17,433,667,433,667,0,0,0,0,433,667,0,0,433,667,California
Santa Clara,2020-12-18,1768,2435,1767,2434,1,1,0,0,1767,2434,0,0,1767,2434,California
Santa Clara,2020-12-19,2122,4557,2122,4556,0,1,0,0,2121,4555,0,0,2121,4555,California
Santa Clara,2020-12-20,1913,6470,1912,6468,1,2,0,0,1910,6465,0,0,1910,6465,California
Santa Clara,2020-12-21,2699,9169,2698,9166,1,3,0,0,2696,9160,1,1,2696,9161,California
Santa Clara,2020-12-22,3179,12348,3170,12336,9,12,0,0,3175,12332,3,4,3175,12336,California
Santa Clara,2020-12-23,3305,15653,3105,15441,200,212,0,0,3302,15633,1,5,3302,15638,California
Santa Clara,2020-12-24,1907,17560,1711,17152,196,408,0,0,1901,17532,2,7,1901,17539,California
Santa Clara,2020-12-25,353,17913,352,17504,1,409,0,0,353,17885,0,7,353,17892,California
Santa Clara,2020-12-26,1276,19189,1036,18540,240,649,0,0,1275,19160,0,7,1275,19167,California
Santa Clara,2020-12-27,663,19852,519,19059,144,793,0,0,663,19823,0,7,663,19830,California
Santa Clara,2020-12-28,2394,22246,1765,20824,629,1422,0,0,2394,22217,0,7,2394,22224,California
Santa Clara,2020-12-29,2423,24669,1546,22370,877,2299,0,0,2423,24640,0,7,2423,24647,California
Santa Clara,2020-12-30,3036,27705,1921,24291,1115,3414,0,0,3033,27670,3,10,3033,27680,California
Santa Clara,2020-12-31,1251,28956,397,24688,854,4268,0,0,1250,28919,1,11,1250,28930,California
Santa Clara,2021-01-01,161,29117,20,24708,141,4409,0,0,159,29076,2,13,159,29089,California
Santa Clara,2021-01-02,1115,30232,833,25541,282,4691,0,0,1115,30191,0,13,1115,30204,California
Santa Clara,2021-01-03,596,30828,376,25917,220,4911,0,0,594,30784,1,14,594,30798,California
Santa Clara,2021-01-04,2504,33332,1686,27603,818,5729,0,0,2501,33285,0,14,2501,33299,California
Santa Clara,2021-01-05,3156,36488,2072,29675,1084,6813,0,0,2956,36048,199,213,2962,36261,California
Santa Clara,2021-01-06,3439,39927,2041,31716,1398,8211,0,0,2791,38199,643,856,2794,39055,California
Santa Clara,2021-01-07,4325,44252,2638,34354,1687,9898,0,0,3202,40298,1112,1968,3211,42266,California
Santa Clara,2021-01-08,5934,50186,3884,38238,2050,11948,0,0,3805,41984,2120,4088,3806,46072,California
Santa Clara,2021-01-09,3074,53260,1944,40182,1130,13078,0,0,1727,42370,1344,5432,1730,47802,California
Santa Clara,2021-01-10,1991,55251,1539,41721,452,13530,0,0,765,41911,1224,6656,765,48567,California
Santa Clara,2021-01-11,6137,61388,3907,45628,2230,15760,0,0,3448,42682,2686,9342,3457,52024,California
Santa Clara,2021-01-12,6957,68345,3539,49167,3418,19178,0,0,4592,44921,2356,11698,4595,56619,California
Santa Clara,2021-01-13,7573,75918,3191,52358,4382,23560,0,0,5276,47909,2289,13987,5277,61896,California
Santa Clara,2021-01-14,8413,84331,2916,55274,5497,29057,0,0,6574,52655,1830,15817,6576,68472,California
Santa Clara,2021-01-15,9606,93937,2761,58035,6845,35902,0,0,8220,59511,1370,17187,8226,76698,California
Santa Clara,2021-01-16,4369,98306,1254,59289,3115,39017,0,0,3528,62202,837,18024,3528,80226,California
Santa Clara,2021-01-17,3255,101561,617,59906,2638,41655,0,0,2747,64444,505,18529,2747,82973,California
Santa Clara,2021-01-18,5167,106728,1193,61099,3974,45629,0,0,4592,68462,575,19104,4593,87566,California
Santa Clara,2021-01-19,8627,115355,2742,63841,5885,51514,0,0,6883,73607,1741,20845,6886,94452,California
Santa Clara,2021-01-20,8501,123856,4472,68313,4029,55543,0,0,6910,78932,1586,22431,6911,101363,California
Santa Clara,2021-01-21,9024,132880,3992,72305,5032,60575,0,0,7723,85363,1294,23725,7725,109088,California
Santa Clara,2021-01-22,8832,141712,3335,75640,5497,66072,0,0,8233,93003,596,24321,8236,117324,California
Santa Clara,2021-01-23,3863,145575,1720,77360,2143,68215,0,0,2874,94890,989,25310,2876,120200,California
Santa Clara,2021-01-24,2889,148464,1443,78803,1446,69661,0,0,2385,96775,500,25810,2385,122585,California
Santa Clara,2021-01-25,8493,156957,3833,82636,4660,74321,0,0,6371,101033,2115,27925,6373,128958,California
Santa Clara,2021-01-26,8497,165454,3881,86517,4616,78937,0,0,6311,105173,2174,30099,6314,135272,California
Santa Clara,2021-01-27,8880,174334,3911,90428,4969,83906,0,0,6919,110152,1942,32041,6921,142193,California
Santa Clara,2021-01-28,9785,184119,3913,94341,5872,89778,0,0,7749,115892,2015,34056,7755,149948,California
Santa Clara,2021-01-29,9719,193838,3997,98338,5722,95500,0,0,7498,121181,2210,36266,7499,157447,California
Santa Clara,2021-01-30,4179,198017,2124,100462,2055,97555,0,0,2930,122872,1240,37506,2931,160378,California
Santa Clara,2021-01-31,2236,200253,1323,101785,913,98468,0,0,1624,123892,604,38110,1624,162002,California
Santa Clara,2021-02-01,7966,208219,3557,105342,4409,102877,0,0,6214,128372,1736,39846,6216,168218,California
Santa Clara,2021-02-02,8805,217024,2941,108283,5864,108741,0,0,6731,133045,2062,41908,6735,174953,California
Santa Clara,2021-02-03,9393,226417,3521,111804,5872,114613,0,0,7036,137738,2349,44257,7042,181995,California
Santa Clara,2021-02-04,11225,237642,4245,116049,6980,121593,0,0,8852,144233,2361,46618,8856,190851,California
Santa Clara,2021-02-05,12175,249817,4394,120443,7781,129374,0,0,8646,149370,3511,50129,8648,199499,California
Santa Clara,2021-02-06,5307,255124,2875,123318,2432,131806,0,0,4097,152266,1203,51332,4099,203598,California
Santa Clara,2021-02-07,3525,258649,2361,125679,1164,132970,0,0,3057,154860,464,51796,3058,206656,California
Santa Clara,2021-02-08,10322,268971,3585,129264,6737,139707,0,0,7498,159550,2810,54606,7500,214156,California
Santa Clara,2021-02-09,11409,280380,3891,133155,7518,147225,0,0,7825,163812,3568,58174,7830,221986,California
Santa Clara,2021-02-10,12934,293314,5032,138187,7902,155127,0,0,6733,164367,6181,64355,6736,228722,California
Santa Clara,2021-02-11,14035,307349,4891,143078,9144,164271,0,0,7883,166120,6132,70487,7885,236607,California
Santa Clara,2021-02-12,14918,322267,4601,147679,10317,174588,0,0,7118,165470,7772,78259,7122,243729,California
Santa Clara,2021-02-13,6244,328511,1519,149198,4725,179313,0,0,2273,163783,3962,82221,2275,246004,California
Santa Clara,2021-02-14,4689,333200,1179,150377,3510,182823,0,0,1501,162107,3183,85404,1507,247511,California
Santa Clara,2021-02-15,6418,339618,2847,153224,3571,186394,0,0,2782,161267,3625,89029,2785,250296,California
Santa Clara,2021-02-16,14155,353773,4128,157352,10027,196421,0,0,7088,161312,7045,96074,7090,257386,California
Santa Clara,2021-02-17,14378,368151,5618,162970,8760,205181,0,0,7172,161311,7179,103253,7178,264564,California
Santa Clara,2021-02-18,14638,382789,8624,171594,6014,211195,0,0,7434,161599,7150,110403,7438,272002,California
Santa Clara,2021-02-19,15230,398019,9767,181361,5463,216658,0,0,8863,164129,6340,116743,8870,280872,California
Santa Clara,2021-02-20,7158,405177,5377,186738,1781,218439,0,0,3847,164684,3294,120037,3849,284721,California
Santa Clara,2021-02-21,3487,408664,2571,189309,916,219355,0,0,1301,163821,2166,122203,1303,286024,California
Santa Clara,2021-02-22,11122,419786,6649,195958,4473,223828,0,0,5165,163069,5919,128122,5167,291191,California
Santa Clara,2021-02-23,13309,433095,8653,204611,4656,228484,0,0,7584,164963,5697,133819,7591,298782,California
Santa Clara,2021-02-24,15630,448725,10076,214687,5554,234038,0,0,9590,168548,6006,139825,9591,308373,California
Santa Clara,2021-02-25,16344,465069,10428,225115,5916,239954,0,0,8841,169941,7457,147282,8850,317223,California
Santa Clara,2021-02-26,15911,480980,9163,234278,6748,246702,0,0,8632,171353,7228,154510,8640,325863,California
Santa Clara,2021-02-27,8812,489792,6154,240432,2657,249359,1,1,4907,172401,3868,158378,4916,330779,California
Santa Clara,2021-02-28,5749,495541,3917,244349,1831,251190,1,2,2789,172266,2926,161304,2791,333570,California
Santa Clara,2021-03-01,15618,511159,8916,253265,6691,257881,11,13,9681,176058,5902,167206,9694,343264,California
Santa Clara,2021-03-02,18795,529954,10966,264231,7827,265708,2,15,11996,181288,6768,173974,11998,355262,California
Santa Clara,2021-03-03,20713,550667,10374,274605,10332,276040,7,22,12802,186232,7868,181842,12812,368074,California
Santa Clara,2021-03-04,20322,570989,11273,285878,9046,285086,3,25,11616,189252,8603,190445,11623,379697,California
Santa Clara,2021-03-05,18518,589507,10226,296104,8163,293249,129,154,9982,190870,8499,198944,10117,389814,California
Santa Clara,2021-03-06,9697,599204,6444,302548,2800,296049,453,607,7249,196136,2429,201373,7695,397509,California
Santa Clara,2021-03-07,7260,606464,4612,307160,2264,298313,384,991,5682,200625,1563,202936,6052,403561,California
Santa Clara,2021-03-08,13362,619826,6873,314033,5880,304193,609,1600,8474,204827,4868,207804,9070,412631,California
Santa Clara,2021-03-09,15657,635483,6698,320731,7602,311795,1357,2957,6954,204430,8677,216481,8280,420911,California
Santa Clara,2021-03-10,16354,651837,7330,328061,6849,318644,2175,5132,6597,203438,9706,226187,8714,429625,California
Santa Clara,2021-03-11,17517,669354,7937,335998,8061,326705,1519,6651,6104,199659,11367,237554,7588,437213,California
Santa Clara,2021-03-12,18205,687559,9294,345292,7327,334032,1584,8235,6052,195153,12101,249655,7595,444808,California
Santa Clara,2021-03-13,11089,698648,6379,351671,3108,337140,1602,9837,4887,195381,6173,255828,6401,451209,California
Santa Clara,2021-03-14,6609,705257,3437,355108,1868,339008,1304,11141,3221,196496,3369,259197,4484,455693,California
Santa Clara,2021-03-15,13080,718337,6656,361764,6116,345124,308,11449,5940,195641,7102,266299,6247,461940,California
Santa Clara,2021-03-16,18636,736973,10538,372302,7885,353009,213,11662,8606,194466,9988,276287,8813,470753,California
Santa Clara,2021-03-17,20576,757549,11635,383937,8764,361773,177,11839,10260,194639,10247,286534,10420,481173,California
Santa Clara,2021-03-18,19686,777235,9251,393188,9250,371023,1185,13024,8953,194087,10665,297199,10113,491286,California
Santa Clara,2021-03-19,19929,797164,10279,403467,8629,379652,1021,14045,9973,195199,9862,307061,10974,502260,California
Santa Clara,2021-03-20,11999,809163,6757,410224,4372,384024,870,14915,6696,197509,5241,312302,7551,509811,California
Santa Clara,2021-03-21,8533,817696,3927,414151,3194,387218,1412,16327,5456,201283,3055,315357,6829,516640,California
Santa Clara,2021-03-22,16891,834587,9439,423590,7091,394309,361,16688,9084,202959,7760,323117,9436,526076,California
Santa Clara,2021-03-23,19909,854496,12649,436239,6722,401031,538,17226,10605,204850,9241,332358,11132,537208,California
Santa Clara,2021-03-24,23263,877759,14939,451178,7900,408931,424,17650,14232,210519,8976,341334,14645,551853,California
Santa Clara,2021-03-25,23513,901272,13481,464659,9071,418002,961,18611,14008,216035,9423,350757,14939,566792,California
Santa Clara,2021-03-26,22567,923839,14297,478956,7867,425869,403,19014,13162,220232,9351,360108,13548,580340,California
Santa Clara,2021-03-27,16014,939853,10593,489549,4635,430504,786,19800,8294,221647,7657,367765,9072,589412,California
Santa Clara,2021-03-28,12449,952302,8674,498223,3061,433565,714,20514,6559,223049,5859,373624,7261,596673,California
Santa Clara,2021-03-29,21231,973533,13036,511259,7461,441026,734,21248,11137,224870,10035,383659,11856,608529,California
Santa Clara,2021-03-30,26287,999820,15596,526855,8725,449751,1966,23214,16090,232748,10138,393797,18016,626545,California
Santa Clara,2021-03-31,20979,1020799,12139,538994,7689,457440,1151,24365,12633,238229,8282,402079,13763,640308,California
Santa Clara,2021-04-01,32436,1053235,20109,559103,9175,466615,3152,27517,19984,248896,12352,414431,23019,663327,California
Santa Clara,2021-04-02,25857,1079092,14677,573780,8975,475590,2205,29722,16447,258137,9348,423779,18589,681916,California
Santa Clara,2021-04-03,15555,1094647,9450,583230,3590,479180,2515,32237,8651,262374,6872,430651,11109,693025,California
Santa Clara,2021-04-04,7788,1102435,4124,587354,2483,481663,1181,33418,4023,263793,3750,434401,5169,698194,California
Santa Clara,2021-04-05,22423,1124858,14866,602220,5002,486665,2555,35973,14562,273037,7818,442219,17062,715256,California
Santa Clara,2021-04-06,30081,1154939,16616,618836,7909,494574,5556,41529,18043,284549,11970,454189,23482,738738,California
Santa Clara,2021-04-07,31518,1186457,16242,635078,8678,503252,6598,48127,19203,297989,12235,466424,25675,764413,California
Santa Clara,2021-04-08,30554,1217011,16704,651782,6112,509364,7738,55865,16666,308461,13795,480219,24267,788680,California
Santa Clara,2021-04-09,28643,1245654,14167,665949,7092,516456,7384,63249,14639,316444,13919,494138,21902,810582,California
Santa Clara,2021-04-10,21873,1267527,12634,678583,3808,520264,5431,68680,11670,323298,10149,504287,17003,827585,California
Santa Clara,2021-04-11,16250,1283777,9749,688332,2709,522973,3792,72472,8425,327669,7780,512067,12151,839736,California
Santa Clara,2021-04-12,27545,1311322,19290,707622,5670,528643,2585,75057,18629,340011,8839,520906,21181,860917,California
Santa Clara,2021-04-13,35024,1346346,27459,735081,7540,536183,25,75082,26836,358804,8099,529005,26892,887809,California
Santa Clara,2021-04-14,37923,1384269,28749,763830,9170,545353,4,75086,26814,374638,11026,540031,26860,914669,California
Santa Clara,2021-04-15,45086,1429355,34823,798653,10252,555605,11,75097,34505,398729,10455,550486,34546,949215,California
Santa Clara,2021-04-16,39380,1468735,26844,825497,12532,568137,4,75101,28000,415485,11281,561767,28037,977252,California
Santa Clara,2021-04-17,22467,1491202,15343,840840,7122,575259,2,75103,15424,423963,6969,568736,15447,992699,California
Santa Clara,2021-04-18,17129,1508331,11255,852095,5874,581133,0,75103,10525,427943,6561,575297,10541,1003240,California
Santa Clara,2021-04-19,29476,1537807,21245,873340,8229,589362,2,75105,17432,433461,11952,587249,17470,1020710,California
Santa Clara,2021-04-20,38660,1576467,23741,897081,14916,604278,3,75108,23353,441699,15163,602412,23401,1044111,California
Santa Clara,2021-04-21,38879,1615346,22909,919990,15964,620242,6,75114,25382,453777,13358,615770,25436,1069547,California
Santa Clara,2021-04-22,38708,1654054,25883,945873,12822,633064,3,75117,18116,451518,20460,636230,18201,1087748,California
Santa Clara,2021-04-23,33603,1687657,20597,966470,13005,646069,1,75118,15622,449349,17855,654085,15686,1103434,California
Santa Clara,2021-04-24,21761,1709418,15845,982315,5915,651984,1,75119,12304,452330,9355,663440,12336,1115770,California
Santa Clara,2021-04-25,13884,1723302,10036,992351,3841,655825,7,75126,8809,456152,5023,668463,8845,1124615,California
Santa Clara,2021-04-26,26052,1749354,20098,1012449,5890,661715,64,75190,10815,451952,15109,683572,10909,1135524,California
Santa Clara,2021-04-27,28516,1777870,20314,1032763,7808,669523,394,75584,12415,448825,15995,699567,12868,1148392,California
Santa Clara,2021-04-28,27190,1805060,20189,1052952,6545,676068,456,76040,11487,445253,15590,715157,12018,1160410,California
Santa Clara,2021-04-29,25087,1830147,18415,1071367,6255,682323,417,76457,9388,439543,15602,730759,9892,1170302,California
Santa Clara,2021-04-30,24320,1854467,16757,1088124,7183,689506,380,76837,10334,436473,13877,744636,10807,1181109,California
Santa Clara,2021-05-01,17967,1872434,14868,1102992,2827,692333,272,77109,5621,430145,12268,756904,5940,1187049,California
Santa Clara,2021-05-02,11540,1883974,9574,1112566,1728,694061,238,77347,3545,426002,7941,764845,3798,1190847,California
Santa Clara,2021-05-03,23531,1907505,19927,1132493,3158,697219,446,77793,5238,413534,18197,783042,5729,1196576,California
Santa Clara,2021-05-04,31644,1939149,24771,1157264,6316,703535,557,78350,5587,393811,25924,808966,6201,1202777,California
Santa Clara,2021-05-05,33253,1972402,25281,1182545,7416,710951,556,78906,5239,371753,27881,836847,5823,1208600,California
Santa Clara,2021-05-06,36485,2008887,30449,1212994,5556,716507,480,79386,4745,345416,31589,868436,5252,1213852,California
Santa Clara,2021-05-07,33444,2042331,26874,1239868,6071,722578,499,79885,4715,322120,28563,896999,5267,1219119,California
Santa Clara,2021-05-08,17702,2060033,14533,1254401,2729,725307,440,80325,3674,312339,13915,910914,4134,1223253,California
Santa Clara,2021-05-09,10871,2070904,9485,1263886,1197,726504,189,80514,2362,306439,8465,919379,2565,1225818,California
Santa Clara,2021-05-10,21593,2092497,17344,1281230,3834,730338,415,80929,2640,290666,18847,938226,3074,1228892,California
Santa Clara,2021-05-11,23421,2115918,17730,1298960,5236,735574,455,81384,4048,275914,19260,957486,4508,1233400,California
Santa Clara,2021-05-12,21930,2137848,16126,1315086,5265,740839,539,81923,4231,263105,17582,975068,4773,1238173,California
Santa Clara,2021-05-13,28779,2166627,23323,1338409,5147,745986,309,82232,11376,257507,17295,992363,11697,1249870,California
Santa Clara,2021-05-14,28418,2195045,19822,1358231,8207,754193,389,82621,9701,249019,18593,1010956,10105,1259975,California
Santa Clara,2021-05-15,21384,2216429,17134,1375365,3965,758158,285,82906,8195,244418,13090,1024046,8489,1268464,California
Santa Clara,2021-05-16,16670,2233099,13626,1388991,2864,761022,180,83086,5419,238856,11162,1035208,5600,1274064,California
Santa Clara,2021-05-17,20757,2253856,16315,1405306,4075,765097,367,83453,6879,232320,13784,1048992,7248,1281312,California
Santa Clara,2021-05-18,26627,2280483,16963,1422269,9245,774342,419,83872,7180,220633,19290,1068282,7603,1288915,California
Santa Clara,2021-05-19,25011,2305494,14576,1436845,10008,784350,427,84299,7295,210774,17588,1085870,7729,1296644,California
Santa Clara,2021-05-20,19004,2324498,12519,1449364,6027,790377,458,84757,6208,204748,12687,1098557,6661,1303305,California
Santa Clara,2021-05-21,22774,2347272,15097,1464461,7157,797534,520,85277,7438,197510,15211,1113768,7973,1311278,California
Santa Clara,2021-05-22,13183,2360455,9974,1474435,2851,800385,358,85635,5714,196196,7391,1121159,6077,1317355,California
Santa Clara,2021-05-23,8475,2368930,6309,1480744,1964,802349,202,85837,3361,194693,5070,1126229,3567,1320922,California
Santa Clara,2021-05-24,11127,2380057,8029,1488773,2634,804983,464,86301,3781,191675,7264,1133493,4246,1325168,California
Santa Clara,2021-05-25,11766,2391823,8135,1496908,3206,808189,425,86726,4452,189326,7224,1140717,4875,1330043,California
Santa Clara,2021-05-26,10696,2402519,6907,1503815,3447,811636,342,87068,4026,187140,6546,1147263,4360,1334403,California
Santa Clara,2021-05-27,9533,2412052,6102,1509917,2978,814614,453,87521,3538,185206,5917,1153180,3983,1338386,California
Santa Clara,2021-05-28,11195,2423247,7231,1517148,3508,818122,456,87977,4553,183658,6559,1159739,5011,1343397,California
Santa Clara,2021-05-29,6481,2429728,4400,1521548,1798,819920,283,88260,2748,183013,3672,1163411,3027,1346424,California
Santa Clara,2021-05-30,3959,2433687,2986,1524534,760,820680,213,88473,1853,183013,2065,1165476,2065,1348489,California
Santa Clara,2021-05-31,1123,2434810,642,1525176,371,821051,110,88583,444,182904,662,1166138,553,1349042,California
Santa Clara,2021-06-01,9236,2444046,6468,1531644,2383,823434,385,88968,3020,180171,6133,1172271,3400,1352442,California
Santa Clara,2021-06-02,7867,2451913,5634,1537278,1871,825305,362,89330,2956,178631,4847,1177118,3307,1355749,California
Santa Clara,2021-06-03,12424,2464337,10285,1547563,1789,827094,350,89680,2646,171929,9701,1186819,2999,1358748,California
Santa Clara,2021-06-04,13926,2478263,11646,1559209,1960,829054,320,90000,3376,165168,10453,1197272,3692,1362440,California
Santa Clara,2021-06-05,10659,2488922,9149,1568358,1250,830304,260,90260,2202,159230,8398,1205670,2460,1364900,California
Santa Clara,2021-06-06,7009,2495931,6246,1574604,605,830909,158,90418,1322,155079,5629,1211299,1478,1366378,California
Santa Clara,2021-06-07,10142,2506073,8550,1583154,1340,832249,252,90670,2376,149987,7716,1219015,2624,1369002,California
Santa Clara,2021-06-08,9315,2515388,7602,1590756,1439,833688,274,90944,2477,145968,6768,1225783,2749,1371751,California
Santa Clara,2021-06-09,9665,2525053,8045,1598801,1363,835051,257,91201,2289,141201,7307,1233090,2540,1374291,California
Santa Clara,2021-06-10,8462,2533515,7010,1605811,1119,836170,333,91534,2180,137493,6217,1239307,2509,1376800,California
Santa Clara,2021-06-11,10379,2543894,8795,1614606,1296,837466,288,91822,2531,132523,7789,1247096,2819,1379619,California
Santa Clara,2021-06-12,7330,2551224,6096,1620702,1063,838529,171,91993,1702,128822,5575,1252671,1874,1381493,California
Santa Clara,2021-06-13,3769,2554993,3042,1623744,609,839138,118,92111,870,126937,2873,1255544,988,1382481,California
Santa Clara,2021-06-14,6116,2561109,4931,1628675,938,840076,247,92358,1983,125076,4088,1259632,2227,1384708,California
Santa Clara,2021-06-15,7572,2568681,6131,1634806,1130,841206,311,92669,2129,122145,5371,1265003,2440,1387148,California
Santa Clara,2021-06-16,6546,2575227,5300,1640106,932,842138,314,92983,2132,120239,4351,1269354,2445,1389593,California
Santa Clara,2021-06-17,5487,2580714,4448,1644554,794,842932,245,93228,1908,118886,3502,1272856,2149,1391742,California
Santa Clara,2021-06-18,5536,2586250,4466,1649020,896,843828,174,93402,1820,117252,3628,1276484,1994,1393736,California
Santa Clara,2021-06-19,4583,2590833,3665,1652685,713,844541,205,93607,1290,115502,3243,1279727,1493,1395229,California
Santa Clara,2021-06-20,2176,2593009,1786,1654471,326,844867,64,93671,677,114768,1475,1281202,741,1395970,California
Santa Clara,2021-06-21,3750,2596759,2818,1657289,700,845567,232,93903,1817,114922,1892,1283094,2046,1398016,California
Santa Clara,2021-06-22,5159,2601918,4112,1661401,817,846384,230,94133,1715,113465,3399,1286493,1942,1399958,California
Santa Clara,2021-06-23,4541,2606459,3565,1664966,772,847156,204,94337,1617,112406,2880,1289373,1821,1401779,California
Santa Clara,2021-06-24,4428,2610887,3427,1668393,797,847953,204,94541,1627,111495,2741,1292114,1830,1403609,California
Santa Clara,2021-06-25,5643,2616530,4601,1672994,823,848776,219,94760,1922,109973,3658,1295772,2136,1405745,California
Santa Clara,2021-06-26,3724,2620254,2967,1675961,614,849390,143,94903,1348,109128,2336,1298108,1491,1407236,California
Santa Clara,2021-06-27,2005,2622259,1559,1677520,358,849748,88,94991,683,108592,1306,1299414,770,1408006,California
Santa Clara,2021-06-28,4161,2626420,3511,1681031,417,850165,233,95224,1585,107869,2539,1301953,1816,1409822,California
Santa Clara,2021-06-29,4241,2630661,3305,1684336,752,850917,184,95408,1636,107128,2561,1304514,1820,1411642,California
Santa Clara,2021-06-30,3791,2634452,2970,1687306,645,851562,176,95584,1448,106443,2310,1306824,1625,1413267,California
Santa Clara,2021-07-01,3641,2638093,2887,1690193,558,852120,196,95780,1385,105798,2224,1309048,1579,1414846,California
Santa Clara,2021-07-02,4241,2642334,3420,1693613,655,852775,166,95946,1643,105057,2551,1311599,1810,1416656,California
Santa Clara,2021-07-03,2456,2644790,1917,1695530,428,853203,111,96057,1013,104766,1414,1313013,1123,1417779,California
Santa Clara,2021-07-04,146,2644936,108,1695638,24,853227,14,96071,75,104787,68,1313081,89,1417868,California
Santa Clara,2021-07-05,2414,2647350,1984,1697622,304,853531,126,96197,966,104461,1417,1314498,1091,1418959,California
Santa Clara,2021-07-06,4301,2651651,3336,1700958,800,854331,165,96362,1450,103263,2809,1317307,1611,1420570,California
Santa Clara,2021-07-07,3746,2655397,2920,1703878,655,854986,171,96533,1302,102324,2409,1319716,1470,1422040,California
Santa Clara,2021-07-08,3085,2658482,2376,1706254,559,855545,150,96683,1179,101777,1870,1321586,1323,1423363,California
Santa Clara,2021-07-09,3414,2661896,2680,1708934,617,856162,117,96800,1393,101290,1991,1323577,1504,1424867,California
Santa Clara,2021-07-10,2577,2664473,1960,1710894,470,856632,147,96947,975,100839,1574,1325151,1123,1425990,California
Santa Clara,2021-07-11,1305,2665778,1002,1711896,273,856905,30,96977,543,100659,753,1325904,573,1426563,California
Santa Clara,2021-07-12,3329,2669107,2610,1714506,549,857454,170,97147,1244,100024,2052,1327956,1417,1427980,California
Santa Clara,2021-07-13,3005,2672112,2338,1716844,528,857982,139,97286,1182,99551,1791,1329747,1318,1429298,California
Santa Clara,2021-07-14,2803,2674915,2242,1719086,431,858413,130,97416,1129,99157,1649,1331396,1255,1430553,California
Santa Clara,2021-07-15,2756,2677671,2209,1721295,427,858840,120,97536,1189,98927,1535,1332931,1305,1431858,California
Santa Clara,2021-07-16,3306,2680977,2623,1723918,564,859404,119,97655,1432,98633,1847,1334778,1553,1433411,California
Santa Clara,2021-07-17,2574,2683551,2046,1725964,409,859813,119,97774,1049,98314,1484,1336262,1165,1434576,California
Santa Clara,2021-07-18,1220,2684771,954,1726918,218,860031,48,97822,508,98181,688,1336950,555,1435131,California
Santa Clara,2021-07-19,2946,2687717,2306,1729224,503,860534,137,97959,1278,97958,1638,1338588,1415,1436546,California
Santa Clara,2021-07-20,3181,2690898,2494,1731718,546,861080,141,98100,1438,97823,1715,1340303,1580,1438126,California
Santa Clara,2021-07-21,2994,2693892,2382,1734100,502,861582,110,98210,1382,97735,1582,1341885,1494,1439620,California
Santa Clara,2021-07-22,2750,2696642,2118,1736218,522,862104,110,98320,1314,97755,1408,1343293,1428,1441048,California
Santa Clara,2021-07-23,3373,2700015,2621,1738839,655,862759,97,98417,1683,97899,1635,1344928,1779,1442827,California
Santa Clara,2021-07-24,2329,2702344,1801,1740640,430,863189,98,98515,1079,97870,1206,1346134,1177,1444004,California
Santa Clara,2021-07-25,1092,2703436,881,1741521,180,863369,31,98546,706,98233,373,1346507,736,1444740,California
Santa Clara,2021-07-26,2652,2706088,2132,1743653,398,863767,122,98668,1483,98701,1129,1347636,1597,1446337,California
Santa Clara,2021-07-27,3315,2709403,2515,1746168,646,864413,154,98822,1650,98884,1619,1349255,1802,1448139,California
Santa Clara,2021-07-28,2860,2712263,2180,1748348,556,864969,124,98946,1490,99159,1340,1350595,1615,1449754,California
Santa Clara,2021-07-29,2733,2714996,2127,1750475,460,865429,146,99092,1465,99541,1228,1351823,1610,1451364,California
Santa Clara,2021-07-30,3287,2718283,2556,1753031,577,866006,154,99246,1701,99874,1520,1353343,1853,1453217,California
Santa Clara,2021-07-31,2579,2720862,1938,1754969,496,866502,145,99391,1343,100175,1185,1354528,1486,1454703,California
Santa Clara,2021-08-01,1135,2721997,962,1755931,130,866632,43,99434,629,100357,490,1355018,672,1455375,California
Santa Clara,2021-08-02,3011,2725008,2497,1758428,378,867010,136,99570,1667,100860,1299,1356317,1802,1457177,California
Santa Clara,2021-08-03,3425,2728433,2647,1761075,586,867596,192,99762,1923,101519,1450,1357767,2109,1459286,California
Santa Clara,2021-08-04,3045,2731478,2368,1763443,529,868125,148,99910,1669,101995,1340,1359107,1816,1461102,California
Santa Clara,2021-08-05,2995,2734473,2336,1765779,476,868601,183,100093,1671,102567,1279,1360386,1851,1462953,California
Santa Clara,2021-08-06,3650,2738123,2853,1768632,633,869234,164,100257,2053,103236,1547,1361933,2216,1465169,California
Santa Clara,2021-08-07,2376,2740499,1894,1770526,388,869622,94,100351,1314,103612,1032,1362965,1408,1466577,California
Santa Clara,2021-08-08,1411,2741910,1150,1771676,195,869817,66,100417,808,103910,575,1363540,873,1467450,California
Santa Clara,2021-08-09,3197,2745107,2667,1774343,378,870195,152,100569,1875,104655,1280,1364820,2025,1469475,California
Santa Clara,2021-08-10,3424,2748531,2656,1776999,598,870793,170,100739,1808,105069,1564,1366384,1978,1471453,California
Santa Clara,2021-08-11,2932,2751463,2309,1779308,492,871285,131,100870,1561,105437,1323,1367707,1691,1473144,California
Santa Clara,2021-08-12,2835,2754298,2154,1781462,523,871808,158,101028,1514,105844,1262,1368969,1669,1474813,California
Santa Clara,2021-08-13,3662,2757960,2753,1784215,732,872540,177,101205,1795,106071,1745,1370714,1972,1476785,California
Santa Clara,2021-08-14,2594,2760554,1895,1786110,611,873151,88,101293,1232,106287,1105,1371819,1321,1478106,California
Santa Clara,2021-08-15,1427,2761981,1120,1787230,243,873394,64,101357,662,106422,593,1372412,728,1478834,California
Santa Clara,2021-08-16,3482,2765463,2567,1789797,759,874153,156,101513,1582,106696,1462,1373874,1736,1480570,California
Santa Clara,2021-08-17,3776,2769239,2605,1792402,954,875107,217,101730,1572,106788,1695,1375569,1787,1482357,California
Santa Clara,2021-08-18,3342,2772581,2345,1794747,829,875936,168,101898,1424,106955,1426,1376995,1593,1483950,California
Santa Clara,2021-08-19,3212,2775793,2141,1796888,921,876857,150,102048,1315,107125,1296,1378291,1466,1485416,California
Santa Clara,2021-08-20,4429,2780222,3046,1799934,1192,878049,191,102239,1606,107044,1875,1380166,1794,1487210,California
Santa Clara,2021-08-21,2903,2783125,2055,1801989,706,878755,142,102381,1032,106884,1335,1381501,1175,1488385,California
Santa Clara,2021-08-22,1488,2784613,1093,1803082,353,879108,42,102423,595,106871,649,1382150,636,1489021,California
Santa Clara,2021-08-23,3538,2788151,2630,1805712,810,879918,98,102521,1334,106747,1558,1383708,1434,1490455,California
Santa Clara,2021-08-24,3916,2792067,2848,1808560,919,880837,149,102670,1403,106562,1734,1385442,1549,1492004,California
Santa Clara,2021-08-25,3710,2795777,2703,1811263,869,881706,138,102808,1439,106526,1624,1387066,1588,1493592,California
Santa Clara,2021-08-26,3450,2799227,2468,1813731,841,882547,141,102949,1178,106237,1605,1388671,1316,1494908,California
Santa Clara,2021-08-27,4083,2803310,2996,1816727,983,883530,104,103053,1421,105821,1941,1390612,1525,1496433,California
Santa Clara,2021-08-28,2815,2806125,2054,1818781,676,884206,85,103138,997,105518,1383,1391995,1080,1497513,California
Santa Clara,2021-08-29,1501,2807626,1155,1819936,313,884519,33,103171,557,105401,707,1392702,590,1498103,California
Santa Clara,2021-08-30,2445,2810071,1637,1821573,717,885236,91,103262,710,105034,1162,1393864,795,1498898,California
Santa Cruz,2020-12-15,2,2,2,2,0,0,0,0,2,2,0,0,2,2,California
Santa Cruz,2020-12-16,55,57,55,57,0,0,0,0,55,57,0,0,55,57,California
Santa Cruz,2020-12-17,383,440,383,440,0,0,0,0,383,440,0,0,383,440,California
Santa Cruz,2020-12-18,442,882,442,882,0,0,0,0,442,882,0,0,442,882,California
Santa Cruz,2020-12-19,169,1051,168,1050,1,1,0,0,169,1051,0,0,169,1051,California
Santa Cruz,2020-12-20,88,1139,88,1138,0,1,0,0,88,1139,0,0,88,1139,California
Santa Cruz,2020-12-21,432,1571,431,1569,1,2,0,0,432,1571,0,0,432,1571,California
Santa Cruz,2020-12-22,402,1973,401,1970,1,3,0,0,402,1973,0,0,402,1973,California
Santa Cruz,2020-12-23,354,2327,315,2285,39,42,0,0,353,2326,0,0,353,2326,California
Santa Cruz,2020-12-24,116,2443,44,2329,72,114,0,0,116,2442,0,0,116,2442,California
Santa Cruz,2020-12-25,8,2451,8,2337,0,114,0,0,8,2450,0,0,8,2450,California
Santa Cruz,2020-12-26,60,2511,43,2380,17,131,0,0,60,2510,0,0,60,2510,California
Santa Cruz,2020-12-27,31,2542,26,2406,5,136,0,0,31,2541,0,0,31,2541,California
Santa Cruz,2020-12-28,459,3001,101,2507,358,494,0,0,459,3000,0,0,459,3000,California
Santa Cruz,2020-12-29,767,3768,357,2864,410,904,0,0,767,3767,0,0,767,3767,California
Santa Cruz,2020-12-30,335,4103,159,3023,176,1080,0,0,335,4102,0,0,335,4102,California
Santa Cruz,2020-12-31,304,4407,8,3031,296,1376,0,0,304,4406,0,0,304,4406,California
Santa Cruz,2021-01-01,34,4441,2,3033,32,1408,0,0,34,4440,0,0,34,4440,California
Santa Cruz,2021-01-02,63,4504,50,3083,13,1421,0,0,63,4503,0,0,63,4503,California
Santa Cruz,2021-01-03,15,4519,7,3090,8,1429,0,0,15,4518,0,0,15,4518,California
Santa Cruz,2021-01-04,276,4795,122,3212,154,1583,0,0,274,4792,0,0,274,4792,California
Santa Cruz,2021-01-05,549,5344,423,3635,126,1709,0,0,251,4745,298,298,251,5043,California
Santa Cruz,2021-01-06,780,6124,650,4285,130,1839,0,0,452,4870,327,625,452,5495,California
Santa Cruz,2021-01-07,512,6636,196,4481,316,2155,0,0,365,5089,147,772,366,5861,California
Santa Cruz,2021-01-08,891,7527,536,5017,355,2510,0,0,466,5131,425,1197,467,6328,California
Santa Cruz,2021-01-09,440,7967,115,5132,325,2835,0,0,390,5471,50,1247,390,6718,California
Santa Cruz,2021-01-10,72,8039,62,5194,10,2845,0,0,20,5439,52,1299,20,6738,California
Santa Cruz,2021-01-11,700,8739,578,5772,122,2967,0,0,176,5092,524,1823,177,6915,California
Santa Cruz,2021-01-12,705,9444,513,6285,192,3159,0,0,470,5327,235,2058,470,7385,California
Santa Cruz,2021-01-13,493,9937,233,6518,260,3419,0,0,403,5643,87,2145,403,7788,California
Santa Cruz,2021-01-14,508,10445,100,6618,408,3827,0,0,446,6028,61,2206,446,8234,California
Santa Cruz,2021-01-15,1401,11846,74,6692,1327,5154,0,0,1338,7305,63,2269,1340,9574,California
Santa Cruz,2021-01-16,399,12245,42,6734,357,5511,0,0,384,7674,15,2284,384,9958,California
Santa Cruz,2021-01-17,288,12533,41,6775,247,5758,0,0,262,7910,26,2310,262,10220,California
Santa Cruz,2021-01-18,964,13497,91,6866,873,6631,0,0,908,8762,56,2366,908,11128,California
Santa Cruz,2021-01-19,1575,15072,503,7369,1072,7703,0,0,1237,9664,336,2702,1238,12366,California
Santa Cruz,2021-01-20,1254,16326,170,7539,1084,8787,0,0,1062,10537,189,2891,1062,13428,California
Santa Cruz,2021-01-21,1722,18048,216,7755,1506,10293,0,0,1620,12057,102,2993,1622,15050,California
Santa Cruz,2021-01-22,1802,19850,509,8264,1293,11586,0,0,1700,13660,98,3091,1701,16751,California
Santa Cruz,2021-01-23,565,20415,137,8401,428,12014,0,0,509,14114,55,3146,509,17260,California
Santa Cruz,2021-01-24,241,20656,16,8417,225,12239,0,0,224,14321,17,3163,224,17484,California
Santa Cruz,2021-01-25,1008,21664,354,8771,654,12893,0,0,517,14347,491,3654,517,18001,California
Santa Cruz,2021-01-26,1619,23283,245,9016,1374,14267,0,0,1127,14982,492,4146,1127,19128,California
Santa Cruz,2021-01-27,1808,25091,426,9442,1382,15649,0,0,1432,16041,374,4520,1433,20561,California
Santa Cruz,2021-01-28,1990,27081,278,9720,1712,17361,0,0,1668,17388,322,4842,1669,22230,California
Santa Cruz,2021-01-29,2083,29164,483,10203,1600,18961,0,0,1955,19217,126,4968,1955,24185,California
Santa Cruz,2021-01-30,1656,30820,310,10513,1346,20307,0,0,1519,20599,137,5105,1519,25704,California
Santa Cruz,2021-01-31,808,31628,110,10623,698,21005,0,0,795,21381,13,5118,795,26499,California
Santa Cruz,2021-02-01,1177,32805,721,11344,456,21461,0,0,783,21770,394,5512,783,27282,California
Santa Cruz,2021-02-02,973,33778,118,11462,855,22316,0,0,827,22452,145,5657,827,28109,California
Santa Cruz,2021-02-03,2132,35910,896,12358,1236,23552,0,0,1825,23974,303,5960,1825,29934,California
Santa Cruz,2021-02-04,1782,37692,711,13069,1071,24623,0,0,1444,25081,337,6297,1444,31378,California
Santa Cruz,2021-02-05,3050,40742,724,13793,2326,26949,0,0,2749,27530,300,6597,2749,34127,California
Santa Cruz,2021-02-06,2496,43238,134,13927,2362,29311,0,0,2165,29364,331,6928,2165,36292,California
Santa Cruz,2021-02-07,883,44121,120,14047,763,30074,0,0,865,30211,18,6946,865,37157,California
Santa Cruz,2021-02-08,653,44774,180,14227,473,30547,0,0,471,30503,179,7125,471,37628,California
Santa Cruz,2021-02-09,2306,47080,1021,15248,1285,31832,0,0,2055,32307,251,7376,2055,39683,California
Santa Cruz,2021-02-10,2082,49162,539,15787,1543,33375,0,0,1419,33076,652,8028,1421,41104,California
Santa Cruz,2021-02-11,1754,50916,283,16070,1471,34846,0,0,1251,33824,503,8531,1251,42355,California
Santa Cruz,2021-02-12,3084,54000,409,16479,2675,37521,0,0,1719,34188,1357,9888,1721,44076,California
Santa Cruz,2021-02-13,1683,55683,117,16596,1566,39087,0,0,1289,35084,393,10281,1289,45365,California
Santa Cruz,2021-02-14,1404,57087,64,16660,1340,40427,0,0,1150,35980,254,10535,1150,46515,California
Santa Cruz,2021-02-15,1514,58601,270,16930,1244,41671,0,0,521,35510,993,11528,523,47038,California
Santa Cruz,2021-02-16,1667,60268,209,17139,1458,43129,0,0,513,34891,1132,12660,513,47551,California
Santa Cruz,2021-02-17,2816,63084,934,18073,1882,45011,0,0,1133,34357,1670,14330,1136,48687,California
Santa Cruz,2021-02-18,2784,65868,608,18681,2176,47187,0,0,1188,33954,1591,15921,1188,49875,California
Santa Cruz,2021-02-19,3145,69013,1098,19779,2047,49234,0,0,1889,34591,1252,17173,1889,51764,California
Santa Cruz,2021-02-20,2322,71335,1455,21234,867,50101,0,0,1600,35470,721,17894,1600,53364,California
Santa Cruz,2021-02-21,832,72167,353,21587,479,50580,0,0,471,35583,358,18252,471,53835,California
Santa Cruz,2021-02-22,1199,73366,926,22513,273,50853,0,0,487,35362,708,18960,487,54322,California
Santa Cruz,2021-02-23,2102,75468,935,23448,1167,52020,0,0,716,34696,1382,20342,716,55038,California
Santa Cruz,2021-02-24,3202,78670,1688,25136,1514,53534,0,0,1061,33621,2136,22478,1061,56099,California
Santa Cruz,2021-02-25,3286,81956,1438,26574,1848,55382,0,0,1595,33533,1684,24162,1596,57695,California
Santa Cruz,2021-02-26,2700,84656,733,27307,1967,57349,0,0,1208,33256,1486,25648,1209,58904,California
Santa Cruz,2021-02-27,2681,87337,938,28245,1742,59091,1,1,1262,33102,1417,27065,1263,60167,California
Santa Cruz,2021-02-28,1325,88662,363,28608,962,60053,0,1,494,32769,827,27892,494,60661,California
Santa Cruz,2021-03-01,1889,90551,1255,29863,633,60686,1,2,666,32217,1219,29111,667,61328,California
Santa Cruz,2021-03-02,1553,92104,390,30253,1163,61849,0,2,848,32363,704,29815,850,62178,California
Santa Cruz,2021-03-03,2298,94402,602,30855,1696,63545,0,2,1185,32440,1108,30923,1185,63363,California
Santa Cruz,2021-03-04,2930,97332,1405,32260,1524,65069,1,3,1907,33338,1011,31934,1909,65272,California
Santa Cruz,2021-03-05,2618,99950,457,32717,2144,67213,17,20,1078,32896,1537,33471,1095,66367,California
Santa Cruz,2021-03-06,3685,103635,1197,33914,2390,69603,98,118,1917,33141,1767,35238,2012,68379,California
Santa Cruz,2021-03-07,1352,104987,114,34028,1144,70747,94,212,548,32980,803,36041,642,69021,California
Santa Cruz,2021-03-08,1073,106060,210,34238,730,71477,133,345,640,33318,430,36471,768,69789,California
Santa Cruz,2021-03-09,1777,107837,270,34508,1361,72838,146,491,705,33100,1068,37539,850,70639,California
Santa Cruz,2021-03-10,3794,111631,2053,36561,1602,74440,139,630,1949,33351,1836,39375,2087,72726,California
Santa Cruz,2021-03-11,2759,114390,1206,37767,1387,75827,166,796,1534,33828,1222,40597,1699,74425,California
Santa Cruz,2021-03-12,2631,117021,835,38602,1522,77349,274,1070,878,33227,1750,42347,1149,75574,California
Santa Cruz,2021-03-13,2214,119235,1254,39856,923,78272,37,1107,1096,33245,1115,43462,1133,76707,California
Santa Cruz,2021-03-14,881,120116,182,40038,687,78959,12,1119,414,33203,465,43927,423,77130,California
Santa Cruz,2021-03-15,1255,121371,442,40480,779,79738,34,1153,539,33066,711,44638,574,77704,California
Santa Cruz,2021-03-16,2295,123666,1095,41575,1135,80873,65,1218,1296,33432,993,45631,1359,79063,California
Santa Cruz,2021-03-17,3924,127590,2399,43974,1511,82384,14,1232,2576,34680,1343,46974,2591,81654,California
Santa Cruz,2021-03-18,3786,131376,2011,45985,1618,84002,157,1389,1964,34979,1818,48792,2117,83771,California
Santa Cruz,2021-03-19,3259,134635,1297,47282,1755,85757,207,1596,1710,35352,1544,50336,1917,85688,California
Santa Cruz,2021-03-20,2242,136877,1641,48923,500,86257,101,1697,1058,35327,1182,51518,1157,86845,California
Santa Cruz,2021-03-21,832,137709,452,49375,258,86515,122,1819,446,35511,384,51902,568,87413,California
Santa Cruz,2021-03-22,1314,139023,797,50172,493,87008,24,1843,932,36087,380,52282,956,88369,California
Santa Cruz,2021-03-23,2577,141600,1394,51566,1094,88102,89,1932,1631,36861,944,53226,1718,90087,California
Santa Cruz,2021-03-24,3107,144707,2086,53652,996,89098,25,1957,2063,37913,1035,54261,2087,92174,California
Santa Cruz,2021-03-25,2636,147343,1294,54946,1232,90330,110,2067,1255,37903,1374,55635,1364,93538,California
Santa Cruz,2021-03-26,2972,150315,1713,56659,1230,91560,29,2096,2013,38995,950,56585,2042,95580,California
Santa Cruz,2021-03-27,2973,153288,1831,58490,1117,92677,25,2121,1388,38834,1574,58159,1413,96993,California
Santa Cruz,2021-03-28,862,154150,526,59016,322,92999,14,2135,431,38852,427,58586,445,97438,California
Santa Cruz,2021-03-29,1912,156062,818,59834,1015,94014,79,2214,1199,39420,709,59295,1277,98715,California
Santa Cruz,2021-03-30,2630,158692,778,60612,1637,95651,215,2429,1621,40250,1005,60300,1835,100550,California
Santa Cruz,2021-03-31,4017,162709,2741,63353,1227,96878,49,2478,2094,40472,1919,62219,2141,102691,California
Santa Cruz,2021-04-01,3881,166590,2084,65437,1646,98524,151,2629,1926,40599,1948,64167,2075,104766,California
Santa Cruz,2021-04-02,3127,169717,1326,66763,1633,100157,168,2797,1746,41134,1377,65544,1912,106678,California
Santa Cruz,2021-04-03,2121,171838,1178,67941,830,100987,113,2910,828,40783,1290,66834,939,107617,California
Santa Cruz,2021-04-04,888,172726,456,68397,378,101365,54,2964,519,40984,369,67203,570,108187,California
Santa Cruz,2021-04-05,2165,174891,716,69113,1283,102648,166,3130,1320,41623,843,68046,1482,109669,California
Santa Cruz,2021-04-06,3204,178095,1562,70675,1284,103932,358,3488,1835,42451,1358,69404,2186,111855,California
Santa Cruz,2021-04-07,4277,182372,1744,72419,2196,106128,337,3825,1708,41930,2563,71967,2042,113897,California
Santa Cruz,2021-04-08,4026,186398,2190,74609,1354,107482,482,4307,2349,43093,1666,73633,2829,116726,California
Santa Cruz,2021-04-09,3562,189960,1425,76034,1759,109241,378,4685,2002,43916,1554,75187,2377,119103,California
Santa Cruz,2021-04-10,2077,192037,968,77002,882,110123,227,4912,949,43962,1124,76311,1170,120273,California
Santa Cruz,2021-04-11,890,192927,437,77439,367,110490,86,4998,391,43940,499,76810,477,120750,California
Santa Cruz,2021-04-12,2178,195105,751,78190,1038,111528,389,5387,1040,44246,1123,77933,1429,122179,California
Santa Cruz,2021-04-13,2779,197884,1370,79560,1408,112936,1,5388,1549,44577,1219,79152,1550,123729,California
Santa Cruz,2021-04-14,4519,202403,2193,81753,2326,115262,0,5388,2095,44264,2410,81562,2097,125826,California
Santa Cruz,2021-04-15,4826,207229,3049,84802,1777,117039,0,5388,3028,45511,1783,83345,3030,128856,California
Santa Cruz,2021-04-16,4243,211472,2293,87095,1948,118987,2,5390,2250,45779,1985,85330,2253,131109,California
Santa Cruz,2021-04-17,2121,213593,836,87931,1285,120272,0,5390,1368,46397,750,86080,1368,132477,California
Santa Cruz,2021-04-18,1039,214632,516,88447,522,120794,1,5391,583,46529,452,86532,584,133061,California
Santa Cruz,2021-04-19,2451,217083,1431,89878,1019,121813,1,5392,1516,47116,929,87461,1516,134577,California
Santa Cruz,2021-04-20,3035,220118,1603,91481,1432,123245,0,5392,1728,47550,1295,88756,1729,136306,California
Santa Cruz,2021-04-21,4094,224212,2749,94230,1345,124590,0,5392,2145,47772,1924,90680,2146,138452,California
Santa Cruz,2021-04-22,4189,228401,2848,97078,1340,125930,1,5393,2341,48279,1837,92517,2344,140796,California
Santa Cruz,2021-04-23,3062,231463,1655,98733,1406,127336,1,5394,1334,47897,1716,94233,1334,142130,California
Santa Cruz,2021-04-24,2168,233631,1071,99804,1094,128430,3,5397,691,47124,1467,95700,694,142824,California
Santa Cruz,2021-04-25,1038,234669,654,100458,371,128801,13,5410,412,46935,614,96314,425,143249,California
Santa Cruz,2021-04-26,2014,236683,969,101427,1028,129829,17,5427,838,46626,1165,97479,856,144105,California
Santa Cruz,2021-04-27,2859,239542,911,102338,1865,131694,83,5510,1408,46672,1443,98922,1489,145594,California
Santa Cruz,2021-04-28,3348,242890,1851,104189,1417,133111,80,5590,1727,46868,1609,100531,1805,147399,California
Santa Cruz,2021-04-29,3637,246527,2430,106619,1151,134262,56,5646,1277,45851,2351,102882,1334,148733,California
Santa Cruz,2021-04-30,2301,248828,1166,107785,1089,135351,46,5692,982,45570,1309,104191,1028,149761,California
Santa Cruz,2021-05-01,1220,250048,960,108745,224,135575,36,5728,592,45575,623,104814,628,150389,California
Santa Cruz,2021-05-02,574,250622,396,109141,153,135728,25,5753,202,45432,371,105185,228,150617,California
Santa Cruz,2021-05-03,1836,252458,922,110063,849,136577,65,5818,630,44936,1192,106377,696,151313,California
Santa Cruz,2021-05-04,2574,255032,1492,111555,1013,137590,69,5887,852,44140,1715,108092,919,152232,California
Santa Cruz,2021-05-05,2681,257713,1324,112879,1277,138867,80,5967,699,42982,1942,110034,784,153016,California
Santa Cruz,2021-05-06,3807,261520,2429,115308,1158,140025,220,6187,862,41137,2925,112959,1080,154096,California
Santa Cruz,2021-05-07,2619,264139,1142,116450,1398,141423,79,6266,421,39451,2187,115146,501,154597,California
Santa Cruz,2021-05-08,1359,265498,689,117139,638,142061,32,6298,369,38863,988,116134,400,154997,California
Santa Cruz,2021-05-09,495,265993,313,117452,159,142220,23,6321,142,38676,352,116486,165,155162,California
Santa Cruz,2021-05-10,2018,268011,1199,118651,758,142978,61,6382,393,37516,1614,118100,454,155616,California
Santa Cruz,2021-05-11,2320,270331,1295,119946,936,143914,89,6471,615,36520,1700,119800,704,156320,California
Santa Cruz,2021-05-12,3083,273414,1309,121255,1698,145612,76,6547,559,34644,2513,122313,637,156957,California
Santa Cruz,2021-05-13,3846,277260,2590,123845,1167,146779,89,6636,1357,33606,2485,124798,1447,158404,California
Santa Cruz,2021-05-14,2863,280123,1553,125398,1272,148051,38,6674,1084,32961,1768,126566,1123,159527,California
Santa Cruz,2021-05-15,2213,282336,1292,126690,910,148961,11,6685,1085,32932,1125,127691,1096,160623,California
Santa Cruz,2021-05-16,777,283113,419,127109,332,149293,26,6711,273,32729,502,128193,299,160922,California
Santa Cruz,2021-05-17,1462,284575,731,127840,663,149956,68,6779,509,32354,952,129145,577,161499,California
Santa Cruz,2021-05-18,2226,286801,1354,129194,845,150801,27,6806,1063,32287,1157,130302,1090,162589,California
Santa Cruz,2021-05-19,3026,289827,1846,131040,1143,151944,37,6843,1301,31908,1717,132019,1338,163927,California
Santa Cruz,2021-05-20,3344,293171,2405,133445,792,152736,147,6990,1584,31887,1752,133771,1731,165658,California
Santa Cruz,2021-05-21,1728,294899,898,134343,750,153486,80,7070,613,31471,1110,134881,694,166352,California
Santa Cruz,2021-05-22,1695,296594,1317,135660,368,153854,10,7080,591,30972,1101,135982,602,166954,California
Santa Cruz,2021-05-23,467,297061,267,135927,181,154035,19,7099,152,30830,313,136295,171,167125,California
Santa Cruz,2021-05-24,1153,298214,668,136595,410,154445,75,7174,301,30363,843,137138,376,167501,California
Santa Cruz,2021-05-25,2205,300419,1275,137870,886,155331,44,7218,453,29253,1606,138744,496,167997,California
Santa Cruz,2021-05-26,1778,302197,778,138648,957,156288,43,7261,465,28458,1302,140046,507,168504,California
Santa Cruz,2021-05-27,1261,303458,696,139344,467,156755,98,7359,429,28159,826,140872,527,169031,California
Santa Cruz,2021-05-28,836,304294,369,139713,437,157192,30,7389,356,28076,470,141342,387,169418,California
Santa Cruz,2021-05-29,573,304867,327,140040,236,157428,10,7399,316,28148,254,141596,326,169744,California
Santa Cruz,2021-05-30,235,305102,117,140157,105,157533,13,7412,91,28111,141,141737,104,169848,California
Santa Cruz,2021-05-31,144,305246,62,140219,81,157614,1,7413,48,28064,96,141833,49,169897,California
Santa Cruz,2021-06-01,899,306145,552,140771,336,157950,11,7424,329,27838,566,142399,340,170237,California
Santa Cruz,2021-06-02,866,307011,505,141276,321,158271,40,7464,329,27675,532,142931,369,170606,California
Santa Cruz,2021-06-03,2232,309243,1515,142791,678,158949,39,7503,513,26520,1707,144638,552,171158,California
Santa Cruz,2021-06-04,1021,310264,693,143484,297,159246,31,7534,236,26009,778,145416,267,171425,California
Santa Cruz,2021-06-05,985,311249,797,144281,183,159429,5,7539,178,25389,803,146219,183,171608,California
Santa Cruz,2021-06-06,374,311623,273,144554,84,159513,17,7556,65,25165,306,146525,82,171690,California
Santa Cruz,2021-06-07,818,312441,604,145158,184,159697,30,7586,227,24831,591,147116,257,171947,California
Santa Cruz,2021-06-08,1407,313848,1116,146274,265,159962,26,7612,292,24040,1111,148227,320,172267,California
Santa Cruz,2021-06-09,1401,315249,1105,147379,278,160240,18,7630,274,23214,1119,149346,293,172560,California
Santa Cruz,2021-06-10,1945,317194,1600,148979,279,160519,66,7696,320,21979,1618,150964,383,172943,California
Santa Cruz,2021-06-11,817,318011,504,149483,280,160799,33,7729,281,21760,531,151495,312,173255,California
Santa Cruz,2021-06-12,982,318993,858,150341,118,160917,6,7735,170,21127,809,152304,176,173431,California
Santa Cruz,2021-06-13,212,319205,141,150482,45,160962,26,7761,35,21011,177,152481,61,173492,California
Santa Cruz,2021-06-14,553,319758,355,150837,162,161124,36,7797,156,20807,395,152876,191,173683,California
Santa Cruz,2021-06-15,912,320670,670,151507,220,161344,22,7819,323,20569,584,153460,346,174029,California
Santa Cruz,2021-06-16,769,321439,564,152071,172,161516,33,7852,225,20287,539,153999,257,174286,California
Santa Cruz,2021-06-17,787,322226,609,152680,142,161658,36,7888,294,20127,489,154488,329,174615,California
Santa Cruz,2021-06-18,627,322853,383,153063,217,161875,27,7915,278,20087,345,154833,305,174920,California
Santa Cruz,2021-06-19,327,323180,259,153322,62,161937,6,7921,112,19994,211,155044,118,175038,California
Santa Cruz,2021-06-20,159,323339,112,153434,30,161967,17,7938,68,19988,91,155135,85,175123,California
Santa Cruz,2021-06-21,337,323676,237,153671,81,162048,19,7957,172,20015,164,155299,191,175314,California
Santa Cruz,2021-06-22,662,324338,467,154138,169,162217,26,7983,260,19901,401,155700,287,175601,California
Santa Cruz,2021-06-23,390,324728,279,154417,102,162319,9,7992,189,19902,195,155895,196,175797,California
Santa Cruz,2021-06-24,538,325266,387,154804,111,162430,40,8032,212,19830,321,156216,249,176046,California
Santa Cruz,2021-06-25,547,325813,360,155164,159,162589,28,8060,252,19819,291,156507,280,176326,California
Santa Cruz,2021-06-26,251,326064,154,155318,89,162678,8,8068,102,19782,147,156654,110,176436,California
Santa Cruz,2021-06-27,160,326224,112,155430,18,162696,30,8098,65,19782,95,156749,95,176531,California
Santa Cruz,2021-06-28,453,326677,367,155797,72,162768,14,8112,193,19729,259,157008,206,176737,California
Santa Cruz,2021-06-29,700,327377,554,156351,118,162886,28,8140,272,19603,425,157433,299,177036,California
Santa Cruz,2021-06-30,415,327792,283,156634,112,162998,20,8160,177,19565,235,157668,197,177233,California
Santa Cruz,2021-07-01,402,328194,287,156921,102,163100,13,8173,176,19531,223,157891,189,177422,California
Santa Cruz,2021-07-02,428,328622,311,157232,103,163203,14,8187,187,19496,236,158127,201,177623,California
Santa Cruz,2021-07-03,210,328832,148,157380,59,163262,3,8190,89,19468,120,158247,92,177715,California
Santa Cruz,2021-07-04,10,328842,8,157388,1,163263,1,8191,8,19475,2,158249,9,177724,California
Santa Cruz,2021-07-05,199,329041,155,157543,41,163304,3,8194,112,19504,85,158334,114,177838,California
Santa Cruz,2021-07-06,664,329705,553,158096,95,163399,16,8210,205,19271,454,158788,221,178059,California
Santa Cruz,2021-07-07,384,330089,274,158370,98,163497,12,8222,152,19205,230,159018,164,178223,California
Santa Cruz,2021-07-08,392,330481,276,158646,79,163576,37,8259,137,19126,253,159271,174,178397,California
Santa Cruz,2021-07-09,445,330926,320,158966,108,163684,17,8276,183,19073,254,159525,201,178598,California
Santa Cruz,2021-07-10,195,331121,141,159107,46,163730,8,8284,90,19068,103,159628,98,178696,California
Santa Cruz,2021-07-11,116,331237,93,159200,20,163750,3,8287,59,19074,56,159684,62,178758,California
Santa Cruz,2021-07-12,360,331597,264,159464,82,163832,14,8301,146,19022,211,159895,159,178917,California
Santa Cruz,2021-07-13,513,332110,393,159857,106,163938,14,8315,198,18925,310,160205,213,179130,California
Santa Cruz,2021-07-14,370,332480,260,160117,92,164030,18,8333,157,18891,208,160413,174,179304,California
Santa Cruz,2021-07-15,360,332840,270,160387,71,164101,19,8352,157,18865,202,160615,176,179480,California
Santa Cruz,2021-07-16,419,333259,299,160686,110,164211,10,8362,204,18866,213,160828,214,179694,California
Santa Cruz,2021-07-17,221,333480,169,160855,45,164256,7,8369,116,18885,104,160932,123,179817,California
Santa Cruz,2021-07-18,142,333622,105,160960,31,164287,6,8375,86,18921,56,160988,92,179909,California
Santa Cruz,2021-07-19,363,333985,263,161223,82,164369,18,8393,167,18912,193,161181,184,180093,California
Santa Cruz,2021-07-20,605,334590,475,161698,116,164485,14,8407,292,18907,311,161492,306,180399,California
Santa Cruz,2021-07-21,361,334951,260,161958,94,164579,7,8414,192,18945,161,161653,199,180598,California
Santa Cruz,2021-07-22,435,335386,299,162257,91,164670,45,8459,217,18991,216,161869,262,180860,California
Santa Cruz,2021-07-23,502,335888,314,162571,161,164831,27,8486,283,19085,215,162084,309,181169,California
Santa Cruz,2021-07-24,245,336133,161,162732,80,164911,4,8490,147,19141,94,162178,150,181319,California
Santa Cruz,2021-07-25,115,336248,96,162828,18,164929,1,8491,81,19190,33,162211,82,181401,California
Santa Cruz,2021-07-26,352,336600,260,163088,82,165011,10,8501,196,19242,154,162365,206,181607,California
Santa Cruz,2021-07-27,588,337188,472,163560,99,165110,17,8518,334,19342,251,162616,351,181958,California
Santa Cruz,2021-07-28,368,337556,238,163798,122,165232,8,8526,201,19385,165,162781,208,182166,California
Santa Cruz,2021-07-29,437,337993,309,164107,92,165324,36,8562,244,19477,188,162969,280,182446,California
Santa Cruz,2021-07-30,536,338529,365,164472,126,165450,45,8607,308,19609,221,163190,353,182799,California
Santa Cruz,2021-07-31,345,338874,247,164719,67,165517,31,8638,220,19741,118,163308,250,183049,California
Santa Cruz,2021-08-01,148,339022,111,164830,33,165550,4,8642,87,19774,58,163366,91,183140,California
Santa Cruz,2021-08-02,328,339350,245,165075,78,165628,5,8647,211,19880,110,163476,216,183356,California
Santa Cruz,2021-08-03,623,339973,485,165560,117,165745,21,8668,377,20038,239,163715,397,183753,California
Santa Cruz,2021-08-04,346,340319,258,165818,76,165821,12,8680,196,20099,145,163860,206,183959,California
Santa Cruz,2021-08-05,454,340773,325,166143,99,165920,30,8710,264,20209,182,164042,292,184251,California
Santa Cruz,2021-08-06,517,341290,373,166516,120,166040,24,8734,304,20326,210,164252,327,184578,California
Santa Cruz,2021-08-07,377,341667,261,166777,74,166114,42,8776,212,20421,157,164409,252,184830,California
Santa Cruz,2021-08-08,182,341849,151,166928,29,166143,2,8778,107,20457,73,164482,109,184939,California
Santa Cruz,2021-08-09,507,342356,394,167322,79,166222,34,8812,300,20589,201,164683,333,185272,California
Santa Cruz,2021-08-10,611,342967,488,167810,116,166338,7,8819,332,20654,275,164958,340,185612,California
Santa Cruz,2021-08-11,376,343343,283,168093,79,166417,14,8833,195,20692,171,165129,209,185821,California
Santa Cruz,2021-08-12,415,343758,313,168406,86,166503,16,8849,223,20751,180,165309,239,186060,California
Santa Cruz,2021-08-13,501,344259,347,168753,124,166627,30,8879,260,20812,229,165538,290,186350,California
Santa Cruz,2021-08-14,278,344537,198,168951,73,166700,7,8886,126,20816,128,165666,132,186482,California
Santa Cruz,2021-08-15,235,344772,176,169127,49,166749,10,8896,130,20876,80,165746,140,186622,California
Santa Cruz,2021-08-16,426,345198,247,169374,167,166916,12,8908,185,20904,168,165914,196,186818,California
Santa Cruz,2021-08-17,707,345905,526,169900,160,167076,21,8929,277,20851,351,166265,298,187116,California
Santa Cruz,2021-08-18,437,346342,270,170170,159,167235,8,8937,180,20861,178,166443,188,187304,California
Santa Cruz,2021-08-19,581,346923,361,170531,192,167427,28,8965,217,20853,252,166695,244,187548,California
Santa Cruz,2021-08-20,654,347577,379,170910,259,167686,16,8981,268,20891,246,166941,284,187832,California
Santa Cruz,2021-08-21,454,348031,318,171228,121,167807,15,8996,130,20798,238,167179,145,187977,California
Santa Cruz,2021-08-22,268,348299,170,171398,84,167891,14,9010,106,20812,106,167285,120,188097,California
Santa Cruz,2021-08-23,526,348825,339,171737,167,168058,20,9030,216,20850,197,167482,235,188332,California
Santa Cruz,2021-08-24,852,349677,617,172354,194,168252,41,9071,281,20753,417,167899,320,188652,California
Santa Cruz,2021-08-25,476,350153,313,172667,157,168409,6,9077,203,20799,163,168062,209,188861,California
Santa Cruz,2021-08-26,637,350790,447,173114,171,168580,19,9096,238,20799,257,168319,257,189118,California
Santa Cruz,2021-08-27,622,351412,415,173529,190,168770,17,9113,249,20787,276,168595,264,189382,California
Santa Cruz,2021-08-28,320,351732,244,173773,75,168845,1,9114,128,20776,140,168735,129,189511,California
Santa Cruz,2021-08-29,247,351979,165,173938,80,168925,2,9116,81,20742,117,168852,83,189594,California
Santa Cruz,2021-08-30,383,352362,243,174181,123,169048,17,9133,108,20684,183,169035,125,189719,California
Shasta,2020-12-15,1,1,1,1,0,0,0,0,1,1,0,0,1,1,California
Shasta,2020-12-16,133,134,133,134,0,0,0,0,133,134,0,0,133,134,California
Shasta,2020-12-17,420,554,420,554,0,0,0,0,420,554,0,0,420,554,California
Shasta,2020-12-18,165,719,165,719,0,0,0,0,165,719,0,0,165,719,California
Shasta,2020-12-19,1,720,1,720,0,0,0,0,1,720,0,0,1,720,California
Shasta,2020-12-20,1,721,0,720,1,1,0,0,1,721,0,0,1,721,California
Shasta,2020-12-21,70,791,69,789,1,2,0,0,70,791,0,0,70,791,California
Shasta,2020-12-22,194,985,189,978,5,7,0,0,194,985,0,0,194,985,California
Shasta,2020-12-23,166,1151,162,1140,4,11,0,0,166,1151,0,0,166,1151,California
Shasta,2020-12-24,25,1176,25,1165,0,11,0,0,25,1176,0,0,25,1176,California
Shasta,2020-12-26,4,1180,1,1166,3,14,0,0,4,1180,0,0,4,1180,California
Shasta,2020-12-27,3,1183,2,1168,1,15,0,0,3,1183,0,0,3,1183,California
Shasta,2020-12-28,36,1219,26,1194,10,25,0,0,36,1219,0,0,36,1219,California
Shasta,2020-12-29,175,1394,174,1368,1,26,0,0,175,1394,0,0,175,1394,California
Shasta,2020-12-30,197,1591,187,1555,10,36,0,0,197,1591,0,0,197,1591,California
Shasta,2020-12-31,80,1671,1,1556,79,115,0,0,80,1671,0,0,80,1671,California
Shasta,2021-01-01,1,1672,0,1556,1,116,0,0,1,1672,0,0,1,1672,California
Shasta,2021-01-02,2,1674,0,1556,2,118,0,0,2,1674,0,0,2,1674,California
Shasta,2021-01-03,1,1675,1,1557,0,118,0,0,1,1675,0,0,1,1675,California
Shasta,2021-01-04,357,2032,297,1854,60,178,0,0,357,2032,0,0,357,2032,California
Shasta,2021-01-05,335,2367,312,2166,23,201,0,0,256,2209,79,79,256,2288,California
Shasta,2021-01-06,473,2840,399,2565,74,275,0,0,206,2149,267,346,207,2495,California
Shasta,2021-01-07,141,2981,42,2607,99,374,0,0,115,2238,26,372,115,2610,California
Shasta,2021-01-08,527,3508,445,3052,82,456,0,0,316,2343,211,583,316,2926,California
Shasta,2021-01-09,75,3583,66,3118,9,465,0,0,71,2410,4,587,71,2997,California
Shasta,2021-01-10,6,3589,0,3118,6,471,0,0,4,2414,2,589,6,3003,California
Shasta,2021-01-11,403,3992,190,3308,213,684,0,0,365,2741,38,627,365,3368,California
Shasta,2021-01-12,473,4465,318,3626,155,839,0,0,305,2879,168,795,306,3674,California
Shasta,2021-01-13,604,5069,266,3892,338,1177,0,0,438,3151,166,961,438,4112,California
Shasta,2021-01-14,492,5561,57,3949,435,1612,0,0,468,3595,24,985,468,4580,California
Shasta,2021-01-15,678,6239,141,4090,537,2149,0,0,677,4271,1,986,677,5257,California
Shasta,2021-01-16,887,7126,53,4143,834,2983,0,0,884,5152,3,989,884,6141,California
Shasta,2021-01-17,28,7154,7,4150,21,3004,0,0,23,5170,5,994,23,6164,California
Shasta,2021-01-18,600,7754,127,4277,473,3477,0,0,593,5756,7,1001,593,6757,California
Shasta,2021-01-19,1064,8818,404,4681,660,4137,0,0,919,6530,145,1146,919,7676,California
Shasta,2021-01-20,753,9571,497,5178,256,4393,0,0,558,6897,191,1337,558,8234,California
Shasta,2021-01-21,669,10240,333,5511,336,4729,0,0,650,7528,19,1356,650,8884,California
Shasta,2021-01-22,436,10676,181,5692,255,4984,0,0,429,7951,7,1363,430,9314,California
Shasta,2021-01-23,58,10734,5,5697,53,5037,0,0,56,8005,2,1365,56,9370,California
Shasta,2021-01-24,26,10760,4,5701,22,5059,0,0,25,8029,1,1366,25,9395,California
Shasta,2021-01-25,751,11511,496,6197,255,5314,0,0,468,8215,282,1648,468,9863,California
Shasta,2021-01-26,715,12226,340,6537,375,5689,0,0,478,8459,234,1882,478,10341,California
Shasta,2021-01-27,450,12676,196,6733,254,5943,0,0,400,8810,49,1931,400,10741,California
Shasta,2021-01-28,912,13588,590,7323,322,6265,0,0,691,9280,221,2152,691,11432,California
Shasta,2021-01-29,815,14403,335,7658,480,6745,0,0,624,9715,190,2342,625,12057,California
Shasta,2021-01-30,606,15009,14,7672,592,7337,0,0,595,10299,11,2353,595,12652,California
Shasta,2021-01-31,30,15039,5,7677,25,7362,0,0,28,10325,2,2355,28,12680,California
Shasta,2021-02-01,540,15579,156,7833,384,7746,0,0,394,10573,146,2501,394,13074,California
Shasta,2021-02-02,985,16564,501,8334,484,8230,0,0,894,11378,89,2590,894,13968,California
Shasta,2021-02-03,697,17261,217,8551,480,8710,0,0,462,11605,235,2825,462,14430,California
Shasta,2021-02-04,1090,18351,688,9239,402,9112,0,0,890,12299,196,3021,890,15320,California
Shasta,2021-02-05,1293,19644,173,9412,1120,10232,0,0,1068,13145,222,3243,1068,16388,California
Shasta,2021-02-06,1821,21465,38,9450,1783,12015,0,0,1797,14917,26,3269,1798,18186,California
Shasta,2021-02-07,27,21492,3,9453,24,12039,0,0,24,14938,3,3272,24,18210,California
Shasta,2021-02-08,599,22091,172,9625,427,12466,0,0,312,14964,286,3558,312,18522,California
Shasta,2021-02-09,1130,23221,655,10280,475,12941,0,0,699,15233,431,3989,700,19222,California
Shasta,2021-02-10,1130,24351,806,11086,324,13265,0,0,548,15200,581,4570,548,19770,California
Shasta,2021-02-11,884,25235,191,11277,693,13958,0,0,304,14929,575,5145,304,20074,California
Shasta,2021-02-12,2206,27441,1637,12914,569,14527,0,0,1652,16030,551,5696,1652,21726,California
Shasta,2021-02-13,1354,28795,371,13285,983,15510,0,0,554,15786,799,6495,555,22281,California
Shasta,2021-02-14,148,28943,5,13290,143,15653,0,0,123,15884,25,6520,123,22404,California
Shasta,2021-02-15,395,29338,111,13401,284,15937,0,0,215,15919,180,6700,215,22619,California
Shasta,2021-02-16,1203,30541,520,13921,683,16620,0,0,420,15559,780,7480,420,23039,California
Shasta,2021-02-17,1040,31581,462,14383,578,17198,0,0,419,15357,621,8101,419,23458,California
Shasta,2021-02-18,968,32549,492,14875,476,17674,0,0,465,15320,503,8604,466,23924,California
Shasta,2021-02-19,1349,33898,950,15825,399,18073,0,0,868,15708,480,9084,868,24792,California
Shasta,2021-02-20,805,34703,103,15928,702,18775,0,0,315,15533,490,9574,315,25107,California
Shasta,2021-02-21,34,34737,4,15932,30,18805,0,0,11,15521,23,9597,11,25118,California
Shasta,2021-02-22,443,35180,86,16018,357,19162,0,0,185,15449,257,9854,185,25303,California
Shasta,2021-02-23,926,36106,480,16498,446,19608,0,0,330,15183,596,10450,330,25633,California
Shasta,2021-02-24,894,37000,514,17012,380,19988,0,0,279,14852,611,11061,280,25913,California
Shasta,2021-02-25,536,37536,202,17214,334,20322,0,0,155,14628,379,11440,155,26068,California
Shasta,2021-02-26,804,38340,110,17324,694,21016,0,0,349,14524,453,11893,349,26417,California
Shasta,2021-02-27,856,39196,76,17400,780,21796,0,0,241,14155,610,12503,241,26658,California
Shasta,2021-02-28,189,39385,4,17404,185,21981,0,0,135,14236,54,12557,135,26793,California
Shasta,2021-03-01,626,40011,63,17467,563,22544,0,0,306,14224,318,12875,306,27099,California
Shasta,2021-03-02,1030,41041,474,17941,556,23100,0,0,332,13859,697,13572,332,27431,California
Shasta,2021-03-03,694,41735,186,18127,508,23608,0,0,245,13656,448,14020,245,27676,California
Shasta,2021-03-04,3064,44799,2489,20616,575,24183,0,0,1375,13349,1682,15702,1375,29051,California
Shasta,2021-03-05,1923,46722,165,20781,1728,25911,30,30,774,13006,1147,16849,804,29855,California
Shasta,2021-03-06,2753,49475,381,21162,2329,28240,43,73,762,11825,1986,18835,805,30660,California
Shasta,2021-03-07,104,49579,4,21166,61,28301,39,112,41,11841,62,18897,78,30738,California
Shasta,2021-03-08,575,50154,59,21225,376,28677,140,252,158,11723,414,19311,296,31034,California
Shasta,2021-03-09,1226,51380,597,21822,454,29131,175,427,657,11988,566,19877,831,31865,California
Shasta,2021-03-10,792,52172,256,22078,335,29466,201,628,144,11683,647,20524,342,32207,California
Shasta,2021-03-11,1517,53689,474,22552,787,30253,256,884,912,12249,601,21125,1167,33374,California
Shasta,2021-03-12,1559,55248,874,23426,449,30702,236,1120,397,11719,1162,22287,632,34006,California
Shasta,2021-03-13,812,56060,424,23850,289,30991,99,1219,489,11983,321,22608,585,34591,California
Shasta,2021-03-14,1010,57070,9,23859,978,31969,23,1242,871,12740,139,22747,896,35487,California
Shasta,2021-03-15,485,57555,39,23898,354,32323,92,1334,208,12762,276,23023,298,35785,California
Shasta,2021-03-16,1119,58674,145,24043,904,33227,70,1404,831,13379,284,23307,901,36686,California
Shasta,2021-03-17,709,59383,181,24224,469,33696,59,1463,368,13474,332,23639,427,37113,California
Shasta,2021-03-18,1518,60901,592,24816,825,34521,101,1564,1076,14211,439,24078,1176,38289,California
Shasta,2021-03-19,627,61528,206,25022,366,34887,55,1619,383,14406,243,24321,438,38727,California
Shasta,2021-03-20,724,62252,476,25498,237,35124,11,1630,529,14751,195,24516,540,39267,California
Shasta,2021-03-21,313,62565,298,25796,4,35128,11,1641,285,15020,27,24543,296,39563,California
Shasta,2021-03-22,336,62901,34,25830,267,35395,35,1676,192,15105,142,24685,227,39790,California
Shasta,2021-03-23,1321,64222,664,26494,600,35995,57,1733,758,15363,557,25242,815,40605,California
Shasta,2021-03-24,617,64839,164,26658,417,36412,36,1769,374,15531,243,25485,411,41016,California
Shasta,2021-03-25,1112,65951,421,27079,670,37082,21,1790,779,16003,329,25814,801,41817,California
Shasta,2021-03-26,1787,67738,1364,28443,393,37475,30,1820,1415,17079,370,26184,1446,43263,California
Shasta,2021-03-27,1534,69272,363,28806,309,37784,862,2682,530,17462,1001,27185,1384,44647,California
Shasta,2021-03-28,404,69676,300,29106,94,37878,10,2692,296,17662,106,27291,306,44953,California
Shasta,2021-03-29,419,70095,44,29150,363,38241,12,2704,157,17572,259,27550,169,45122,California
Shasta,2021-03-30,1211,71306,750,29900,444,38685,17,2721,589,17560,618,28168,606,45728,California
Shasta,2021-03-31,616,71922,206,30106,403,39088,7,2728,371,17697,241,28409,378,46106,California
Shasta,2021-04-01,873,72795,228,30334,630,39718,15,2743,544,17929,326,28735,558,46664,California
Shasta,2021-04-02,720,73515,179,30513,490,40208,51,2794,383,18027,335,29070,433,47097,California
Shasta,2021-04-03,505,74020,362,30875,127,40335,16,2810,383,18304,122,29192,399,47496,California
Shasta,2021-04-04,288,74308,172,31047,96,40431,20,2830,214,18464,74,29266,234,47730,California
Shasta,2021-04-05,430,74738,69,31116,308,40739,53,2883,250,18587,180,29446,303,48033,California
Shasta,2021-04-06,1114,75852,480,31596,466,41205,168,3051,532,18707,578,30024,698,48731,California
Shasta,2021-04-07,622,76474,186,31782,279,41484,157,3208,231,18707,387,30411,387,49118,California
Shasta,2021-04-08,1119,77593,254,32036,710,42194,155,3363,206,18156,909,31320,358,49476,California
Shasta,2021-04-09,2570,80163,2060,34096,301,42495,209,3572,1996,19790,566,31886,2200,51676,California
Shasta,2021-04-10,858,81021,575,34671,154,42649,129,3701,232,19524,625,32511,359,52035,California
Shasta,2021-04-11,1240,82261,392,35063,828,43477,20,3721,143,18595,1092,33603,163,52198,California
Shasta,2021-04-12,335,82596,8,35071,268,43745,59,3780,93,18505,241,33844,151,52349,California
Shasta,2021-04-13,1249,83845,362,35433,884,44629,3,3783,334,17931,910,34754,336,52685,California
Shasta,2021-04-14,573,84418,146,35579,425,45054,2,3785,214,17789,358,35112,216,52901,California
Shasta,2021-04-15,1048,85466,245,35824,803,45857,0,3785,300,17346,743,35855,300,53201,California
Shasta,2021-04-16,2287,87753,1820,37644,467,46324,0,3785,921,16903,1364,37219,921,54122,California
Shasta,2021-04-17,612,88365,389,38033,223,46547,0,3785,181,16655,430,37649,182,54304,California
Shasta,2021-04-18,266,88631,240,38273,26,46573,0,3785,32,16455,232,37881,32,54336,California
Shasta,2021-04-19,380,89011,32,38305,348,46921,0,3785,164,16403,216,38097,164,54500,California
Shasta,2021-04-20,972,89983,212,38517,760,47681,0,3785,363,16159,607,38704,363,54863,California
Shasta,2021-04-21,593,90576,203,38720,390,48071,0,3785,307,16180,286,38990,307,55170,California
Shasta,2021-04-22,945,91521,262,38982,683,48754,0,3785,303,15844,639,39629,303,55473,California
Shasta,2021-04-23,635,92156,242,39224,393,49147,0,3785,327,15864,307,39936,327,55800,California
Shasta,2021-04-24,597,92753,358,39582,238,49385,1,3786,107,15483,488,40424,107,55907,California
Shasta,2021-04-25,212,92965,180,39762,31,49416,1,3787,40,15352,172,40596,41,55948,California
Shasta,2021-04-26,495,93460,56,39818,434,49850,5,3792,351,15565,142,40738,355,56303,California
Shasta,2021-04-27,534,93994,172,39990,325,50175,37,3829,298,15666,232,40970,333,56636,California
Shasta,2021-04-28,564,94558,139,40129,393,50568,32,3861,250,15633,314,41284,281,56917,California
Shasta,2021-04-29,747,95305,106,40235,619,51187,22,3883,177,15263,569,41853,199,57116,California
Shasta,2021-04-30,2242,97547,1824,42059,387,51574,31,3914,254,13561,1986,43839,284,57400,California
Shasta,2021-05-01,229,97776,24,42083,131,51705,74,3988,102,13610,127,43966,176,57576,California
Shasta,2021-05-02,50,97826,17,42100,20,51725,13,4001,22,13617,28,43994,35,57611,California
Shasta,2021-05-03,354,98180,103,42203,229,51954,22,4023,111,13509,241,44235,133,57744,California
Shasta,2021-05-04,531,98711,202,42405,292,52246,37,4060,252,13522,276,44511,289,58033,California
Shasta,2021-05-05,442,99153,146,42551,279,52525,17,4077,204,13505,238,44749,221,58254,California
Shasta,2021-05-06,680,99833,257,42808,389,52914,34,4111,289,13444,382,45131,321,58575,California
Shasta,2021-05-07,1098,100931,730,43538,330,53244,38,4149,300,12985,797,45928,338,58913,California
Shasta,2021-05-08,168,101099,82,43620,76,53320,10,4159,100,13027,67,45995,109,59022,California
Shasta,2021-05-09,63,101162,14,43634,44,53364,5,4164,33,13035,30,46025,38,59060,California
Shasta,2021-05-10,254,101416,23,43657,184,53548,47,4211,113,13054,138,46163,157,59217,California
Shasta,2021-05-11,498,101914,141,43798,210,53758,147,4358,180,13064,317,46480,327,59544,California
Shasta,2021-05-12,388,102302,141,43939,224,53982,23,4381,129,12959,257,46737,152,59696,California
Shasta,2021-05-13,584,102886,242,44181,328,54310,14,4395,223,12837,359,47096,237,59933,California
Shasta,2021-05-14,637,103523,267,44448,345,54655,25,4420,294,12815,342,47438,320,60253,California
Shasta,2021-05-15,382,103905,122,44570,161,54816,99,4519,159,12851,222,47660,258,60511,California
Shasta,2021-05-16,218,104123,153,44723,55,54871,10,4529,159,12961,59,47719,169,60680,California
Shasta,2021-05-17,530,104653,245,44968,227,55098,58,4587,279,13049,249,47968,337,61017,California
Shasta,2021-05-18,626,105279,298,45266,302,55400,26,4613,332,13115,292,48260,358,61375,California
Shasta,2021-05-19,583,105862,273,45539,242,55642,68,4681,277,13157,303,48563,345,61720,California
Shasta,2021-05-20,566,106428,252,45791,294,55936,20,4701,259,13131,304,48867,278,61998,California
Shasta,2021-05-21,640,107068,286,46077,335,56271,19,4720,329,13170,309,49176,348,62346,California
Shasta,2021-05-22,234,107302,132,46209,94,56365,8,4728,142,13232,89,49265,151,62497,California
Shasta,2021-05-23,112,107414,49,46258,57,56422,6,4734,68,13262,44,49309,74,62571,California
Shasta,2021-05-24,546,107960,174,46432,340,56762,32,4766,194,13139,349,49658,226,62797,California
Shasta,2021-05-25,473,108433,208,46640,220,56982,45,4811,161,13036,308,49966,205,63002,California
Shasta,2021-05-26,373,108806,143,46783,206,57188,24,4835,147,12982,225,50191,171,63173,California
Shasta,2021-05-27,413,109219,153,46936,251,57439,9,4844,158,12897,252,50443,167,63340,California
Shasta,2021-05-28,434,109653,196,47132,211,57650,27,4871,201,12895,230,50673,228,63568,California
Shasta,2021-05-29,226,109879,66,47198,129,57779,31,4902,89,12876,137,50810,118,63686,California
Shasta,2021-05-30,85,109964,48,47246,35,57814,2,4904,53,12900,31,50841,55,63741,California
Shasta,2021-05-31,34,109998,9,47255,24,57838,1,4905,12,12892,21,50862,13,63754,California
Shasta,2021-06-01,522,110520,153,47408,223,58061,146,5051,130,12785,383,51245,276,64030,California
Shasta,2021-06-02,291,110811,119,47527,163,58224,9,5060,116,12737,173,51418,125,64155,California
Shasta,2021-06-03,368,111179,161,47688,200,58424,7,5067,121,12619,246,51664,128,64283,California
Shasta,2021-06-04,559,111738,278,47966,255,58679,26,5093,196,12480,361,52025,222,64505,California
Shasta,2021-06-05,249,111987,145,48111,86,58765,18,5111,79,12409,169,52194,98,64603,California
Shasta,2021-06-06,159,112146,125,48236,32,58797,2,5113,47,12346,112,52306,49,64652,California
Shasta,2021-06-07,401,112547,234,48470,150,58947,17,5130,106,12175,294,52600,123,64775,California
Shasta,2021-06-08,515,113062,318,48788,153,59100,44,5174,147,11999,367,52967,191,64966,California
Shasta,2021-06-09,477,113539,269,49057,121,59221,87,5261,112,11835,362,53329,198,65164,California
Shasta,2021-06-10,410,113949,245,49302,140,59361,25,5286,128,11713,275,53604,153,65317,California
Shasta,2021-06-11,466,114415,251,49553,176,59537,39,5325,128,11542,337,53941,166,65483,California
Shasta,2021-06-12,207,114622,136,49689,65,59602,6,5331,73,11488,133,54074,79,65562,California
Shasta,2021-06-13,87,114709,54,49743,31,59633,2,5333,26,11455,61,54135,28,65590,California
Shasta,2021-06-14,280,114989,153,49896,110,59743,17,5350,80,11353,199,54334,97,65687,California
Shasta,2021-06-15,449,115438,224,50120,115,59858,110,5460,154,11322,289,54623,258,65945,California
Shasta,2021-06-16,261,115699,153,50273,95,59953,13,5473,85,11249,171,54794,98,66043,California
Shasta,2021-06-17,288,115987,123,50396,129,60082,36,5509,100,11198,187,54981,136,66179,California
Shasta,2021-06-18,369,116356,224,50620,125,60207,20,5529,155,11160,213,55194,175,66354,California
Shasta,2021-06-19,117,116473,75,50695,38,60245,4,5533,52,11152,63,55257,55,66409,California
Shasta,2021-06-20,58,116531,36,50731,18,60263,4,5537,21,11140,37,55294,25,66434,California
Shasta,2021-06-21,200,116731,64,50795,108,60371,28,5565,79,11126,121,55415,107,66541,California
Shasta,2021-06-22,374,117105,140,50935,83,60454,151,5716,95,11091,271,55686,236,66777,California
Shasta,2021-06-23,219,117324,128,51063,74,60528,17,5733,91,11072,127,55813,108,66885,California
Shasta,2021-06-24,230,117554,136,51199,76,60604,18,5751,92,11047,135,55948,110,66995,California
Shasta,2021-06-25,299,117853,204,51403,82,60686,13,5764,123,11006,176,56124,135,67130,California
Shasta,2021-06-26,139,117992,81,51484,48,60734,10,5774,56,10990,82,56206,66,67196,California
Shasta,2021-06-27,67,118059,44,51528,19,60753,4,5778,23,10973,44,56250,27,67223,California
Shasta,2021-06-28,184,118243,121,51649,47,60800,16,5794,91,10987,93,56343,107,67330,California
Shasta,2021-06-29,274,118517,166,51815,80,60880,28,5822,102,10948,169,56512,130,67460,California
Shasta,2021-06-30,211,118728,121,51936,76,60956,14,5836,92,10936,118,56630,106,67566,California
Shasta,2021-07-01,208,118936,135,52071,61,61017,12,5848,82,10906,124,56754,94,67660,California
Shasta,2021-07-02,270,119206,174,52245,82,61099,14,5862,120,10894,146,56900,134,67794,California
Shasta,2021-07-03,116,119322,78,52323,32,61131,6,5868,52,10888,64,56964,58,67852,California
Shasta,2021-07-04,4,119326,0,52323,3,61134,1,5869,0,10885,4,56968,1,67853,California
Shasta,2021-07-05,108,119434,60,52383,38,61172,10,5879,46,10880,61,57029,56,67909,California
Shasta,2021-07-06,286,119720,166,52549,100,61272,20,5899,92,10803,189,57218,112,68021,California
Shasta,2021-07-07,197,119917,102,52651,55,61327,40,5939,67,10782,128,57346,107,68128,California
Shasta,2021-07-08,213,120130,118,52769,78,61405,17,5956,84,10754,128,57474,100,68228,California
Shasta,2021-07-09,249,120379,162,52931,80,61485,7,5963,97,10706,152,57626,104,68332,California
Shasta,2021-07-10,97,120476,61,52992,32,61517,4,5967,43,10699,54,57680,47,68379,California
Shasta,2021-07-11,43,120519,21,53013,20,61537,2,5969,17,10692,26,57706,19,68398,California
Shasta,2021-07-12,150,120669,76,53089,56,61593,18,5987,67,10694,83,57789,85,68483,California
Shasta,2021-07-13,228,120897,135,53224,82,61675,11,5998,107,10696,117,57906,119,68602,California
Shasta,2021-07-14,159,121056,96,53320,59,61734,4,6002,73,10690,83,57989,77,68679,California
Shasta,2021-07-15,180,121236,99,53419,75,61809,6,6008,78,10676,98,58087,84,68763,California
Shasta,2021-07-16,243,121479,146,53565,80,61889,17,6025,110,10675,126,58213,125,68888,California
Shasta,2021-07-17,114,121593,64,53629,44,61933,6,6031,61,10690,52,58265,67,68955,California
Shasta,2021-07-18,61,121654,33,53662,24,61957,4,6035,36,10705,25,58290,40,68995,California
Shasta,2021-07-19,196,121850,83,53745,69,62026,44,6079,81,10716,114,58404,125,69120,California
Shasta,2021-07-20,234,122084,142,53887,80,62106,12,6091,137,10769,96,58500,149,69269,California
Shasta,2021-07-21,188,122272,111,53998,62,62168,15,6106,108,10812,80,58580,123,69392,California
Shasta,2021-07-22,220,122492,132,54130,74,62242,14,6120,125,10858,93,58673,139,69531,California
Shasta,2021-07-23,285,122777,177,54307,87,62329,21,6141,138,10873,144,58817,159,69690,California
Shasta,2021-07-24,142,122919,84,54391,53,62382,5,6146,75,10886,67,58884,80,69770,California
Shasta,2021-07-25,67,122986,46,54437,21,62403,0,6146,49,10917,18,58902,49,69819,California
Shasta,2021-07-26,239,123225,116,54553,82,62485,41,6187,139,10997,100,59002,180,69999,California
Shasta,2021-07-27,273,123498,152,54705,97,62582,24,6211,158,11074,102,59104,179,70178,California
Shasta,2021-07-28,220,123718,113,54818,91,62673,16,6227,137,11144,83,59187,153,70331,California
Shasta,2021-07-29,257,123975,157,54975,78,62751,22,6249,158,11227,96,59283,179,70510,California
Shasta,2021-07-30,339,124314,208,55183,115,62866,16,6265,210,11327,125,59408,225,70735,California
Shasta,2021-07-31,138,124452,67,55250,63,62929,8,6273,96,11389,42,59450,104,70839,California
Shasta,2021-08-01,78,124530,52,55302,22,62951,4,6277,59,11435,17,59467,63,70902,California
Shasta,2021-08-02,256,124786,119,55421,89,63040,48,6325,147,11523,107,59574,195,71097,California
Shasta,2021-08-03,284,125070,168,55589,99,63139,17,6342,174,11606,108,59682,191,71288,California
Shasta,2021-08-04,297,125367,184,55773,76,63215,37,6379,192,11731,104,59786,229,71517,California
Shasta,2021-08-05,300,125667,177,55950,99,63314,24,6403,191,11842,104,59890,215,71732,California
Shasta,2021-08-06,385,126052,249,56199,111,63425,25,6428,250,11986,131,60021,275,72007,California
Shasta,2021-08-07,170,126222,116,56315,53,63478,1,6429,119,12057,49,60070,120,72127,California
Shasta,2021-08-08,119,126341,80,56395,34,63512,5,6434,82,12108,36,60106,87,72214,California
Shasta,2021-08-09,278,126619,152,56547,95,63607,31,6465,174,12210,102,60208,204,72418,California
Shasta,2021-08-10,312,126931,186,56733,101,63708,25,6490,181,12291,123,60331,204,72622,California
Shasta,2021-08-11,277,127208,169,56902,79,63787,29,6519,166,12376,110,60441,195,72817,California
Shasta,2021-08-12,395,127603,202,57104,165,63952,28,6547,250,12511,142,60583,277,73094,California
Shasta,2021-08-13,448,128051,271,57375,131,64083,46,6593,281,12680,157,60740,326,73420,California
Shasta,2021-08-14,233,128284,143,57518,86,64169,4,6597,151,12761,74,60814,155,73575,California
Shasta,2021-08-15,125,128409,76,57594,45,64214,4,6601,75,12799,41,60855,79,73654,California
Shasta,2021-08-16,372,128781,151,57745,167,64381,54,6655,187,12884,155,61010,240,73894,California
Shasta,2021-08-17,344,129125,178,57923,144,64525,22,6677,188,12965,128,61138,209,74103,California
Shasta,2021-08-18,282,129407,155,58078,103,64628,24,6701,150,13029,109,61247,173,74276,California
Shasta,2021-08-19,353,129760,216,58294,125,64753,12,6713,179,13074,146,61393,191,74467,California
Shasta,2021-08-20,487,130247,297,58591,169,64922,21,6734,262,13155,202,61595,283,74750,California
Shasta,2021-08-21,206,130453,115,58706,90,65012,1,6735,112,13182,86,61681,113,74863,California
Shasta,2021-08-22,147,130600,95,58801,52,65064,0,6735,94,13231,45,61726,94,74957,California
Shasta,2021-08-23,439,131039,236,59037,146,65210,57,6792,214,13304,198,61924,271,75228,California
Shasta,2021-08-24,423,131462,254,59291,115,65325,54,6846,212,13375,192,62116,263,75491,California
Shasta,2021-08-25,415,131877,280,59571,117,65442,18,6864,213,13422,183,62299,230,75721,California
Shasta,2021-08-26,411,132288,295,59866,94,65536,22,6886,224,13505,163,62462,246,75967,California
Shasta,2021-08-27,563,132851,391,60257,139,65675,33,6919,288,13581,243,62705,319,76286,California
Shasta,2021-08-28,225,133076,140,60397,85,65760,0,6919,106,13573,114,62819,106,76392,California
Shasta,2021-08-29,174,133250,122,60519,52,65812,0,6919,90,13588,75,62894,90,76482,California
Shasta,2021-08-30,194,133444,119,60638,48,65860,27,6946,85,13603,97,62991,112,76594,California
Sierra,2020-12-18,1,1,1,1,0,0,0,0,1,1,0,0,1,1,California
Sierra,2020-12-21,2,3,2,3,0,0,0,0,2,3,0,0,2,3,California
Sierra,2020-12-22,12,15,12,15,0,0,0,0,12,15,0,0,12,15,California
Sierra,2020-12-23,4,19,4,19,0,0,0,0,4,19,0,0,4,19,California
Sierra,2020-12-28,1,20,0,19,1,1,0,0,1,20,0,0,1,20,California
Sierra,2020-12-29,49,69,7,26,42,43,0,0,49,69,0,0,49,69,California
Sierra,2020-12-30,2,71,0,26,2,45,0,0,2,71,0,0,2,71,California
Sierra,2020-12-31,13,84,0,26,13,58,0,0,13,84,0,0,13,84,California
Sierra,2021-01-01,1,85,1,27,0,58,0,0,1,85,0,0,1,85,California
Sierra,2021-01-05,65,150,3,30,62,120,0,0,65,150,0,0,65,150,California
Sierra,2021-01-06,1,151,1,31,0,120,0,0,1,151,0,0,1,151,California
Sierra,2021-01-07,20,171,1,32,19,139,0,0,19,169,1,1,19,170,California
Sierra,2021-01-11,3,174,3,35,0,139,0,0,0,166,3,4,0,170,California
Sierra,2021-01-12,38,212,12,47,26,165,0,0,26,180,12,16,26,196,California
Sierra,2021-01-13,3,215,3,50,0,165,0,0,0,177,3,19,0,196,California
Sierra,2021-01-14,34,249,2,52,32,197,0,0,34,211,0,19,34,230,California
Sierra,2021-01-15,4,253,1,53,3,200,0,0,4,215,0,19,4,234,California
Sierra,2021-01-18,3,256,0,53,3,203,0,0,3,218,0,19,3,237,California
Sierra,2021-01-19,33,289,0,53,33,236,0,0,33,251,0,19,33,270,California
Sierra,2021-01-20,2,291,1,54,1,237,0,0,1,251,1,20,1,271,California
Sierra,2021-01-21,53,344,0,54,53,290,0,0,52,303,1,21,53,324,California
Sierra,2021-01-22,2,346,0,54,2,292,0,0,2,305,0,21,2,326,California
Sierra,2021-01-23,2,348,0,54,2,294,0,0,2,307,0,21,2,328,California
Sierra,2021-01-25,1,349,1,55,0,294,0,0,1,308,0,21,1,329,California
Sierra,2021-01-26,62,411,2,57,60,354,0,0,23,292,39,60,23,352,California
Sierra,2021-01-27,4,415,4,61,0,354,0,0,0,288,4,64,0,352,California
Sierra,2021-01-28,53,468,0,61,53,407,0,0,43,321,10,74,43,395,California
Sierra,2021-01-29,1,469,0,61,1,408,0,0,1,322,0,74,1,396,California
Sierra,2021-01-30,2,471,2,63,0,408,0,0,2,324,0,74,2,398,California
Sierra,2021-02-01,1,472,0,63,1,409,0,0,0,323,1,75,0,398,California
Sierra,2021-02-02,60,532,0,63,60,469,0,0,21,305,39,114,21,419,California
Sierra,2021-02-03,5,537,5,68,0,469,0,0,5,310,0,114,5,424,California
Sierra,2021-02-04,100,637,2,70,98,567,0,0,51,313,48,162,51,475,California
Sierra,2021-02-05,3,640,1,71,2,569,0,0,2,314,1,163,2,477,California
Sierra,2021-02-09,54,694,0,71,54,623,0,0,50,360,4,167,50,527,California
Sierra,2021-02-10,4,698,1,72,3,626,0,0,2,360,2,169,2,529,California
Sierra,2021-02-11,193,891,1,73,192,818,0,0,133,433,60,229,133,662,California
Sierra,2021-02-12,20,911,0,73,20,838,0,0,20,453,0,229,20,682,California
Sierra,2021-02-15,3,914,2,75,1,839,0,0,0,450,3,232,0,682,California
Sierra,2021-02-16,45,959,1,76,44,883,0,0,10,425,35,267,10,692,California
Sierra,2021-02-17,4,963,0,76,4,887,0,0,1,423,3,270,1,693,California
Sierra,2021-02-18,142,1105,0,76,142,1029,0,0,92,466,49,319,92,785,California
Sierra,2021-02-19,1,1106,0,76,1,1030,0,0,0,465,1,320,0,785,California
Sierra,2021-02-20,4,1110,2,78,2,1032,0,0,1,464,2,322,1,786,California
Sierra,2021-02-23,5,1115,0,78,5,1037,0,0,5,469,0,322,5,791,California
Sierra,2021-02-24,1,1116,0,78,1,1038,0,0,1,470,0,322,1,792,California
Sierra,2021-02-25,122,1238,0,78,122,1160,0,0,59,467,62,384,59,851,California
Sierra,2021-02-26,10,1248,5,83,5,1165,0,0,3,463,7,391,3,854,California
Sierra,2021-03-02,59,1307,0,83,59,1224,0,0,39,482,20,411,39,893,California
Sierra,2021-03-04,108,1415,0,83,108,1332,0,0,59,492,49,460,59,952,California
Sierra,2021-03-05,12,1427,0,83,12,1344,0,0,10,500,2,462,10,962,California
Sierra,2021-03-08,1,1428,1,84,0,1344,0,0,1,501,0,462,1,963,California
Sierra,2021-03-09,57,1485,0,84,57,1401,0,0,11,466,46,508,11,974,California
Sierra,2021-03-10,6,1491,0,84,6,1407,0,0,4,468,2,510,4,978,California
Sierra,2021-03-11,173,1664,1,85,172,1579,0,0,42,379,131,641,42,1020,California
Sierra,2021-03-12,19,1683,0,85,19,1598,0,0,0,360,19,660,0,1020,California
Sierra,2021-03-13,27,1710,0,85,27,1625,0,0,27,387,0,660,27,1047,California
Sierra,2021-03-15,2,1712,0,85,0,1625,2,2,0,387,2,662,2,1049,California
Sierra,2021-03-16,35,1747,0,85,34,1659,1,3,20,393,15,677,21,1070,California
Sierra,2021-03-17,1,1748,0,85,1,1660,0,3,0,392,1,678,0,1070,California
Sierra,2021-03-18,161,1909,0,85,161,1821,0,3,66,364,94,772,66,1136,California
Sierra,2021-03-19,2,1911,0,85,2,1823,0,3,0,362,2,774,0,1136,California
Sierra,2021-03-20,2,1913,0,85,2,1825,0,3,1,362,1,775,1,1137,California
Sierra,2021-03-23,23,1936,0,85,23,1848,0,3,13,365,10,785,13,1150,California
Sierra,2021-03-24,2,1938,0,85,2,1850,0,3,1,365,1,786,1,1151,California
Sierra,2021-03-25,99,2037,1,86,98,1948,0,3,49,365,49,835,49,1200,California
Sierra,2021-03-26,11,2048,0,86,11,1959,0,3,8,370,3,838,8,1208,California
Sierra,2021-03-27,1,2049,0,86,1,1960,0,3,0,369,1,839,0,1208,California
Sierra,2021-03-29,1,2050,1,87,0,1960,0,3,0,368,1,840,0,1208,California
Sierra,2021-03-30,58,2108,0,87,58,2018,0,3,25,360,33,873,25,1233,California
Sierra,2021-03-31,8,2116,0,87,8,2026,0,3,8,368,0,873,8,1241,California
Sierra,2021-04-01,65,2181,1,88,64,2090,0,3,5,318,55,928,5,1246,California
Sierra,2021-04-02,2,2183,1,89,1,2091,0,3,2,320,0,928,2,1248,California
Sierra,2021-04-04,1,2184,0,89,1,2092,0,3,0,320,0,928,0,1248,California
Sierra,2021-04-06,11,2195,0,89,11,2103,0,3,1,311,10,938,1,1249,California
Sierra,2021-04-07,12,2207,1,90,6,2109,5,8,1,307,10,948,6,1255,California
Sierra,2021-04-08,52,2259,2,92,50,2159,0,8,17,289,35,983,17,1272,California
Sierra,2021-04-09,1,2260,1,93,0,2159,0,8,1,290,0,983,1,1273,California
Sierra,2021-04-10,27,2287,0,93,27,2186,0,8,0,263,27,1010,0,1273,California
Sierra,2021-04-12,1,2288,0,93,0,2186,1,9,0,263,1,1011,1,1274,California
Sierra,2021-04-13,44,2332,0,93,44,2230,0,9,5,229,39,1050,5,1279,California
Sierra,2021-04-14,1,2333,0,93,1,2231,0,9,1,230,0,1050,1,1280,California
Sierra,2021-04-15,51,2384,2,95,49,2280,0,9,2,184,48,1098,2,1282,California
Sierra,2021-04-17,2,2386,1,96,1,2281,0,9,1,184,1,1099,1,1283,California
Sierra,2021-04-18,1,2387,0,96,1,2282,0,9,0,184,0,1099,0,1283,California
Sierra,2021-04-19,1,2388,0,96,1,2283,0,9,1,185,0,1099,1,1284,California
Sierra,2021-04-20,33,2421,2,98,31,2314,0,9,5,162,28,1127,5,1289,California
Sierra,2021-04-21,2,2423,1,99,1,2315,0,9,1,162,1,1128,1,1290,California
Sierra,2021-04-22,63,2486,1,100,62,2377,0,9,5,110,57,1185,5,1295,California
Sierra,2021-04-23,12,2498,0,100,12,2389,0,9,3,104,9,1194,3,1298,California
Sierra,2021-04-24,4,2502,0,100,4,2393,0,9,4,108,0,1194,4,1302,California
Sierra,2021-04-26,1,2503,0,100,1,2394,0,9,1,109,0,1194,1,1303,California
Sierra,2021-04-27,29,2532,0,100,29,2423,0,9,3,86,26,1220,3,1306,California
Sierra,2021-04-28,10,2542,2,102,8,2431,0,9,2,80,8,1228,2,1308,California
Sierra,2021-04-29,21,2563,2,104,19,2450,0,9,14,88,6,1234,14,1322,California
Sierra,2021-04-30,3,2566,1,105,2,2452,0,9,1,87,2,1236,1,1323,California
Sierra,2021-05-01,1,2567,0,105,1,2453,0,9,0,87,0,1236,0,1323,California
Sierra,2021-05-03,1,2568,1,106,0,2453,0,9,1,88,0,1236,1,1324,California
Sierra,2021-05-04,3,2571,1,107,1,2454,1,10,1,88,2,1238,2,1326,California
Sierra,2021-05-05,24,2595,1,108,23,2477,0,10,8,81,15,1253,8,1334,California
Sierra,2021-05-06,2,2597,1,109,1,2478,0,10,0,79,2,1255,0,1334,California
Sierra,2021-05-08,1,2598,0,109,0,2478,1,11,0,79,1,1256,1,1335,California
Sierra,2021-05-11,12,2610,0,109,4,2482,8,19,0,75,12,1268,8,1343,California
Sierra,2021-05-12,12,2622,1,110,11,2493,0,19,9,81,3,1271,9,1352,California
Sierra,2021-05-13,2,2624,1,111,1,2494,0,19,1,81,1,1272,1,1353,California
Sierra,2021-05-14,3,2627,1,112,2,2496,0,19,3,84,0,1272,3,1356,California
Sierra,2021-05-15,1,2628,0,112,0,2496,1,20,0,84,1,1273,1,1357,California
Sierra,2021-05-17,1,2629,1,113,0,2496,0,20,1,85,0,1273,1,1358,California
Sierra,2021-05-18,1,2630,0,113,0,2496,1,21,0,85,1,1274,1,1359,California
Sierra,2021-05-19,7,2637,3,116,4,2500,0,21,2,82,5,1279,2,1361,California
Sierra,2021-05-20,9,2646,8,124,0,2500,1,22,8,90,1,1280,9,1370,California
Sierra,2021-05-21,3,2649,1,125,2,2502,0,22,1,89,2,1282,1,1371,California
Sierra,2021-05-22,5,2654,0,125,5,2507,0,22,1,86,4,1286,1,1372,California
Sierra,2021-05-24,4,2658,1,126,3,2510,0,22,2,87,2,1288,3,1375,California
Sierra,2021-05-25,3,2661,1,127,2,2512,0,22,1,86,2,1290,1,1376,California
Sierra,2021-05-26,9,2670,0,127,9,2521,0,22,4,85,5,1295,4,1380,California
Sierra,2021-05-27,8,2678,1,128,6,2527,1,23,2,82,6,1301,3,1383,California
Sierra,2021-05-28,3,2681,1,129,2,2529,0,23,2,83,1,1302,2,1385,California
Sierra,2021-05-29,2,2683,0,129,2,2531,0,23,2,85,0,1302,2,1387,California
Sierra,2021-05-30,1,2684,1,130,0,2531,0,23,1,86,0,1302,1,1388,California
Sierra,2021-06-01,1,2685,0,130,1,2532,0,23,0,85,1,1303,0,1388,California
Sierra,2021-06-02,23,2708,0,130,21,2553,2,25,0,65,22,1325,2,1390,California
Sierra,2021-06-03,3,2711,1,131,2,2555,0,25,0,62,3,1328,0,1390,California
Sierra,2021-06-04,2,2713,2,133,0,2555,0,25,1,62,1,1329,1,1391,California
Sierra,2021-06-08,1,2714,1,134,0,2555,0,25,1,63,0,1329,1,1392,California
Sierra,2021-06-09,9,2723,1,135,6,2561,2,27,0,56,9,1338,2,1394,California
Sierra,2021-06-10,9,2732,9,144,0,2561,0,27,5,57,4,1342,5,1399,California
Sierra,2021-06-11,4,2736,1,145,3,2564,0,27,1,55,3,1345,1,1400,California
Sierra,2021-06-12,1,2737,1,146,0,2564,0,27,1,56,0,1345,1,1401,California
Sierra,2021-06-14,7,2744,5,151,1,2565,1,28,3,56,4,1349,4,1405,California
Sierra,2021-06-15,1,2745,0,151,1,2566,0,28,0,56,0,1349,0,1405,California
Sierra,2021-06-16,7,2752,1,152,6,2572,0,28,3,55,4,1353,3,1408,California
Sierra,2021-06-17,5,2757,2,154,1,2573,2,30,2,56,3,1356,4,1412,California
Sierra,2021-06-18,2,2759,1,155,0,2573,1,31,0,55,2,1358,1,1413,California
Sierra,2021-06-21,1,2760,0,155,1,2574,0,31,0,54,1,1359,0,1413,California
Sierra,2021-06-22,4,2764,2,157,2,2576,0,31,2,54,2,1361,2,1415,California
Sierra,2021-06-23,7,2771,0,157,7,2583,0,31,3,53,4,1365,3,1418,California
Sierra,2021-06-24,5,2776,0,157,2,2585,3,34,1,53,4,1369,4,1422,California
Sierra,2021-06-26,1,2777,1,158,0,2585,0,34,1,54,0,1369,1,1423,California
Sierra,2021-06-27,1,2778,1,159,0,2585,0,34,1,55,0,1369,1,1424,California
Sierra,2021-06-28,1,2779,0,159,0,2585,1,35,0,55,1,1370,1,1425,California
Sierra,2021-06-30,3,2782,2,161,0,2585,1,36,1,55,2,1372,2,1427,California
Sierra,2021-07-01,4,2786,2,163,2,2587,0,36,2,55,2,1374,2,1429,California
Sierra,2021-07-02,1,2787,1,164,0,2587,0,36,0,54,1,1375,0,1429,California
Sierra,2021-07-03,1,2788,1,165,0,2587,0,36,0,53,1,1376,0,1429,California
Sierra,2021-07-07,6,2794,6,171,0,2587,0,36,2,51,4,1380,2,1431,California
Sierra,2021-07-08,2,2796,1,172,1,2588,0,36,1,51,1,1381,1,1432,California
Sierra,2021-07-09,2,2798,2,174,0,2588,0,36,2,53,0,1381,2,1434,California
Sierra,2021-07-12,2,2800,1,175,1,2589,0,36,1,53,1,1382,1,1435,California
Sierra,2021-07-13,1,2801,1,176,0,2589,0,36,0,52,1,1383,0,1435,California
Sierra,2021-07-14,5,2806,2,178,2,2591,1,37,1,50,3,1386,1,1436,California
Sierra,2021-07-15,4,2810,1,179,2,2593,1,38,2,52,2,1388,4,1440,California
Sierra,2021-07-16,1,2811,1,180,0,2593,0,38,1,53,0,1388,1,1441,California
Sierra,2021-07-18,3,2814,3,183,0,2593,0,38,2,54,1,1389,2,1443,California
Sierra,2021-07-21,1,2815,1,184,0,2593,0,38,0,53,1,1390,0,1443,California
Sierra,2021-07-22,10,2825,5,189,5,2598,0,38,9,61,1,1391,9,1452,California
Sierra,2021-07-23,3,2828,0,189,3,2601,0,38,0,58,3,1394,0,1452,California
Sierra,2021-07-26,2,2830,2,191,0,2601,0,38,1,58,1,1395,1,1453,California
Sierra,2021-07-27,1,2831,0,191,1,2602,0,38,0,58,0,1395,0,1453,California
Sierra,2021-07-29,5,2836,1,192,4,2606,0,38,3,59,2,1397,3,1456,California
Sierra,2021-07-30,3,2839,3,195,0,2606,0,38,1,58,2,1399,1,1457,California
Sierra,2021-08-02,2,2841,1,196,0,2606,1,39,1,59,1,1400,2,1459,California
Sierra,2021-08-03,3,2844,1,197,1,2607,1,40,2,61,1,1401,3,1462,California
Sierra,2021-08-04,2,2846,2,199,0,2607,0,40,2,63,0,1401,2,1464,California
Sierra,2021-08-05,12,2858,8,207,2,2609,2,42,8,69,4,1405,10,1474,California
Sierra,2021-08-06,1,2859,1,208,0,2609,0,42,1,70,0,1405,1,1475,California
Sierra,2021-08-09,5,2864,4,212,0,2609,1,43,2,70,3,1408,3,1478,California
Sierra,2021-08-10,4,2868,4,216,0,2609,0,43,3,72,1,1409,3,1481,California
Sierra,2021-08-11,1,2869,0,216,0,2609,1,44,0,72,1,1410,1,1482,California
Sierra,2021-08-12,6,2875,4,220,2,2611,0,44,3,72,3,1413,3,1485,California
Sierra,2021-08-16,1,2876,1,221,0,2611,0,44,1,73,0,1413,1,1486,California
Sierra,2021-08-17,4,2880,3,224,0,2611,1,45,3,76,1,1414,4,1490,California
Sierra,2021-08-18,5,2885,3,227,2,2613,0,45,3,78,1,1415,3,1493,California
Sierra,2021-08-19,8,2893,3,230,5,2618,0,45,4,78,4,1419,4,1497,California
Sierra,2021-08-20,6,2899,4,234,1,2619,1,46,3,79,3,1422,4,1501,California
Sierra,2021-08-23,8,2907,7,241,0,2619,1,47,4,80,4,1426,5,1506,California
Sierra,2021-08-24,1,2908,1,242,0,2619,0,47,0,79,1,1427,0,1506,California
Sierra,2021-08-25,11,2919,9,251,2,2621,0,47,10,88,1,1428,10,1516,California
Sierra,2021-08-26,17,2936,11,262,5,2626,1,48,6,85,11,1439,8,1524,California
Sierra,2021-08-27,4,2940,2,264,1,2627,1,49,2,86,2,1441,3,1527,California
Sierra,2021-08-30,3,2943,2,266,0,2627,1,50,1,86,2,1443,2,1529,California
Siskiyou,2020-12-16,2,2,2,2,0,0,0,0,2,2,0,0,2,2,California
Siskiyou,2020-12-17,4,6,4,6,0,0,0,0,4,6,0,0,4,6,California
Siskiyou,2020-12-18,2,8,2,8,0,0,0,0,2,8,0,0,2,8,California
Siskiyou,2020-12-19,4,12,4,12,0,0,0,0,4,12,0,0,4,12,California
Siskiyou,2020-12-20,1,13,1,13,0,0,0,0,1,13,0,0,1,13,California
Siskiyou,2020-12-21,133,146,133,146,0,0,0,0,133,146,0,0,133,146,California
Siskiyou,2020-12-22,159,305,159,305,0,0,0,0,159,305,0,0,159,305,California
Siskiyou,2020-12-23,143,448,143,448,0,0,0,0,143,448,0,0,143,448,California
Siskiyou,2020-12-24,6,454,5,453,1,1,0,0,6,454,0,0,6,454,California
Siskiyou,2020-12-26,2,456,0,453,2,3,0,0,2,456,0,0,2,456,California
Siskiyou,2020-12-27,2,458,0,453,2,5,0,0,2,458,0,0,2,458,California
Siskiyou,2020-12-28,5,463,3,456,2,7,0,0,5,463,0,0,5,463,California
Siskiyou,2020-12-29,11,474,3,459,8,15,0,0,11,474,0,0,11,474,California
Siskiyou,2020-12-30,106,580,6,465,100,115,0,0,106,580,0,0,106,580,California
Siskiyou,2020-12-31,12,592,0,465,12,127,0,0,12,592,0,0,12,592,California
Siskiyou,2021-01-02,1,593,1,466,0,127,0,0,1,593,0,0,1,593,California
Siskiyou,2021-01-03,1,594,0,466,1,128,0,0,1,594,0,0,1,594,California
Siskiyou,2021-01-04,160,754,3,469,157,285,0,0,160,754,0,0,160,754,California
Siskiyou,2021-01-05,91,845,4,473,87,372,0,0,90,843,1,1,90,844,California
Siskiyou,2021-01-06,63,908,7,480,56,428,0,0,59,898,4,5,59,903,California
Siskiyou,2021-01-07,179,1087,4,484,175,603,0,0,178,1075,1,6,178,1081,California
Siskiyou,2021-01-08,177,1264,3,487,174,777,0,0,175,1248,2,8,175,1256,California
Siskiyou,2021-01-09,3,1267,3,490,0,777,0,0,1,1247,2,10,1,1257,California
Siskiyou,2021-01-11,161,1428,140,630,21,798,0,0,23,1132,138,148,23,1280,California
Siskiyou,2021-01-12,247,1675,197,827,50,848,0,0,90,1066,157,305,91,1371,California
Siskiyou,2021-01-13,164,1839,143,970,21,869,0,0,23,948,141,446,23,1394,California
Siskiyou,2021-01-14,35,1874,1,971,34,903,0,0,34,981,1,447,34,1428,California
Siskiyou,2021-01-15,57,1931,3,974,54,957,0,0,57,1038,0,447,57,1485,California
Siskiyou,2021-01-16,5,1936,2,976,3,960,0,0,5,1043,0,447,5,1490,California
Siskiyou,2021-01-17,1,1937,1,977,0,960,0,0,0,1042,1,448,0,1490,California
Siskiyou,2021-01-18,82,2019,3,980,79,1039,0,0,80,1120,2,450,80,1570,California
Siskiyou,2021-01-19,35,2054,1,981,34,1073,0,0,34,1153,1,451,34,1604,California
Siskiyou,2021-01-20,70,2124,37,1018,33,1106,0,0,64,1211,6,457,64,1668,California
Siskiyou,2021-01-21,69,2193,2,1020,67,1173,0,0,68,1278,1,458,68,1736,California
Siskiyou,2021-01-22,1338,3531,1171,2191,167,1340,0,0,1338,2616,0,458,1338,3074,California
Siskiyou,2021-01-23,6,3537,2,2193,4,1344,0,0,3,2616,3,461,3,3077,California
Siskiyou,2021-01-25,212,3749,11,2204,201,1545,0,0,207,2818,5,466,207,3284,California
Siskiyou,2021-01-26,100,3849,3,2207,97,1642,0,0,91,2900,9,475,91,3375,California
Siskiyou,2021-01-27,201,4050,4,2211,197,1839,0,0,133,2966,67,542,133,3508,California
Siskiyou,2021-01-28,292,4342,116,2327,176,2015,0,0,268,3215,19,561,268,3776,California
Siskiyou,2021-01-29,249,4591,5,2332,244,2259,0,0,231,3428,18,579,231,4007,California
Siskiyou,2021-01-30,5,4596,4,2336,1,2260,0,0,5,3433,0,579,5,4012,California
Siskiyou,2021-01-31,1,4597,1,2337,0,2260,0,0,1,3434,0,579,1,4013,California
Siskiyou,2021-02-01,270,4867,3,2340,267,2527,0,0,115,3394,155,734,115,4128,California
Siskiyou,2021-02-02,273,5140,45,2385,228,2755,0,0,155,3431,118,852,155,4283,California
Siskiyou,2021-02-03,321,5461,1,2386,320,3075,0,0,266,3642,55,907,266,4549,California
Siskiyou,2021-02-04,379,5840,7,2393,372,3447,0,0,223,3709,156,1063,223,4772,California
Siskiyou,2021-02-05,564,6404,4,2397,560,4007,0,0,376,3897,188,1251,376,5148,California
Siskiyou,2021-02-06,15,6419,0,2397,15,4022,0,0,15,3912,0,1251,15,5163,California
Siskiyou,2021-02-07,2,6421,1,2398,1,4023,0,0,2,3914,0,1251,2,5165,California
Siskiyou,2021-02-08,237,6658,4,2402,233,4256,0,0,211,4099,26,1277,211,5376,California
Siskiyou,2021-02-09,209,6867,2,2404,207,4463,0,0,178,4246,31,1308,178,5554,California
Siskiyou,2021-02-10,387,7254,41,2445,346,4809,0,0,318,4496,68,1376,318,5872,California
Siskiyou,2021-02-11,215,7469,2,2447,213,5022,0,0,185,4651,30,1406,185,6057,California
Siskiyou,2021-02-12,1698,9167,1196,3643,502,5524,0,0,496,3945,1202,2608,496,6553,California
Siskiyou,2021-02-13,37,9204,2,3645,35,5559,0,0,33,3974,4,2612,33,6586,California
Siskiyou,2021-02-14,6,9210,2,3647,4,5563,0,0,6,3980,0,2612,6,6592,California
Siskiyou,2021-02-15,104,9314,4,3651,100,5663,0,0,98,4072,6,2618,98,6690,California
Siskiyou,2021-02-16,141,9455,3,3654,138,5801,0,0,103,4137,38,2656,103,6793,California
Siskiyou,2021-02-17,285,9740,4,3658,281,6082,0,0,248,4348,37,2693,248,7041,California
Siskiyou,2021-02-18,278,10018,93,3751,185,6267,0,0,129,4328,149,2842,129,7170,California
Siskiyou,2021-02-19,98,10116,34,3785,64,6331,0,0,36,4304,60,2902,36,7206,California
Siskiyou,2021-02-20,23,10139,4,3789,19,6350,0,0,17,4317,6,2908,19,7225,California
Siskiyou,2021-02-21,2,10141,2,3791,0,6350,0,0,1,4317,1,2909,1,7226,California
Siskiyou,2021-02-22,220,10361,2,3793,218,6568,0,0,79,4255,141,3050,79,7305,California
Siskiyou,2021-02-23,270,10631,14,3807,256,6824,0,0,180,4345,90,3140,180,7485,California
Siskiyou,2021-02-24,177,10808,5,3812,172,6996,0,0,52,4272,125,3265,52,7537,California
Siskiyou,2021-02-25,310,11118,17,3829,293,7289,0,0,141,4245,168,3433,141,7678,California
Siskiyou,2021-02-26,681,11799,7,3836,674,7963,0,0,369,4302,312,3745,369,8047,California
Siskiyou,2021-02-27,31,11830,6,3842,25,7988,0,0,27,4325,4,3749,27,8074,California
Siskiyou,2021-02-28,3,11833,3,3845,0,7988,0,0,2,4326,1,3750,2,8076,California
Siskiyou,2021-03-01,303,12136,6,3851,297,8285,0,0,54,4131,249,3999,54,8130,California
Siskiyou,2021-03-02,209,12345,1,3852,208,8493,0,0,72,4066,137,4136,72,8202,California
Siskiyou,2021-03-03,357,12702,12,3864,345,8838,0,0,157,4023,200,4336,157,8359,California
Siskiyou,2021-03-04,840,13542,621,4485,219,9057,0,0,641,4465,199,4535,641,9000,California
Siskiyou,2021-03-05,356,13898,5,4490,340,9397,11,11,111,4345,242,4777,122,9122,California
Siskiyou,2021-03-06,42,13940,3,4493,32,9429,7,18,27,4364,15,4792,34,9156,California
Siskiyou,2021-03-07,12,13952,3,4496,1,9430,8,26,2,4364,10,4802,10,9166,California
Siskiyou,2021-03-08,432,14384,21,4517,378,9808,33,59,72,4109,360,5162,105,9271,California
Siskiyou,2021-03-09,248,14632,2,4519,191,9999,55,114,43,4002,205,5367,98,9369,California
Siskiyou,2021-03-10,295,14927,7,4526,259,10258,29,143,25,3786,270,5637,54,9423,California
Siskiyou,2021-03-11,520,15447,205,4731,269,10527,46,189,282,3880,234,5871,328,9751,California
Siskiyou,2021-03-12,705,16152,148,4879,519,11046,38,227,193,3600,510,6381,230,9981,California
Siskiyou,2021-03-13,427,16579,376,5255,28,11074,23,250,377,3950,50,6431,400,10381,California
Siskiyou,2021-03-14,19,16598,0,5255,3,11077,16,266,2,3950,17,6448,17,10398,California
Siskiyou,2021-03-15,512,17110,256,5511,192,11269,64,330,334,4170,178,6626,398,10796,California
Siskiyou,2021-03-16,252,17362,27,5538,209,11478,16,346,133,4201,118,6744,149,10945,California
Siskiyou,2021-03-17,204,17566,10,5548,185,11663,9,355,36,4078,168,6912,45,10990,California
Siskiyou,2021-03-18,922,18488,783,6331,127,11790,12,367,802,4773,119,7031,814,11804,California
Siskiyou,2021-03-19,65,18553,5,6336,47,11837,13,380,18,4757,47,7078,31,11835,California
Siskiyou,2021-03-20,29,18582,7,6343,18,11855,4,384,5,4742,24,7102,9,11844,California
Siskiyou,2021-03-21,8,18590,2,6345,1,11856,5,389,3,4745,5,7107,8,11852,California
Siskiyou,2021-03-22,209,18799,19,6364,168,12024,22,411,142,4845,64,7171,164,12016,California
Siskiyou,2021-03-23,161,18960,18,6382,135,12159,8,419,119,4930,42,7213,127,12143,California
Siskiyou,2021-03-24,149,19109,49,6431,100,12259,0,419,116,5013,33,7246,116,12259,California
Siskiyou,2021-03-25,562,19671,310,6741,249,12508,3,422,389,5232,173,7419,392,12651,California
Siskiyou,2021-03-26,313,19984,34,6775,279,12787,0,422,103,5127,208,7627,103,12754,California
Siskiyou,2021-03-27,37,20021,6,6781,26,12813,5,427,10,5115,27,7654,15,12769,California
Siskiyou,2021-03-28,7,20028,6,6787,1,12814,0,427,5,5118,2,7656,5,12774,California
Siskiyou,2021-03-29,93,20121,10,6797,81,12895,2,429,43,5113,50,7706,45,12819,California
Siskiyou,2021-03-30,103,20224,7,6804,95,12990,1,430,39,5090,64,7770,41,12860,California
Siskiyou,2021-03-31,176,20400,9,6813,164,13154,3,433,43,5007,130,7900,47,12907,California
Siskiyou,2021-04-01,823,21223,665,7478,158,13312,0,433,206,4596,617,8517,206,13113,California
Siskiyou,2021-04-02,349,21572,197,7675,148,13460,4,437,63,4379,284,8801,67,13180,California
Siskiyou,2021-04-03,27,21599,5,7680,15,13475,7,444,5,4369,22,8823,12,13192,California
Siskiyou,2021-04-04,2,21601,0,7680,2,13477,0,444,1,4369,1,8824,1,13193,California
Siskiyou,2021-04-05,436,22037,331,8011,79,13556,26,470,25,4011,409,9233,51,13244,California
Siskiyou,2021-04-06,223,22260,36,8047,134,13690,53,523,128,4098,93,9326,180,13424,California
Siskiyou,2021-04-07,117,22377,12,8059,64,13754,41,564,64,4151,53,9379,106,13530,California
Siskiyou,2021-04-08,346,22723,173,8232,129,13883,44,608,65,3979,281,9660,109,13639,California
Siskiyou,2021-04-09,549,23272,377,8609,134,14017,38,646,86,3642,462,10122,125,13764,California
Siskiyou,2021-04-10,43,23315,5,8614,2,14019,36,682,5,3645,38,10160,41,13805,California
Siskiyou,2021-04-11,5,23320,3,8617,1,14020,1,683,1,3643,4,10164,2,13807,California
Siskiyou,2021-04-12,128,23448,21,8638,105,14125,2,685,30,3577,98,10262,32,13839,California
Siskiyou,2021-04-13,204,23652,37,8675,167,14292,0,685,82,3537,122,10384,82,13921,California
Siskiyou,2021-04-14,159,23811,64,8739,95,14387,0,685,87,3554,70,10454,87,14008,California
Siskiyou,2021-04-15,1113,24924,953,9692,160,14547,0,685,436,3314,677,11131,437,14445,California
Siskiyou,2021-04-16,310,25234,217,9909,92,14639,1,686,268,3543,39,11170,268,14713,California
Siskiyou,2021-04-17,11,25245,8,9917,3,14642,0,686,6,3544,5,11175,6,14719,California
Siskiyou,2021-04-18,6,25251,3,9920,3,14645,0,686,2,3542,4,11179,2,14721,California
Siskiyou,2021-04-19,130,25381,24,9944,106,14751,0,686,47,3506,83,11262,47,14768,California
Siskiyou,2021-04-20,207,25588,5,9949,202,14953,0,686,86,3472,120,11382,86,14854,California
Siskiyou,2021-04-21,96,25684,11,9960,85,15038,0,686,26,3428,70,11452,26,14880,California
Siskiyou,2021-04-22,407,26091,297,10257,110,15148,0,686,47,3115,360,11812,47,14927,California
Siskiyou,2021-04-23,185,26276,15,10272,170,15318,0,686,160,3251,24,11836,160,15087,California
Siskiyou,2021-04-24,26,26302,4,10276,22,15340,0,686,19,3263,7,11843,19,15106,California
Siskiyou,2021-04-25,2,26304,0,10276,2,15342,0,686,2,3265,0,11843,2,15108,California
Siskiyou,2021-04-26,99,26403,4,10280,90,15432,5,691,24,3219,75,11918,29,15137,California
Siskiyou,2021-04-27,116,26519,5,10285,109,15541,2,693,87,3281,27,11945,89,15226,California
Siskiyou,2021-04-28,111,26630,8,10293,95,15636,8,701,54,3286,57,12002,62,15288,California
Siskiyou,2021-04-29,149,26779,17,10310,131,15767,1,702,31,3200,118,12120,32,15320,California
Siskiyou,2021-04-30,104,26883,23,10333,80,15847,1,703,45,3189,56,12176,45,15365,California
Siskiyou,2021-05-01,10,26893,6,10339,1,15848,3,706,6,3194,4,12180,9,15374,California
Siskiyou,2021-05-02,9,26902,3,10342,6,15854,0,706,8,3201,1,12181,8,15382,California
Siskiyou,2021-05-03,106,27008,23,10365,81,15935,2,708,43,3183,63,12244,45,15427,California
Siskiyou,2021-05-04,123,27131,7,10372,114,16049,2,710,61,3185,61,12305,63,15490,California
Siskiyou,2021-05-05,116,27247,19,10391,88,16137,9,719,39,3157,76,12381,48,15538,California
Siskiyou,2021-05-06,367,27614,296,10687,65,16202,6,725,190,3176,177,12558,196,15734,California
Siskiyou,2021-05-07,307,27921,218,10905,84,16286,5,730,31,2937,275,12833,36,15770,California
Siskiyou,2021-05-08,24,27945,3,10908,20,16306,1,731,19,2952,5,12838,20,15790,California
Siskiyou,2021-05-09,1,27946,0,10908,1,16307,0,731,0,2951,1,12839,0,15790,California
Siskiyou,2021-05-10,100,28046,68,10976,31,16338,1,732,24,2900,76,12915,25,15815,California
Siskiyou,2021-05-11,91,28137,9,10985,76,16414,6,738,52,2919,39,12954,58,15873,California
Siskiyou,2021-05-12,113,28250,5,10990,103,16517,5,743,17,2846,95,13049,22,15895,California
Siskiyou,2021-05-13,133,28383,36,11026,86,16603,11,754,39,2802,94,13143,50,15945,California
Siskiyou,2021-05-14,177,28560,83,11109,93,16696,1,755,108,2843,68,13211,109,16054,California
Siskiyou,2021-05-15,44,28604,14,11123,28,16724,2,757,37,2876,6,13217,39,16093,California
Siskiyou,2021-05-16,6,28610,2,11125,4,16728,0,757,4,2878,2,13219,4,16097,California
Siskiyou,2021-05-17,63,28673,2,11127,38,16766,23,780,12,2862,51,13270,35,16132,California
Siskiyou,2021-05-18,214,28887,82,11209,128,16894,4,784,123,2899,90,13360,127,16259,California
Siskiyou,2021-05-19,201,29088,98,11307,102,16996,1,785,167,3033,34,13394,168,16427,California
Siskiyou,2021-05-20,534,29622,430,11737,102,17098,2,787,239,2981,293,13687,241,16668,California
Siskiyou,2021-05-21,242,29864,96,11833,145,17243,1,788,110,2961,131,13818,111,16779,California
Siskiyou,2021-05-22,41,29905,19,11852,22,17265,0,788,27,2974,14,13832,27,16806,California
Siskiyou,2021-05-23,4,29909,3,11855,1,17266,0,788,2,2974,2,13834,2,16808,California
Siskiyou,2021-05-24,46,29955,5,11860,41,17307,0,788,31,2991,14,13848,31,16839,California
Siskiyou,2021-05-25,157,30112,15,11875,122,17429,20,808,52,2959,104,13952,72,16911,California
Siskiyou,2021-05-26,76,30188,19,11894,57,17486,0,808,41,2965,35,13987,41,16952,California
Siskiyou,2021-05-27,131,30319,93,11987,37,17523,1,809,55,2945,76,14063,56,17008,California
Siskiyou,2021-05-28,153,30472,59,12046,93,17616,1,810,102,2998,50,14113,103,17111,California
Siskiyou,2021-05-29,17,30489,9,12055,5,17621,3,813,6,2996,11,14124,9,17120,California
Siskiyou,2021-05-31,2,30491,1,12056,0,17621,1,814,1,2997,1,14125,2,17122,California
Siskiyou,2021-06-01,87,30578,20,12076,67,17688,0,814,28,2967,58,14183,28,17150,California
Siskiyou,2021-06-02,122,30700,35,12111,87,17775,0,814,47,2939,75,14258,47,17197,California
Siskiyou,2021-06-03,160,30860,113,12224,42,17817,5,819,40,2865,119,14377,45,17242,California
Siskiyou,2021-06-04,101,30961,77,12301,24,17841,0,819,22,2808,79,14456,22,17264,California
Siskiyou,2021-06-05,38,30999,19,12320,18,17859,1,820,13,2797,25,14481,14,17278,California
Siskiyou,2021-06-06,3,31002,2,12322,0,17859,1,821,0,2795,3,14484,1,17279,California
Siskiyou,2021-06-07,39,31041,4,12326,31,17890,4,825,27,2814,12,14496,31,17310,California
Siskiyou,2021-06-08,212,31253,92,12418,117,18007,3,828,67,2745,139,14635,70,17380,California
Siskiyou,2021-06-09,111,31364,82,12500,28,18035,1,829,28,2692,82,14717,29,17409,California
Siskiyou,2021-06-10,176,31540,144,12644,31,18066,1,830,76,2669,100,14817,77,17486,California
Siskiyou,2021-06-11,116,31656,61,12705,48,18114,7,837,24,2631,69,14886,31,17517,California
Siskiyou,2021-06-12,29,31685,6,12711,23,18137,0,837,9,2620,20,14906,9,17526,California
Siskiyou,2021-06-13,24,31709,16,12727,8,18145,0,837,2,2600,22,14928,2,17528,California
Siskiyou,2021-06-14,24,31733,4,12731,16,18161,4,841,11,2601,13,14941,14,17542,California
Siskiyou,2021-06-15,95,31828,28,12759,54,18215,13,854,36,2591,59,15000,49,17591,California
Siskiyou,2021-06-16,102,31930,23,12782,77,18292,2,856,10,2511,92,15092,12,17603,California
Siskiyou,2021-06-17,184,32114,139,12921,32,18324,13,869,40,2421,143,15235,53,17656,California
Siskiyou,2021-06-18,100,32214,65,12986,27,18351,8,877,22,2373,78,15313,30,17686,California
Siskiyou,2021-06-19,26,32240,17,13003,9,18360,0,877,12,2371,14,15327,12,17698,California
Siskiyou,2021-06-20,3,32243,2,13005,0,18360,1,878,2,2373,1,15328,3,17701,California
Siskiyou,2021-06-21,39,32282,4,13009,33,18393,2,880,6,2348,33,15361,8,17709,California
Siskiyou,2021-06-22,65,32347,24,13033,37,18430,4,884,30,2347,35,15396,34,17743,California
Siskiyou,2021-06-23,54,32401,7,13040,42,18472,5,889,11,2321,42,15438,16,17759,California
Siskiyou,2021-06-24,98,32499,58,13098,31,18503,9,898,46,2324,52,15490,55,17814,California
Siskiyou,2021-06-25,99,32598,63,13161,36,18539,0,898,67,2360,31,15521,67,17881,California
Siskiyou,2021-06-26,8,32606,3,13164,5,18544,0,898,4,2360,4,15525,4,17885,California
Siskiyou,2021-06-28,10,32616,4,13168,6,18550,0,898,5,2360,5,15530,5,17890,California
Siskiyou,2021-06-29,78,32694,54,13222,23,18573,1,899,42,2367,36,15566,43,17933,California
Siskiyou,2021-06-30,58,32752,10,13232,45,18618,3,902,14,2341,43,15609,17,17950,California
Siskiyou,2021-07-01,35,32787,23,13255,7,18625,5,907,13,2337,22,15631,18,17968,California
Siskiyou,2021-07-02,60,32847,37,13292,22,18647,1,908,41,2360,19,15650,42,18010,California
Siskiyou,2021-07-03,16,32863,5,13297,11,18658,0,908,8,2360,8,15658,8,18018,California
Siskiyou,2021-07-05,15,32878,5,13302,10,18668,0,908,4,2354,10,15668,4,18022,California
Siskiyou,2021-07-06,61,32939,15,13317,41,18709,5,913,17,2332,44,15712,22,18044,California
Siskiyou,2021-07-07,36,32975,10,13327,24,18733,2,915,12,2322,24,15736,14,18058,California
Siskiyou,2021-07-08,108,33083,73,13400,31,18764,4,919,42,2303,66,15802,47,18105,California
Siskiyou,2021-07-09,76,33159,48,13448,24,18788,4,923,54,2339,22,15824,58,18163,California
Siskiyou,2021-07-10,16,33175,6,13454,10,18798,0,923,7,2337,9,15833,7,18170,California
Siskiyou,2021-07-11,2,33177,0,13454,2,18800,0,923,2,2339,0,15833,2,18172,California
Siskiyou,2021-07-12,25,33202,11,13465,13,18813,1,924,4,2323,21,15854,5,18177,California
Siskiyou,2021-07-13,58,33260,26,13491,30,18843,2,926,25,2317,33,15887,27,18204,California
Siskiyou,2021-07-14,41,33301,12,13503,28,18871,1,927,16,2310,24,15911,17,18221,California
Siskiyou,2021-07-15,72,33373,48,13551,19,18890,5,932,38,2319,34,15945,43,18264,California
Siskiyou,2021-07-16,80,33453,62,13613,14,18904,4,936,23,2290,56,16001,27,18291,California
Siskiyou,2021-07-17,5,33458,2,13615,3,18907,0,936,3,2291,2,16003,3,18294,California
Siskiyou,2021-07-18,3,33461,0,13615,3,18910,0,936,3,2294,0,16003,3,18297,California
Siskiyou,2021-07-19,13,33474,3,13618,10,18920,0,936,8,2298,4,16007,8,18305,California
Siskiyou,2021-07-20,80,33554,52,13670,22,18942,6,942,34,2292,46,16053,40,18345,California
Siskiyou,2021-07-21,32,33586,17,13687,15,18957,0,942,22,2304,10,16063,22,18367,California
Siskiyou,2021-07-22,73,33659,46,13733,24,18981,3,945,43,2320,30,16093,46,18413,California
Siskiyou,2021-07-23,66,33725,43,13776,23,19004,0,945,31,2318,33,16126,31,18444,California
Siskiyou,2021-07-24,19,33744,11,13787,7,19011,1,946,14,2328,5,16131,15,18459,California
Siskiyou,2021-07-25,2,33746,0,13787,1,19012,1,947,1,2329,1,16132,2,18461,California
Siskiyou,2021-07-26,26,33772,16,13803,8,19020,2,949,23,2351,3,16135,25,18486,California
Siskiyou,2021-07-27,63,33835,26,13829,35,19055,2,951,40,2370,23,16158,42,18528,California
Siskiyou,2021-07-28,55,33890,30,13859,23,19078,2,953,39,2396,15,16173,41,18569,California
Siskiyou,2021-07-29,88,33978,47,13906,29,19107,12,965,46,2412,42,16215,58,18627,California
Siskiyou,2021-07-30,86,34064,57,13963,24,19131,5,970,34,2399,52,16267,39,18666,California
Siskiyou,2021-07-31,20,34084,10,13973,9,19140,1,971,13,2406,7,16274,14,18680,California
Siskiyou,2021-08-01,10,34094,0,13973,10,19150,0,971,9,2414,1,16275,9,18689,California
Siskiyou,2021-08-02,41,34135,14,13987,23,19173,4,975,29,2435,12,16287,33,18722,California
Siskiyou,2021-08-03,117,34252,54,14041,58,19231,5,980,73,2469,44,16331,78,18800,California
Siskiyou,2021-08-04,61,34313,28,14069,30,19261,3,983,49,2510,11,16342,52,18852,California
Siskiyou,2021-08-05,67,34380,45,14114,12,19273,10,993,28,2510,37,16379,37,18889,California
Siskiyou,2021-08-06,99,34479,68,14182,26,19299,5,998,70,2556,28,16407,74,18963,California
Siskiyou,2021-08-07,8,34487,6,14188,2,19301,0,998,6,2560,2,16409,6,18969,California
Siskiyou,2021-08-08,2,34489,1,14189,0,19301,1,999,1,2561,1,16410,2,18971,California
Siskiyou,2021-08-09,55,34544,36,14225,17,19318,2,1001,44,2598,9,16419,46,19017,California
Siskiyou,2021-08-10,123,34667,62,14287,50,19368,11,1012,79,2644,44,16463,90,19107,California
Siskiyou,2021-08-11,82,34749,43,14330,35,19403,4,1016,56,2678,26,16489,60,19167,California
Siskiyou,2021-08-12,107,34856,63,14393,34,19437,10,1026,58,2699,47,16536,68,19235,California
Siskiyou,2021-08-13,115,34971,80,14473,27,19464,8,1034,72,2738,42,16578,81,19316,California
Siskiyou,2021-08-14,28,34999,13,14486,15,19479,0,1034,17,2746,9,16587,17,19333,California
Siskiyou,2021-08-15,9,35008,4,14490,5,19484,0,1034,8,2754,0,16587,8,19341,California
Siskiyou,2021-08-16,76,35084,37,14527,39,19523,0,1034,51,2781,24,16611,51,19392,California
Siskiyou,2021-08-17,92,35176,41,14568,43,19566,8,1042,51,2804,36,16647,59,19451,California
Siskiyou,2021-08-18,80,35256,42,14610,34,19600,4,1046,43,2817,34,16681,47,19498,California
Siskiyou,2021-08-19,80,35336,35,14645,44,19644,1,1047,48,2842,24,16705,49,19547,California
Siskiyou,2021-08-20,82,35418,61,14706,21,19665,0,1047,43,2852,33,16738,43,19590,California
Siskiyou,2021-08-21,31,35449,17,14723,9,19674,5,1052,13,2852,18,16756,18,19608,California
Siskiyou,2021-08-22,6,35455,4,14727,2,19676,0,1052,0,2846,6,16762,0,19608,California
Siskiyou,2021-08-23,65,35520,30,14757,27,19703,8,1060,32,2864,22,16784,40,19648,California
Siskiyou,2021-08-24,101,35621,75,14832,23,19726,3,1063,55,2879,43,16827,58,19706,California
Siskiyou,2021-08-25,110,35731,69,14901,34,19760,7,1070,58,2902,42,16869,65,19771,California
Siskiyou,2021-08-26,105,35836,61,14962,42,19802,2,1072,54,2921,37,16906,56,19827,California
Siskiyou,2021-08-27,116,35952,92,15054,24,19826,0,1072,49,2913,57,16963,49,19876,California
Siskiyou,2021-08-28,34,35986,20,15074,13,19839,1,1073,19,2919,14,16977,20,19896,California
Siskiyou,2021-08-29,17,36003,14,15088,3,19842,0,1073,13,2928,4,16981,13,19909,California
Siskiyou,2021-08-30,52,36055,24,15112,24,19866,4,1077,18,2919,31,17012,22,19931,California
Solano,2020-12-15,4,4,4,4,0,0,0,0,4,4,0,0,4,4,California
Solano,2020-12-16,71,75,71,75,0,0,0,0,71,75,0,0,71,75,California
Solano,2020-12-17,172,247,172,247,0,0,0,0,172,247,0,0,172,247,California
Solano,2020-12-18,483,730,481,728,2,2,0,0,483,730,0,0,483,730,California
Solano,2020-12-19,520,1250,520,1248,0,2,0,0,520,1250,0,0,520,1250,California
Solano,2020-12-20,350,1600,348,1596,2,4,0,0,350,1600,0,0,350,1600,California
Solano,2020-12-21,577,2177,575,2171,2,6,0,0,577,2177,0,0,577,2177,California
Solano,2020-12-22,660,2837,625,2796,35,41,0,0,660,2837,0,0,660,2837,California
Solano,2020-12-23,867,3704,767,3563,100,141,0,0,868,3705,0,0,868,3705,California
Solano,2020-12-24,415,4119,162,3725,253,394,0,0,415,4120,0,0,415,4120,California
Solano,2020-12-25,9,4128,1,3726,8,402,0,0,9,4129,0,0,9,4129,California
Solano,2020-12-26,174,4302,45,3771,129,531,0,0,174,4303,0,0,174,4303,California
Solano,2020-12-27,108,4410,28,3799,80,611,0,0,108,4411,0,0,108,4411,California
Solano,2020-12-28,897,5307,436,4235,461,1072,0,0,897,5308,0,0,897,5308,California
Solano,2020-12-29,947,6254,382,4617,565,1637,0,0,947,6255,0,0,947,6255,California
Solano,2020-12-30,1256,7510,608,5225,648,2285,0,0,1256,7511,0,0,1256,7511,California
Solano,2020-12-31,550,8060,143,5368,407,2692,0,0,549,8060,0,0,549,8060,California
Solano,2021-01-01,15,8075,14,5382,1,2693,0,0,15,8075,0,0,15,8075,California
Solano,2021-01-02,220,8295,170,5552,50,2743,0,0,220,8295,0,0,220,8295,California
Solano,2021-01-03,54,8349,39,5591,15,2758,0,0,48,8343,0,0,48,8343,California
Solano,2021-01-04,451,8800,242,5833,209,2967,0,0,442,8783,2,2,442,8785,California
Solano,2021-01-05,738,9538,384,6217,354,3321,0,0,576,9202,157,159,576,9361,California
Solano,2021-01-06,847,10385,437,6654,410,3731,0,0,577,9511,268,427,577,9938,California
Solano,2021-01-07,1066,11451,674,7328,392,4123,0,0,597,9642,467,894,598,10536,California
Solano,2021-01-08,1181,12632,784,8112,397,4520,0,0,576,9631,588,1482,577,11113,California
Solano,2021-01-09,900,13532,765,8877,135,4655,0,0,441,9616,456,1938,441,11554,California
Solano,2021-01-10,265,13797,194,9071,71,4726,0,0,163,9677,102,2040,163,11717,California
Solano,2021-01-11,1340,15137,1125,10196,215,4941,0,0,819,9975,521,2561,819,12536,California
Solano,2021-01-12,1583,16720,1180,11376,403,5344,0,0,1034,10462,548,3109,1035,13571,California
Solano,2021-01-13,1482,18202,998,12374,484,5828,0,0,1229,11440,251,3360,1229,14800,California
Solano,2021-01-14,1938,20140,827,13201,1111,6939,0,0,1624,12752,312,3672,1624,16424,California
Solano,2021-01-15,1730,21870,1065,14266,665,7604,0,0,1428,13878,302,3974,1428,17852,California
Solano,2021-01-16,1304,23174,910,15176,394,7998,0,0,1132,14839,171,4145,1132,18984,California
Solano,2021-01-17,1058,24232,761,15937,297,8295,0,0,1034,15850,24,4169,1035,20019,California
Solano,2021-01-18,1438,25670,862,16799,576,8871,0,0,1310,17032,128,4297,1310,21329,California
Solano,2021-01-19,1677,27347,1350,18149,327,9198,0,0,1397,18150,279,4576,1397,22726,California
Solano,2021-01-20,2086,29433,1439,19588,647,9845,0,0,1589,19245,494,5070,1589,24315,California
Solano,2021-01-21,3282,32715,1047,20635,2235,12080,0,0,2911,21787,371,5441,2913,27228,California
Solano,2021-01-22,1808,34523,861,21496,947,13027,0,0,1605,23190,203,5644,1606,28834,California
Solano,2021-01-23,745,35268,244,21740,501,13528,0,0,537,23519,209,5853,538,29372,California
Solano,2021-01-24,459,35727,64,21804,395,13923,0,0,391,23842,68,5921,391,29763,California
Solano,2021-01-25,1704,37431,634,22438,1070,14993,0,0,1127,24394,576,6497,1128,30891,California
Solano,2021-01-26,1826,39257,749,23187,1077,16070,0,0,1173,24914,654,7151,1174,32065,California
Solano,2021-01-27,1830,41087,734,23921,1096,17166,0,0,1200,25489,625,7776,1200,33265,California
Solano,2021-01-28,2008,43095,716,24637,1292,18458,0,0,1396,26275,611,8387,1397,34662,California
Solano,2021-01-29,1743,44838,794,25431,949,19407,0,0,1374,27284,365,8752,1374,36036,California
Solano,2021-01-30,950,45788,439,25870,511,19918,0,0,622,27579,328,9080,623,36659,California
Solano,2021-01-31,272,46060,182,26052,90,20008,0,0,173,27655,97,9177,173,36832,California
Solano,2021-02-01,1570,47630,1038,27090,532,20540,0,0,778,27647,786,9963,778,37610,California
Solano,2021-02-02,3414,51044,1100,28190,2314,22854,0,0,2585,29410,823,10786,2586,40196,California
Solano,2021-02-03,2280,53324,1305,29495,975,23829,0,0,1169,29471,1108,11894,1169,41365,California
Solano,2021-02-04,1861,55185,912,30407,949,24778,0,0,1101,29817,755,12649,1101,42466,California
Solano,2021-02-05,3159,58344,1417,31824,1742,26520,0,0,2135,30935,1017,13666,2135,44601,California
Solano,2021-02-06,3123,61467,1174,32998,1949,28469,0,0,2288,32392,831,14497,2288,46889,California
Solano,2021-02-07,861,62328,785,33783,76,28545,0,0,237,32006,623,15120,237,47126,California
Solano,2021-02-08,1788,64116,1245,35028,543,29088,0,0,728,31677,1057,16177,728,47854,California
Solano,2021-02-09,1967,66083,1499,36527,468,29556,0,0,688,31088,1277,17454,688,48542,California
Solano,2021-02-10,2330,68413,1516,38043,814,30370,0,0,837,30434,1491,18945,837,49379,California
Solano,2021-02-11,2579,70992,1501,39544,1078,31448,0,0,1201,30268,1367,20312,1201,50580,California
Solano,2021-02-12,4329,75321,1638,41182,2691,34139,0,0,2944,31836,1376,21688,2944,53524,California
Solano,2021-02-13,2919,78240,250,41432,2669,36808,0,0,2491,33904,423,22111,2491,56015,California
Solano,2021-02-14,732,78972,209,41641,523,37331,0,0,407,33989,323,22434,408,56423,California
Solano,2021-02-15,1317,80289,310,41951,1007,38338,0,0,679,34031,637,23071,679,57102,California
Solano,2021-02-16,2593,82882,1394,43345,1199,39537,0,0,1678,34797,913,23984,1679,58781,California
Solano,2021-02-17,3314,86196,1449,44794,1865,41402,0,0,2246,35979,1065,25049,2247,61028,California
Solano,2021-02-18,2997,89193,852,45646,2145,43547,0,0,856,34701,2134,27183,856,61884,California
Solano,2021-02-19,2532,91725,1480,47126,1052,44599,0,0,1184,34546,1341,28524,1186,63070,California
Solano,2021-02-20,2807,94532,397,47523,2410,47009,0,0,2271,36282,535,29059,2271,65341,California
Solano,2021-02-21,2399,96931,2016,49539,383,47392,0,0,2022,37931,373,29432,2022,67363,California
Solano,2021-02-22,1859,98790,1091,50630,768,48160,0,0,961,37998,895,30327,962,68325,California
Solano,2021-02-23,3049,101839,1124,51754,1925,50085,0,0,2082,39117,963,31290,2082,70407,California
Solano,2021-02-24,2614,104453,1301,53055,1313,51398,0,0,1434,39377,1175,32465,1435,71842,California
Solano,2021-02-25,2724,107177,1603,54658,1121,52519,0,0,1480,39620,1237,33702,1480,73322,California
Solano,2021-02-26,3674,110851,2335,56993,1339,53858,0,0,2177,40307,1490,35192,2177,75499,California
Solano,2021-02-27,4047,114898,1555,58548,2491,56349,1,1,3261,42798,772,35964,3263,78762,California
Solano,2021-02-28,1964,116862,1578,60126,385,56734,1,2,1621,44083,338,36302,1623,80385,California
Solano,2021-03-01,2831,119693,1243,61369,1587,58321,1,3,2140,45541,683,36985,2141,82526,California
Solano,2021-03-02,2509,122202,1464,62833,1045,59366,0,3,1338,45710,1169,38154,1338,83864,California
Solano,2021-03-03,2327,124529,1296,64129,1031,60397,0,3,1427,46249,890,39044,1429,85293,California
Solano,2021-03-04,4492,129021,3475,67604,1015,61412,2,5,3200,48172,1282,40326,3205,88498,California
Solano,2021-03-05,5082,134103,1711,69315,3360,64772,11,16,4034,51180,1037,41363,4045,92543,California
Solano,2021-03-06,3924,138027,860,70175,3023,67795,41,57,2645,52599,1267,42630,2686,95229,California
Solano,2021-03-07,3655,141682,771,70946,2858,70653,26,83,1964,52913,1677,44307,1991,97220,California
Solano,2021-03-08,2216,143898,1359,72305,590,71243,267,350,1639,54243,573,44880,1903,99123,California
Solano,2021-03-09,3283,147181,1581,73886,1645,72888,57,407,2365,55742,917,45797,2416,101539,California
Solano,2021-03-10,2466,149647,1769,75655,612,73500,85,492,1295,55955,1164,46961,1377,102916,California
Solano,2021-03-11,6098,155745,1769,77424,4083,77583,246,738,5040,60191,1051,48012,5287,108203,California
Solano,2021-03-12,6181,161926,1580,79004,4421,82004,180,918,3256,60713,2913,50925,3435,111638,California
Solano,2021-03-13,4647,166573,809,79813,3755,85759,83,1001,2251,60663,2387,53312,2337,113975,California
Solano,2021-03-14,4041,170614,3154,82967,417,86176,470,1471,1546,60186,2489,55801,2012,115987,California
Solano,2021-03-15,4077,174691,2489,85456,1255,87431,333,1804,2546,61541,1521,57322,2876,118863,California
Solano,2021-03-16,3110,177801,1330,86786,1547,88978,233,2037,1572,61814,1530,58852,1803,120666,California
Solano,2021-03-17,6666,184467,1689,88475,4882,93860,95,2132,4998,65243,1664,60516,5093,125759,California
Solano,2021-03-18,5301,189768,1874,90349,3386,97246,41,2173,3789,67571,1503,62019,3831,129590,California
Solano,2021-03-19,3631,193399,2676,93025,877,98123,78,2251,1610,67250,2011,64030,1690,131280,California
Solano,2021-03-20,5637,199036,1692,94717,3893,102016,52,2303,2631,66938,2994,67024,2682,133962,California
Solano,2021-03-21,1690,200726,1588,96305,77,102093,25,2328,368,66017,1312,68336,391,134353,California
Solano,2021-03-22,2712,203438,2062,98367,600,102693,50,2378,1565,66487,1141,69477,1611,135964,California
Solano,2021-03-23,3643,207081,1718,100085,1879,104572,46,2424,1353,65603,2282,71759,1398,137362,California
Solano,2021-03-24,2857,209938,1785,101870,1038,105610,34,2458,1352,65491,1496,73255,1384,138746,California
Solano,2021-03-25,4925,214863,4029,105899,861,106471,35,2493,2280,65168,2637,75892,2314,141060,California
Solano,2021-03-26,3281,218144,2129,108028,1113,107584,39,2532,1740,65419,1529,77421,1780,142840,California
Solano,2021-03-27,4253,222397,1160,109188,3050,110634,43,2575,1654,64525,2589,80010,1695,144535,California
Solano,2021-03-28,1437,223834,1119,110307,301,110935,17,2592,538,64186,894,80904,555,145090,California
Solano,2021-03-29,3629,227463,2061,112368,1549,112484,19,2611,1524,63640,2090,82994,1544,146634,California
Solano,2021-03-30,3085,230548,2029,114397,954,113438,102,2713,1905,64467,1178,84172,2005,148639,California
Solano,2021-03-31,3166,233714,2153,116550,851,114289,162,2875,1843,65150,1318,85490,2001,150640,California
Solano,2021-04-01,5616,239330,2124,118674,3337,117626,155,3030,3542,66785,2061,87551,3696,154336,California
Solano,2021-04-02,6689,246019,2248,120922,4273,121899,168,3198,2530,65340,4140,91691,2695,157031,California
Solano,2021-04-03,1555,247574,990,121912,410,122309,155,3353,586,65113,967,92658,740,157771,California
Solano,2021-04-04,787,248361,291,122203,191,122500,305,3658,239,65113,544,93202,544,158315,California
Solano,2021-04-05,3083,251444,2127,124330,744,123244,212,3870,1512,65268,1566,94768,1721,160036,California
Solano,2021-04-06,6160,257604,1651,125981,4020,127264,489,4359,1618,62843,4532,99300,2107,162143,California
Solano,2021-04-07,6053,263657,4681,130662,964,128228,408,4767,3432,64079,2602,101902,3838,165981,California
Solano,2021-04-08,6574,270231,1809,132471,3891,132119,874,5641,1797,61996,4745,106647,2662,168643,California
Solano,2021-04-09,6485,276716,1688,134159,3938,136057,859,6500,1561,59508,4897,111544,2409,171052,California
Solano,2021-04-10,1824,278540,980,135139,462,136519,382,6882,824,59714,998,112542,1204,172256,California
Solano,2021-04-11,1206,279746,776,135915,327,136846,103,6985,642,59898,561,113103,745,173001,California
Solano,2021-04-12,3304,283050,1718,137633,1220,138066,366,7351,1339,59641,1958,115061,1701,174702,California
Solano,2021-04-13,2583,285633,1127,138760,1455,139521,1,7352,1333,59731,1244,116305,1334,176036,California
Solano,2021-04-14,6607,292240,1978,140738,4629,144150,0,7352,1843,56820,4755,121060,1844,177880,California
Solano,2021-04-15,5815,298055,2190,142928,3624,147774,1,7353,1736,54493,4064,125124,1737,179617,California
Solano,2021-04-16,3740,301795,2642,145570,1096,148870,2,7355,2313,55391,1417,126541,2315,181932,California
Solano,2021-04-17,3333,305128,1088,146658,2245,151115,0,7355,1132,54334,2191,128732,1134,183066,California
Solano,2021-04-18,1058,306186,666,147324,392,151507,0,7355,548,54372,510,129242,548,183614,California
Solano,2021-04-19,2155,308341,1162,148486,993,152500,0,7355,1163,54553,984,130226,1165,184779,California
Solano,2021-04-20,3077,311418,1875,150361,1202,153702,0,7355,1683,54848,1388,131614,1683,186462,California
Solano,2021-04-21,3915,315333,2421,152782,1494,155196,0,7355,2044,55030,1862,133476,2044,188506,California
Solano,2021-04-22,3092,318425,1541,154323,1551,156747,0,7355,1828,55597,1261,134737,1828,190334,California
Solano,2021-04-23,4254,322679,2161,156484,2093,158840,0,7355,2558,56469,1688,136425,2560,192894,California
Solano,2021-04-24,3970,326649,2396,158880,1572,160412,2,7357,2634,57859,1247,137672,2637,195531,California
Solano,2021-04-25,1451,328100,1127,160007,324,160736,0,7357,1147,58709,297,137969,1147,196678,California
Solano,2021-04-26,2640,330740,1709,161716,927,161663,4,7361,1452,58992,1173,139142,1456,198134,California
Solano,2021-04-27,2636,333376,1320,163036,1286,162949,30,7391,1489,59376,1136,140278,1520,199654,California
Solano,2021-04-28,6187,339563,5119,168155,1021,163970,47,7438,3853,60955,2320,142598,3899,203553,California
Solano,2021-04-29,4707,344270,1506,169661,3167,167137,34,7472,2098,60486,2601,145199,2132,205685,California
Solano,2021-04-30,4218,348488,2240,171901,1834,168971,144,7616,1961,60351,2238,147437,2103,207788,California
Solano,2021-05-01,2215,350703,1699,173600,314,169285,202,7818,1309,60963,899,148336,1511,209299,California
Solano,2021-05-02,1223,351926,963,174563,233,169518,27,7845,674,61121,543,148879,701,210000,California
Solano,2021-05-03,1489,353415,1032,175595,371,169889,86,7931,611,60945,874,149753,698,210698,California
Solano,2021-05-04,1841,355256,1075,176670,702,170591,64,7995,825,60819,1015,150768,889,211587,California
Solano,2021-05-05,2342,357598,1478,178148,749,171340,115,8110,1129,60852,1208,151976,1241,212828,California
Solano,2021-05-06,2055,359653,1222,179370,619,171959,214,8324,742,60500,1300,153276,948,213776,California
Solano,2021-05-07,2895,362548,2023,181393,754,172713,118,8442,995,59719,1891,155167,1110,214886,California
Solano,2021-05-08,1509,364057,955,182348,437,173150,117,8559,576,59486,926,156093,693,215579,California
Solano,2021-05-09,455,364512,276,182624,167,173317,12,8571,177,59400,276,156369,190,215769,California
Solano,2021-05-10,1396,365908,648,183272,641,173958,107,8678,388,58891,1004,157373,495,216264,California
Solano,2021-05-11,2352,368260,1206,184478,1054,175012,92,8770,687,58010,1660,159033,779,217043,California
Solano,2021-05-12,2216,370476,1270,185748,771,175783,175,8945,732,57448,1468,160501,906,217949,California
Solano,2021-05-13,3136,373612,2146,187894,777,176560,213,9158,1637,57804,1495,161996,1851,219800,California
Solano,2021-05-14,2552,376164,1739,189633,691,177251,122,9280,1076,57537,1465,163461,1198,220998,California
Solano,2021-05-15,3474,379638,2815,192448,571,177822,88,9368,1307,56775,2156,165617,1394,222392,California
Solano,2021-05-16,1560,381198,1156,193604,371,178193,33,9401,280,55810,1277,166894,312,222704,California
Solano,2021-05-17,2489,383687,1421,195025,982,179175,86,9487,876,55175,1593,168487,958,223662,California
Solano,2021-05-18,2987,386674,1650,196675,1247,180422,90,9577,1480,55252,1493,169980,1570,225232,California
Solano,2021-05-19,5909,392583,4284,200959,1488,181910,137,9714,2224,53942,3672,173652,2362,227594,California
Solano,2021-05-20,2658,395241,1592,202551,1002,182912,64,9778,948,53256,1698,175350,1012,228606,California
Solano,2021-05-21,3637,398878,1897,204448,1669,184581,71,9849,1372,52447,2253,177603,1444,230050,California
Solano,2021-05-22,2791,401669,2157,206605,540,185121,94,9943,1180,52116,1604,179207,1273,231323,California
Solano,2021-05-23,1431,403100,1181,207786,226,185347,24,9967,761,52234,667,179874,785,232108,California
Solano,2021-05-24,1901,405001,1093,208879,734,186081,74,10041,640,51693,1253,181127,712,232820,California
Solano,2021-05-25,1651,406652,832,209711,757,186838,62,10103,592,51297,1049,182176,653,233473,California
Solano,2021-05-26,1927,408579,1108,210819,762,187600,57,10160,714,50861,1208,183384,772,234245,California
Solano,2021-05-27,2179,410758,970,211789,1131,188731,78,10238,899,50567,1270,184654,976,235221,California
Solano,2021-05-28,2061,412819,1053,212842,951,189682,57,10295,775,50121,1278,185932,832,236053,California
Solano,2021-05-29,665,413484,333,213175,300,189982,32,10327,306,50102,356,186288,337,236390,California
Solano,2021-05-30,326,413810,154,213329,147,190129,25,10352,115,50035,208,186496,141,236531,California
Solano,2021-05-31,128,413938,20,213349,100,190229,8,10360,25,49965,103,186599,33,236564,California
Solano,2021-06-01,1859,415797,1195,214544,586,190815,78,10438,737,49666,1114,187713,815,237379,California
Solano,2021-06-02,1862,417659,1311,215855,483,191298,68,10506,938,49754,915,188628,1003,238382,California
Solano,2021-06-03,2258,419917,1782,217637,391,191689,85,10591,717,49024,1532,190160,802,239184,California
Solano,2021-06-04,1687,421604,1175,218812,446,192135,66,10657,510,48428,1172,191332,576,239760,California
Solano,2021-06-05,1439,423043,1042,219854,346,192481,51,10708,482,48012,949,192281,533,240293,California
Solano,2021-06-06,678,423721,558,220412,88,192569,32,10740,365,48096,313,192594,397,240690,California
Solano,2021-06-07,1251,424972,957,221369,230,192799,64,10804,410,47733,837,193431,474,241164,California
Solano,2021-06-08,1847,426819,1338,222707,474,193273,35,10839,484,46895,1357,194788,519,241683,California
Solano,2021-06-09,2130,428949,1819,224526,250,193523,61,10900,665,46162,1458,196246,725,242408,California
Solano,2021-06-10,1299,430248,842,225368,382,193905,75,10975,413,45773,876,197122,487,242895,California
Solano,2021-06-11,1617,431865,1285,226653,264,194169,68,11043,585,45397,1027,198149,651,243546,California
Solano,2021-06-12,1217,433082,936,227589,221,194390,60,11103,199,44646,1010,199159,259,243805,California
Solano,2021-06-13,628,433710,539,228128,80,194470,9,11112,111,44250,516,199675,120,243925,California
Solano,2021-06-14,1336,435046,942,229070,359,194829,35,11147,277,43509,1051,200726,310,244235,California
Solano,2021-06-15,1500,436546,950,230020,497,195326,53,11200,616,43300,876,201602,667,244902,California
Solano,2021-06-16,1180,437726,780,230800,330,195656,70,11270,396,42987,778,202380,465,245367,California
Solano,2021-06-17,1235,438961,942,231742,223,195879,70,11340,438,42711,783,203163,507,245874,California
Solano,2021-06-18,1308,440269,1001,232743,240,196119,67,11407,477,42428,826,203989,543,246417,California
Solano,2021-06-19,425,440694,297,233040,100,196219,28,11435,157,42349,264,204253,185,246602,California
Solano,2021-06-20,182,440876,139,233179,36,196255,7,11442,84,42342,98,204351,91,246693,California
Solano,2021-06-21,635,441511,405,233584,166,196421,64,11506,393,42558,241,204592,457,247150,California
Solano,2021-06-22,1187,442698,891,234475,241,196662,55,11561,436,42302,747,205339,491,247641,California
Solano,2021-06-23,1446,444144,1197,235672,176,196838,73,11634,491,41917,948,206287,563,248204,California
Solano,2021-06-24,936,445080,695,236367,175,197013,66,11700,398,41847,531,206818,461,248665,California
Solano,2021-06-25,1067,446147,744,237111,248,197261,75,11775,494,41860,555,207373,568,249233,California
Solano,2021-06-26,608,446755,473,237584,95,197356,40,11815,258,41809,348,207721,297,249530,California
Solano,2021-06-27,473,447228,413,237997,58,197414,2,11817,168,41675,304,208025,170,249700,California
Solano,2021-06-28,1003,448231,827,238824,135,197549,41,11858,415,41549,582,208607,456,250156,California
Solano,2021-06-29,863,449094,659,239483,149,197698,55,11913,377,41498,482,209089,431,250587,California
Solano,2021-06-30,831,449925,615,240098,173,197871,43,11956,380,41469,451,209540,422,251009,California
Solano,2021-07-01,674,450599,498,240596,111,197982,65,12021,259,41380,413,209953,324,251333,California
Solano,2021-07-02,770,451369,587,241183,148,198130,35,12056,311,41273,453,210406,346,251679,California
Solano,2021-07-03,322,451691,216,241399,90,198220,16,12072,163,41296,155,210561,178,251857,California
Solano,2021-07-04,34,451725,4,241403,17,198237,13,12085,14,41303,20,210581,27,251884,California
Solano,2021-07-05,354,452079,245,241648,94,198331,15,12100,176,41321,173,210754,191,252075,California
Solano,2021-07-06,1039,453118,824,242472,193,198524,22,12122,377,41064,657,211411,400,252475,California
Solano,2021-07-07,722,453840,513,242985,148,198672,61,12183,278,40966,437,211848,339,252814,California
Solano,2021-07-08,624,454464,443,243428,157,198829,24,12207,267,40907,352,212200,293,253107,California
Solano,2021-07-09,791,455255,530,243958,233,199062,28,12235,340,40829,446,212646,368,253475,California
Solano,2021-07-10,294,455549,196,244154,90,199152,8,12243,133,40813,157,212803,141,253616,California
Solano,2021-07-11,245,455794,180,244334,61,199213,4,12247,104,40797,124,212927,108,253724,California
Solano,2021-07-12,771,456565,604,244938,123,199336,44,12291,320,40714,447,213374,364,254088,California
Solano,2021-07-13,771,457336,539,245477,190,199526,42,12333,346,40683,419,213793,388,254476,California
Solano,2021-07-14,734,458070,572,246049,120,199646,42,12375,348,40694,376,214169,387,254863,California
Solano,2021-07-15,630,458700,441,246490,143,199789,46,12421,266,40644,361,214530,311,255174,California
Solano,2021-07-16,924,459624,742,247232,141,199930,41,12462,427,40616,495,215025,467,255641,California
Solano,2021-07-17,363,459987,278,247510,76,200006,9,12471,152,40567,210,215235,161,255802,California
Solano,2021-07-18,253,460240,207,247717,41,200047,5,12476,154,40629,97,215332,159,255961,California
Solano,2021-07-19,904,461144,756,248473,115,200162,33,12509,464,40690,435,215767,496,256457,California
Solano,2021-07-20,808,461952,641,249114,136,200298,31,12540,408,40733,397,216164,440,256897,California
Solano,2021-07-21,803,462755,576,249690,200,200498,27,12567,421,40804,377,216541,448,257345,California
Solano,2021-07-22,736,463491,569,250259,118,200616,49,12616,384,40888,349,216890,433,257778,California
Solano,2021-07-23,903,464394,659,250918,221,200837,23,12639,514,41037,388,217278,537,258315,California
Solano,2021-07-24,413,464807,326,251244,78,200915,9,12648,255,41147,153,217431,263,258578,California
Solano,2021-07-25,224,465031,172,251416,43,200958,9,12657,177,41286,47,217478,186,258764,California
Solano,2021-07-26,754,465785,486,251902,234,201192,34,12691,536,41641,215,217693,570,259334,California
Solano,2021-07-27,742,466527,462,252364,253,201445,27,12718,483,41898,252,217945,509,259843,California
Solano,2021-07-28,914,467441,726,253090,144,201589,44,12762,540,42117,365,218310,584,260427,California
Solano,2021-07-29,665,468106,402,253492,244,201833,19,12781,468,42408,196,218506,487,260914,California
Solano,2021-07-30,871,468977,662,254154,155,201988,54,12835,562,42726,295,218801,613,261527,California
Solano,2021-07-31,419,469396,289,254443,116,202104,14,12849,277,42882,134,218935,290,261817,California
Solano,2021-08-01,291,469687,235,254678,51,202155,5,12854,208,43016,79,219014,213,262030,California
Solano,2021-08-02,888,470575,615,255293,256,202411,17,12871,580,43307,306,219320,597,262627,California
Solano,2021-08-03,977,471552,751,256044,177,202588,49,12920,631,43651,336,219656,680,263307,California
Solano,2021-08-04,1023,472575,736,256780,260,202848,27,12947,589,43837,428,220084,614,263921,California
Solano,2021-08-05,889,473464,620,257400,246,203094,23,12970,645,44267,236,220320,666,264587,California
Solano,2021-08-06,1194,474658,860,258260,298,203392,36,13006,734,44585,452,220772,770,265357,California
Solano,2021-08-07,442,475100,302,258562,123,203515,17,13023,287,44737,152,220924,304,265661,California
Solano,2021-08-08,347,475447,278,258840,69,203584,0,13023,205,44802,140,221064,205,265866,California
Solano,2021-08-09,1044,476491,879,259719,126,203710,39,13062,580,44961,459,221523,618,266484,California
Solano,2021-08-10,1208,477699,897,260616,288,203998,23,13085,736,45250,469,221992,758,267242,California
Solano,2021-08-11,1027,478726,775,261391,174,204172,78,13163,677,45658,345,222337,753,267995,California
Solano,2021-08-12,1014,479740,735,262126,244,204416,35,13198,597,45877,410,222747,629,268624,California
Solano,2021-08-13,1074,480814,788,262914,219,204635,67,13265,650,46179,416,223163,718,269342,California
Solano,2021-08-14,488,481302,348,263262,121,204756,19,13284,257,46236,219,223382,276,269618,California
Solano,2021-08-15,282,481584,200,263462,75,204831,7,13291,157,46289,111,223493,164,269782,California
Solano,2021-08-16,991,482575,730,264192,214,205045,47,13338,503,46378,461,223954,550,270332,California
Solano,2021-08-17,853,483428,641,264833,177,205222,35,13373,470,46543,339,224293,504,270836,California
Solano,2021-08-18,1253,484681,819,265652,400,205622,34,13407,599,46599,577,224870,633,271469,California
Solano,2021-08-19,846,485527,571,266223,216,205838,59,13466,423,46746,334,225204,481,271950,California
Solano,2021-08-20,1391,486918,911,267134,450,206288,30,13496,619,46789,607,225811,650,272600,California
Solano,2021-08-21,487,487405,357,267491,118,206406,12,13508,235,46830,206,226017,247,272847,California
Solano,2021-08-22,377,487782,296,267787,78,206484,3,13511,154,46799,188,226205,157,273004,California
Solano,2021-08-23,1304,489086,879,268666,382,206866,43,13554,594,46913,523,226728,637,273641,California
Solano,2021-08-24,1376,490462,1001,269667,342,207208,33,13587,626,46961,611,227339,659,274300,California
Solano,2021-08-25,1124,491586,911,270578,164,207372,49,13636,521,47036,495,227834,570,274870,California
Solano,2021-08-26,1322,492908,915,271493,367,207739,40,13676,545,47017,604,228438,585,275455,California
Solano,2021-08-27,1354,494262,1067,272560,227,207966,60,13736,591,47026,642,229080,651,276106,California
Solano,2021-08-28,649,494911,429,272989,216,208182,4,13740,235,46997,268,229348,239,276345,California
Solano,2021-08-29,375,495286,281,273270,90,208272,4,13744,154,46966,189,229537,158,276503,California
Solano,2021-08-30,1044,496330,703,273973,307,208579,34,13778,373,46831,543,230080,408,276911,California
Sonoma,2020-12-15,4,4,4,4,0,0,0,0,4,4,0,0,4,4,California
Sonoma,2020-12-16,27,31,27,31,0,0,0,0,27,31,0,0,27,31,California
Sonoma,2020-12-17,111,142,111,142,0,0,0,0,111,142,0,0,111,142,California
Sonoma,2020-12-18,440,582,440,582,0,0,0,0,440,582,0,0,440,582,California
Sonoma,2020-12-19,119,701,118,700,1,1,0,0,119,701,0,0,119,701,California
Sonoma,2020-12-20,181,882,181,881,0,1,0,0,181,882,0,0,181,882,California
Sonoma,2020-12-21,900,1782,898,1779,2,3,0,0,898,1780,0,0,898,1780,California
Sonoma,2020-12-22,1363,3145,1277,3056,86,89,0,0,1363,3143,0,0,1363,3143,California
Sonoma,2020-12-23,1611,4756,1232,4288,379,468,0,0,1611,4754,0,0,1611,4754,California
Sonoma,2020-12-24,314,5070,104,4392,210,678,0,0,314,5068,0,0,314,5068,California
Sonoma,2020-12-25,8,5078,1,4393,7,685,0,0,8,5076,0,0,8,5076,California
Sonoma,2020-12-26,265,5343,256,4649,9,694,0,0,265,5341,0,0,265,5341,California
Sonoma,2020-12-27,96,5439,81,4730,15,709,0,0,96,5437,0,0,96,5437,California
Sonoma,2020-12-28,978,6417,541,5271,437,1146,0,0,953,6389,1,1,953,6390,California
Sonoma,2020-12-29,1144,7561,783,6054,361,1507,0,0,1110,7499,0,1,1110,7500,California
Sonoma,2020-12-30,1106,8667,487,6541,619,2126,0,0,1098,8597,0,1,1098,8598,California
Sonoma,2020-12-31,523,9190,69,6610,454,2580,0,0,523,9120,0,1,523,9121,California
Sonoma,2021-01-01,644,9834,318,6928,326,2906,0,0,644,9764,0,1,644,9765,California
Sonoma,2021-01-02,138,9972,130,7058,8,2914,0,0,139,9903,0,1,139,9904,California
Sonoma,2021-01-03,26,9998,11,7069,15,2929,0,0,26,9929,0,1,26,9930,California
Sonoma,2021-01-04,339,10337,103,7172,236,3165,0,0,338,10267,0,1,338,10268,California
Sonoma,2021-01-05,438,10775,97,7269,341,3506,0,0,411,10661,17,18,411,10679,California
Sonoma,2021-01-06,952,11727,428,7697,524,4030,0,0,842,11399,104,122,842,11521,California
Sonoma,2021-01-07,1056,12783,550,8247,506,4536,0,0,873,12090,182,304,873,12394,California
Sonoma,2021-01-08,1833,14616,1258,9505,575,5111,0,0,1340,12939,491,795,1340,13734,California
Sonoma,2021-01-09,648,15264,399,9904,249,5360,0,0,602,13495,46,841,602,14336,California
Sonoma,2021-01-10,473,15737,461,10365,12,5372,0,0,275,13572,198,1039,275,14611,California
Sonoma,2021-01-11,1385,17122,1236,11601,149,5521,0,0,423,13038,957,1996,423,15034,California
Sonoma,2021-01-12,1555,18677,1299,12900,256,5777,0,0,397,12279,1156,3152,397,15431,California
Sonoma,2021-01-13,2055,20732,1368,14268,687,6464,0,0,1182,12592,870,4022,1183,16614,California
Sonoma,2021-01-14,1549,22281,812,15080,737,7201,0,0,1317,13678,231,4253,1317,17931,California
Sonoma,2021-01-15,1569,23850,627,15707,942,8143,0,0,1346,14812,214,4467,1348,19279,California
Sonoma,2021-01-16,1148,24998,614,16321,534,8677,0,0,901,15470,243,4710,901,20180,California
Sonoma,2021-01-17,680,25678,558,16879,122,8799,0,0,597,15983,84,4794,597,20777,California
Sonoma,2021-01-18,1103,26781,930,17809,173,8972,0,0,620,16121,483,5277,621,21398,California
Sonoma,2021-01-19,2103,28884,1002,18811,1101,10073,0,0,1388,16797,713,5990,1389,22787,California
Sonoma,2021-01-20,2198,31082,716,19527,1482,11555,0,0,1514,17639,673,6663,1515,24302,California
Sonoma,2021-01-21,2351,33433,689,20216,1662,13217,0,0,2109,19509,240,6903,2110,26412,California
Sonoma,2021-01-22,2788,36221,1062,21278,1726,14943,0,0,2626,21974,161,7064,2626,29038,California
Sonoma,2021-01-23,783,37004,597,21875,186,15129,0,0,670,22532,112,7176,670,29708,California
Sonoma,2021-01-24,853,37857,713,22588,140,15269,0,0,835,23349,18,7194,835,30543,California
Sonoma,2021-01-25,2213,40070,543,23131,1670,16939,0,0,1716,24569,496,7690,1716,32259,California
Sonoma,2021-01-26,2099,42169,318,23449,1781,18720,0,0,1615,25701,483,8173,1615,33874,California
Sonoma,2021-01-27,3788,45957,1294,24743,2494,21214,0,0,3188,28294,597,8770,3190,37064,California
Sonoma,2021-01-28,4157,50114,1854,26597,2303,23517,0,0,3452,31047,701,9471,3454,40518,California
Sonoma,2021-01-29,3048,53162,1436,28033,1612,25129,0,0,2173,32351,871,10342,2175,42693,California
Sonoma,2021-01-30,2594,55756,2395,30428,199,25328,0,0,2237,34234,355,10697,2238,44931,California
Sonoma,2021-01-31,796,56552,678,31106,118,25446,0,0,564,34567,231,10928,564,45495,California
Sonoma,2021-02-01,2524,59076,870,31976,1654,27100,0,0,2125,36297,395,11323,2125,47620,California
Sonoma,2021-02-02,3645,62721,1411,33387,2234,29334,0,0,3039,38734,602,11925,3039,50659,California
Sonoma,2021-02-03,4091,66812,1327,34714,2764,32098,0,0,3135,40917,952,12877,3135,53794,California
Sonoma,2021-02-04,4274,71086,1758,36472,2516,34614,0,0,3442,43532,830,13707,3445,57239,California
Sonoma,2021-02-05,4872,75958,1758,38230,3114,37728,0,0,3791,46248,1076,14783,3792,61031,California
Sonoma,2021-02-06,2708,78666,2326,40556,382,38110,0,0,2144,47833,561,15344,2146,63177,California
Sonoma,2021-02-07,1582,80248,1444,42000,138,38248,0,0,1309,48869,273,15617,1309,64486,California
Sonoma,2021-02-08,3298,83546,1034,43034,2264,40512,0,0,2686,50945,610,16227,2686,67172,California
Sonoma,2021-02-09,3648,87194,1747,44781,1901,42413,0,0,3148,53596,498,16725,3149,70321,California
Sonoma,2021-02-10,4643,91837,2518,47299,2125,44538,0,0,3598,56160,1035,17760,3599,73920,California
Sonoma,2021-02-11,5681,97518,3057,50356,2624,47162,0,0,4381,59247,1294,19054,4381,78301,California
Sonoma,2021-02-12,6019,103537,3322,53678,2697,49859,0,0,4521,62284,1488,20542,4525,82826,California
Sonoma,2021-02-13,2014,105551,1165,54843,849,50708,0,0,1191,62655,820,21362,1191,84017,California
Sonoma,2021-02-14,2368,107919,1862,56705,506,51214,0,0,1600,63492,763,22125,1600,85617,California
Sonoma,2021-02-15,2190,110109,828,57533,1362,52576,0,0,1622,64550,564,22689,1622,87239,California
Sonoma,2021-02-16,5074,115183,2193,59726,2881,55457,0,0,3760,67007,1305,23994,3762,91001,California
Sonoma,2021-02-17,5703,120886,2971,62697,2732,58189,0,0,3566,68456,2120,26114,3569,94570,California
Sonoma,2021-02-18,7172,128058,3259,65956,3913,62102,0,0,4097,69508,3046,29160,4098,98668,California
Sonoma,2021-02-19,5776,133834,1747,67703,4029,66131,0,0,3570,70894,2186,31346,3572,102240,California
Sonoma,2021-02-20,3147,136981,2847,70550,300,66431,0,0,1213,70184,1923,33269,1213,103453,California
Sonoma,2021-02-21,569,137550,447,70997,122,66553,0,0,139,69902,421,33690,139,103592,California
Sonoma,2021-02-22,3098,140648,1463,72460,1635,68188,0,0,1266,69354,1814,35504,1266,104858,California
Sonoma,2021-02-23,3554,144202,2163,74623,1391,69579,0,0,1655,69123,1886,37390,1655,106513,California
Sonoma,2021-02-24,5971,150173,2665,77288,3306,72885,0,0,3027,69235,2916,40306,3028,109541,California
Sonoma,2021-02-25,6286,156459,2444,79732,3842,76727,0,0,3345,69679,2901,43207,3345,112886,California
Sonoma,2021-02-26,6921,163380,3039,82771,3882,80609,0,0,4360,71500,2539,45746,4360,117246,California
Sonoma,2021-02-27,4429,167809,2061,84832,2368,82977,0,0,2937,72956,1481,47227,2937,120183,California
Sonoma,2021-02-28,2639,170448,1959,86791,679,83656,1,1,759,71857,1860,49087,761,120944,California
Sonoma,2021-03-01,4326,174774,1354,88145,2970,86626,2,3,2214,71993,2082,51169,2218,123162,California
Sonoma,2021-03-02,4671,179445,1615,89760,3053,89679,3,6,2650,72642,2004,53173,2653,125815,California
Sonoma,2021-03-03,5221,184666,2690,92450,2531,92210,0,6,2356,72157,2842,56015,2357,128172,California
Sonoma,2021-03-04,6152,190818,2766,95216,3386,95596,0,6,2636,71305,3488,59503,2636,130808,California
Sonoma,2021-03-05,6637,197455,2936,98152,3686,99282,15,21,2757,70223,3854,63357,2772,133580,California
Sonoma,2021-03-06,2829,200284,1239,99391,1449,100731,141,162,1928,71398,887,64244,2062,135642,California
Sonoma,2021-03-07,1848,202132,1426,100817,325,101056,97,259,410,70466,1433,65677,501,136143,California
Sonoma,2021-03-08,4161,206293,669,101486,3307,104363,185,444,2419,71345,1722,67399,2601,138744,California
Sonoma,2021-03-09,5736,212029,3144,104630,2320,106683,272,716,2707,71305,3003,70402,2963,141707,California
Sonoma,2021-03-10,6149,218178,3229,107859,2573,109256,347,1063,2432,70385,3686,74088,2766,144473,California
Sonoma,2021-03-11,7672,225850,3082,110941,3763,113019,827,1890,2548,68656,5087,79175,3358,147831,California
Sonoma,2021-03-12,7528,233378,2284,113225,3866,116885,1378,3268,2095,66712,5387,84562,3443,151274,California
Sonoma,2021-03-13,3512,236890,1738,114963,1531,118416,243,3511,2048,67540,1456,86018,2284,153558,California
Sonoma,2021-03-14,1384,238274,380,115343,862,119278,142,3653,845,67990,535,86553,985,154543,California
Sonoma,2021-03-15,5310,243584,1553,116896,3367,122645,390,4043,2177,67448,3105,89658,2563,157106,California
Sonoma,2021-03-16,6372,249956,2297,119193,3842,126487,233,4276,2886,67103,3460,93118,3115,160221,California
Sonoma,2021-03-17,6896,256852,3610,122803,3099,129586,187,4463,3274,66970,3592,96710,3459,163680,California
Sonoma,2021-03-18,7231,264083,2977,125780,3638,133224,616,5079,3113,66592,4096,100806,3718,167398,California
Sonoma,2021-03-19,7566,271649,3268,129048,4063,137287,235,5314,2945,65193,4582,105388,3183,170581,California
Sonoma,2021-03-20,3771,275420,1773,130821,1157,138444,841,6155,2028,66320,1728,107116,2855,173436,California
Sonoma,2021-03-21,1407,276827,610,131431,759,139203,38,6193,1205,67371,192,107308,1243,174679,California
Sonoma,2021-03-22,4622,281449,3130,134561,1393,140596,99,6292,3348,69556,1262,108570,3447,178126,California
Sonoma,2021-03-23,5947,287396,3670,138231,2203,142799,74,6366,4447,72590,1486,110056,4520,182646,California
Sonoma,2021-03-24,6958,294354,4340,142571,2533,145332,85,6451,4191,74123,2736,112792,4269,186915,California
Sonoma,2021-03-25,7276,301630,4264,146835,2879,148211,133,6584,4260,75536,2980,115772,4393,191308,California
Sonoma,2021-03-26,7596,309226,3510,150345,3974,152185,112,6696,3781,75653,3775,119547,3892,195200,California
Sonoma,2021-03-27,3975,313201,1528,151873,2074,154259,373,7069,1009,74083,2948,122495,1378,196578,California
Sonoma,2021-03-28,1522,314723,950,152823,544,154803,28,7097,793,74180,723,123218,820,197398,California
Sonoma,2021-03-29,3030,317753,1125,153948,1872,156675,33,7130,1543,74279,1477,124695,1576,198974,California
Sonoma,2021-03-30,6038,323791,3296,157244,2677,159352,65,7195,3096,74514,2926,127621,3161,202135,California
Sonoma,2021-03-31,5827,329618,3455,160699,2156,161508,216,7411,3354,75632,2449,130070,3567,205702,California
Sonoma,2021-04-01,7050,336668,4096,164795,2588,164096,366,7777,3772,76516,3244,133314,4128,209830,California
Sonoma,2021-04-02,6060,342728,3612,168407,2334,166430,114,7891,3603,77786,2437,135751,3707,213537,California
Sonoma,2021-04-03,3822,346550,1894,170301,1704,168134,224,8115,1688,77578,2113,137864,1905,215442,California
Sonoma,2021-04-04,1080,347630,699,171000,289,168423,92,8207,642,77879,433,138297,734,216176,California
Sonoma,2021-04-05,4491,352121,675,171675,3467,171890,349,8556,1659,77062,2824,141121,2007,218183,California
Sonoma,2021-04-06,7007,359128,3544,175219,3047,174937,416,8972,4065,78614,2922,144043,4474,222657,California
Sonoma,2021-04-07,6934,366062,3921,179140,2164,177101,849,9821,3369,79278,3542,147585,4206,226863,California
Sonoma,2021-04-08,7741,373803,4183,183323,2780,179881,778,10599,4234,80792,3485,151070,4999,231862,California
Sonoma,2021-04-09,6909,380712,3846,187169,2162,182043,901,11500,3534,81860,3355,154425,4423,236285,California
Sonoma,2021-04-10,3962,384674,1717,188886,1682,183725,563,12063,1169,80808,2776,157201,1724,238009,California
Sonoma,2021-04-11,1296,385970,617,189503,597,184322,82,12145,444,80484,848,158049,524,238533,California
Sonoma,2021-04-12,5005,390975,2079,191582,2431,186753,495,12640,1854,79693,3128,161177,2337,240870,California
Sonoma,2021-04-13,7995,398970,4695,196277,3295,190048,5,12645,3044,77812,4929,166106,3048,243918,California
Sonoma,2021-04-14,6762,405732,3827,200104,2915,192963,20,12665,2560,76202,4189,170295,2579,246497,California
Sonoma,2021-04-15,7626,413358,4331,204435,3294,196257,1,12666,3635,75869,3969,174264,3636,250133,California
Sonoma,2021-04-16,6989,420347,3497,207932,3490,199747,2,12668,3899,76692,3079,177343,3902,254035,California
Sonoma,2021-04-17,3577,423924,1848,209780,1729,201476,0,12668,1685,76516,1863,179206,1687,255722,California
Sonoma,2021-04-18,1425,425349,1029,210809,396,201872,0,12668,548,76194,871,180077,549,256271,California
Sonoma,2021-04-19,3491,428840,1918,212727,1572,203444,1,12669,1529,75769,1955,182032,1530,257801,California
Sonoma,2021-04-20,6475,435315,3569,216296,2906,206350,0,12669,2388,74090,4069,186101,2390,260191,California
Sonoma,2021-04-21,6952,442267,4398,220694,2552,208902,2,12671,3141,73453,3780,189881,3143,263334,California
Sonoma,2021-04-22,6622,448889,4636,225330,1985,210887,1,12672,2646,72152,3948,193829,2647,265981,California
Sonoma,2021-04-23,7721,456610,4768,230098,2946,213833,7,12679,3733,71931,3962,197791,3741,269722,California
Sonoma,2021-04-24,2848,459458,1537,231635,1296,215129,15,12694,1559,72224,1282,199073,1575,271297,California
Sonoma,2021-04-25,1102,460560,803,232438,299,215428,0,12694,434,71996,662,199735,434,271731,California
Sonoma,2021-04-26,3038,463598,1446,233884,1564,216992,28,12722,1639,72275,1388,201123,1667,273398,California
Sonoma,2021-04-27,5640,469238,3804,237688,1710,218702,126,12848,2235,71247,3388,204511,2360,275758,California
Sonoma,2021-04-28,5084,474322,3316,241004,1562,220264,206,13054,2051,70487,3011,207522,2251,278009,California
Sonoma,2021-04-29,5225,479547,3676,244680,1403,221667,146,13200,1949,69333,3250,210772,2096,280105,California
Sonoma,2021-04-30,5659,485206,3704,248384,1660,223327,295,13495,1849,67691,3784,214556,2142,282247,California
Sonoma,2021-05-01,2603,487809,1839,250223,657,223984,107,13602,1230,67666,1358,215914,1333,283580,California
Sonoma,2021-05-02,885,488694,659,250882,174,224158,52,13654,562,67958,323,216237,615,284195,California
Sonoma,2021-05-03,3326,492020,1722,252604,1450,225608,154,13808,1089,66978,2218,218455,1238,285433,California
Sonoma,2021-05-04,4690,496710,2440,255044,2063,227671,187,13995,1458,65415,3200,221655,1637,287070,California
Sonoma,2021-05-05,3803,500513,2231,257275,1375,229046,197,14192,1342,64514,2439,224094,1538,288608,California
Sonoma,2021-05-06,4693,505206,2467,259742,2094,231140,132,14324,1315,62656,3302,227396,1444,290052,California
Sonoma,2021-05-07,3712,508918,2373,262115,1213,232353,126,14450,1096,61282,2595,229991,1221,291273,California
Sonoma,2021-05-08,1970,510888,1311,263426,565,232918,94,14544,688,60799,1265,231256,782,292055,California
Sonoma,2021-05-09,509,511397,287,263713,179,233097,43,14587,160,60657,345,231601,203,292258,California
Sonoma,2021-05-10,2383,513780,1055,264768,1195,234292,133,14720,288,58999,2076,233677,418,292676,California
Sonoma,2021-05-11,3671,517451,1990,266758,1553,235845,128,14848,877,57233,2771,236448,1005,293681,California
Sonoma,2021-05-12,4139,521590,2546,269304,1440,237285,153,15001,849,54961,3273,239721,1001,294682,California
Sonoma,2021-05-13,5067,526657,2885,272189,2048,239333,134,15135,1669,53385,3377,243098,1801,296483,California
Sonoma,2021-05-14,5939,532596,3666,275855,2135,241468,138,15273,2232,52069,3687,246785,2371,298854,California
Sonoma,2021-05-15,3038,535634,2239,278094,737,242205,62,15335,1895,52898,1129,247914,1958,300812,California
Sonoma,2021-05-16,1359,536993,1138,279232,162,242367,59,15394,1000,53606,351,248265,1059,301871,California
Sonoma,2021-05-17,2478,539471,1840,281072,542,242909,96,15490,902,53034,1568,249833,996,302867,California
Sonoma,2021-05-18,4387,543858,2894,283966,1383,244292,110,15600,1451,51686,2909,252742,1561,304428,California
Sonoma,2021-05-19,3940,547798,2457,286423,1368,245660,115,15715,1488,50855,2433,255175,1602,306030,California
Sonoma,2021-05-20,3485,551283,2277,288700,1114,246774,94,15809,1324,50122,2146,257321,1413,307443,California
Sonoma,2021-05-21,4349,555632,2446,291146,1773,248547,130,15939,1516,48951,2804,260125,1633,309076,California
Sonoma,2021-05-22,2410,558042,1328,292474,1042,249589,40,15979,674,47948,1717,261842,714,309790,California
Sonoma,2021-05-23,1517,559559,1236,293710,264,249853,17,15996,772,47997,740,262582,789,310579,California
Sonoma,2021-05-24,2053,561612,1280,294990,639,250492,134,16130,660,47431,1360,263942,794,311373,California
Sonoma,2021-05-25,3000,564612,1834,296824,1075,251567,91,16221,741,46019,2241,266183,829,312202,California
Sonoma,2021-05-26,2533,567145,1765,298589,655,252222,113,16334,1014,45644,1500,267683,1125,313327,California
Sonoma,2021-05-27,2116,569261,1156,299745,863,253085,97,16431,692,45023,1407,269090,786,314113,California
Sonoma,2021-05-28,2235,571496,1159,300904,983,254068,93,16524,629,44152,1593,270683,722,314835,California
Sonoma,2021-05-29,1373,572869,940,301844,364,254432,69,16593,639,44135,725,271408,708,315543,California
Sonoma,2021-05-30,354,573223,217,302061,126,254558,11,16604,135,44070,210,271618,145,315688,California
Sonoma,2021-05-31,73,573296,28,302089,44,254602,1,16605,19,44037,53,271671,20,315708,California
Sonoma,2021-06-01,2013,575309,1157,303246,778,255380,78,16683,720,43556,1275,272946,794,316502,California
Sonoma,2021-06-02,1613,576922,992,304238,505,255885,116,16799,648,43357,959,273905,760,317262,California
Sonoma,2021-06-03,2060,578982,1421,305659,557,256442,82,16881,439,42267,1610,275515,520,317782,California
Sonoma,2021-06-04,2758,581740,2246,307905,402,256844,110,16991,524,40675,2224,277739,632,318414,California
Sonoma,2021-06-05,1859,583599,1529,309434,299,257143,31,17022,282,39417,1571,279310,313,318727,California
Sonoma,2021-06-06,1037,584636,957,310391,70,257213,10,17032,142,38680,890,280200,153,318880,California
Sonoma,2021-06-07,1513,586149,1267,311658,192,257405,54,17086,341,37908,1164,281364,392,319272,California
Sonoma,2021-06-08,1912,588061,1533,313191,330,257735,49,17135,526,37109,1372,282736,573,319845,California
Sonoma,2021-06-09,1678,589739,1392,314583,224,257959,62,17197,398,36304,1265,284001,460,320305,California
Sonoma,2021-06-10,1871,591610,1528,316111,237,258196,106,17303,557,35666,1299,285300,661,320966,California
Sonoma,2021-06-11,2039,593649,1664,317775,283,258479,92,17395,548,34822,1484,286784,640,321606,California
Sonoma,2021-06-12,1144,594793,905,318680,191,258670,48,17443,350,34434,786,287570,398,322004,California
Sonoma,2021-06-13,575,595368,479,319159,77,258747,19,17462,108,34096,464,288034,126,322130,California
Sonoma,2021-06-14,973,596341,699,319858,211,258958,63,17525,354,33904,609,288643,417,322547,California
Sonoma,2021-06-15,1880,598221,1406,321264,364,259322,110,17635,613,33373,1253,289896,722,323269,California
Sonoma,2021-06-16,1613,599834,1238,322502,273,259595,102,17737,512,32891,1093,290989,611,323880,California
Sonoma,2021-06-17,1054,600888,796,323298,176,259771,82,17819,413,32749,636,291625,494,324374,California
Sonoma,2021-06-18,1081,601969,774,324072,205,259976,102,17921,451,32679,619,292244,549,324923,California
Sonoma,2021-06-19,843,602812,697,324769,107,260083,39,17960,276,32429,564,292808,314,325237,California
Sonoma,2021-06-20,243,603055,201,324970,36,260119,6,17966,83,32362,156,292964,89,325326,California
Sonoma,2021-06-21,548,603603,313,325283,157,260276,78,18044,258,32422,275,293239,335,325661,California
Sonoma,2021-06-22,1261,604864,998,326281,170,260446,93,18137,582,32423,671,293910,672,326333,California
Sonoma,2021-06-23,1232,606096,948,327229,199,260645,85,18222,473,32232,749,294659,558,326891,California
Sonoma,2021-06-24,962,607058,641,327870,220,260865,101,18323,422,32224,529,295188,521,327412,California
Sonoma,2021-06-25,1208,608266,924,328794,203,261068,81,18404,522,32160,665,295853,601,328013,California
Sonoma,2021-06-26,694,608960,497,329291,117,261185,80,18484,332,32213,358,296211,411,328424,California
Sonoma,2021-06-27,199,609159,165,329456,23,261208,11,18495,102,32232,94,296305,113,328537,California
Sonoma,2021-06-28,716,609875,578,330034,82,261290,56,18551,313,32198,402,296707,368,328905,California
Sonoma,2021-06-29,962,610837,742,330776,170,261460,50,18601,406,32102,552,297259,456,329361,California
Sonoma,2021-06-30,908,611745,704,331480,162,261622,42,18643,397,32037,503,297762,438,329799,California
Sonoma,2021-07-01,989,612734,772,332252,143,261765,74,18717,433,31990,551,298313,504,330303,California
Sonoma,2021-07-02,780,613514,559,332811,172,261937,49,18766,370,32006,403,298716,419,330722,California
Sonoma,2021-07-03,572,614086,473,333284,74,262011,25,18791,231,31924,338,299054,256,330978,California
Sonoma,2021-07-04,22,614108,13,333297,8,262019,1,18792,14,31931,8,299062,15,330993,California
Sonoma,2021-07-05,333,614441,251,333548,58,262077,24,18816,153,31928,179,299241,176,331169,California
Sonoma,2021-07-06,1138,615579,912,334460,153,262230,73,18889,417,31706,710,299951,488,331657,California
Sonoma,2021-07-07,792,616371,602,335062,133,262363,57,18946,313,31602,475,300426,371,332028,California
Sonoma,2021-07-08,889,617260,678,335740,124,262487,87,19033,355,31512,530,300956,440,332468,California
Sonoma,2021-07-09,859,618119,641,336381,158,262645,60,19093,402,31518,455,301411,461,332929,California
Sonoma,2021-07-10,612,618731,490,336871,81,262726,41,19134,268,31487,338,301749,307,333236,California
Sonoma,2021-07-11,225,618956,155,337026,67,262793,3,19137,92,31450,132,301881,95,333331,California
Sonoma,2021-07-12,575,619531,419,337445,110,262903,46,19183,238,31402,330,302211,282,333613,California
Sonoma,2021-07-13,1044,620575,844,338289,140,263043,60,19243,406,31234,633,302844,465,334078,California
Sonoma,2021-07-14,724,621299,572,338861,115,263158,37,19280,327,31205,393,303237,364,334442,California
Sonoma,2021-07-15,950,622249,774,339635,115,263273,61,19341,436,31191,510,303747,496,334938,California
Sonoma,2021-07-16,884,623133,689,340324,151,263424,44,19385,412,31177,470,304217,456,335394,California
Sonoma,2021-07-17,797,623930,651,340975,107,263531,39,19424,348,31120,443,304660,386,335780,California
Sonoma,2021-07-18,198,624128,157,341132,25,263556,16,19440,100,31140,94,304754,114,335894,California
Sonoma,2021-07-19,702,624830,523,341655,119,263675,60,19500,337,31178,356,305110,394,336288,California
Sonoma,2021-07-20,1058,625888,867,342522,132,263807,59,19559,551,31289,497,305607,608,336896,California
Sonoma,2021-07-21,806,626694,662,343184,111,263918,33,19592,409,31337,393,306000,441,337337,California
Sonoma,2021-07-22,1014,627708,803,343987,157,264075,54,19646,496,31375,511,306511,549,337886,California
Sonoma,2021-07-23,915,628623,667,344654,182,264257,66,19712,466,31467,440,306951,532,338418,California
Sonoma,2021-07-24,690,629313,558,345212,94,264351,38,19750,412,31643,273,307224,449,338867,California
Sonoma,2021-07-25,207,629520,161,345373,38,264389,8,19758,140,31727,62,307286,146,339013,California
Sonoma,2021-07-26,559,630079,415,345788,104,264493,40,19798,362,31936,192,307478,401,339414,California
Sonoma,2021-07-27,1140,631219,950,346738,139,264632,51,19849,668,32189,464,307942,717,340131,California
Sonoma,2021-07-28,768,631987,600,347338,108,264740,60,19909,416,32320,345,308287,476,340607,California
Sonoma,2021-07-29,1008,632995,813,348151,138,264878,57,19966,610,32594,392,308679,666,341273,California
Sonoma,2021-07-30,986,633981,781,348932,179,265057,26,19992,559,32765,414,309093,585,341858,California
Sonoma,2021-07-31,889,634870,713,349645,130,265187,46,20038,599,33124,286,309379,645,342503,California
Sonoma,2021-08-01,274,635144,201,349846,68,265255,5,20043,175,33215,89,309468,180,342683,California
Sonoma,2021-08-02,677,635821,492,350338,149,265404,36,20079,403,33387,267,309735,439,343122,California
Sonoma,2021-08-03,1441,637262,1187,351525,174,265578,80,20159,927,33888,506,310241,1007,344129,California
Sonoma,2021-08-04,1118,638380,891,352416,167,265745,60,20219,682,34204,425,310666,741,344870,California
Sonoma,2021-08-05,1148,639528,940,353356,154,265899,54,20273,669,34458,469,311135,723,345593,California
Sonoma,2021-08-06,1234,640762,972,354328,172,266071,90,20363,775,34879,442,311577,863,346456,California
Sonoma,2021-08-07,836,641598,676,355004,126,266197,34,20397,489,35064,338,311915,523,346979,California
Sonoma,2021-08-08,278,641876,222,355226,55,266252,1,20398,158,35108,115,312030,159,347138,California
Sonoma,2021-08-09,836,642712,654,355880,109,266361,73,20471,470,35305,345,312375,542,347680,California
Sonoma,2021-08-10,1232,643944,1024,356904,174,266535,34,20505,685,35489,535,312910,719,348399,California
Sonoma,2021-08-11,1000,644944,797,357701,152,266687,51,20556,562,35686,417,313327,614,349013,California
Sonoma,2021-08-12,941,645885,721,358422,164,266851,56,20612,471,35754,459,313786,527,349540,California
Sonoma,2021-08-13,1093,646978,840,359262,207,267058,46,20658,618,35968,449,314235,663,350203,California
Sonoma,2021-08-14,805,647783,643,359905,130,267188,32,20690,405,36041,364,314599,437,350640,California
Sonoma,2021-08-15,258,648041,194,360099,63,267251,1,20691,133,36063,112,314711,134,350774,California
Sonoma,2021-08-16,827,648868,575,360674,213,267464,39,20730,348,36087,363,315074,387,351161,California
Sonoma,2021-08-17,1274,650142,983,361657,250,267714,41,20771,562,36080,609,315683,602,351763,California
Sonoma,2021-08-18,1009,651151,730,362387,215,267929,64,20835,436,36163,417,316100,500,352263,California
Sonoma,2021-08-19,1261,652412,903,363290,311,268240,47,20882,439,36088,559,316659,484,352747,California
Sonoma,2021-08-20,1570,653982,1056,364346,461,268701,53,20935,574,36107,605,317264,624,353371,California
Sonoma,2021-08-21,1061,655043,803,365149,242,268943,16,20951,303,35899,528,317792,320,353691,California
Sonoma,2021-08-22,310,655353,176,365325,130,269073,4,20955,116,35899,120,317912,120,353811,California
Sonoma,2021-08-23,815,656168,565,365890,231,269304,19,20974,336,35939,314,318226,354,354165,California
Sonoma,2021-08-24,1595,657763,1236,367126,297,269601,62,21036,525,35732,793,319019,586,354751,California
Sonoma,2021-08-25,1254,659017,946,368072,263,269864,45,21081,424,35618,584,319603,470,355221,California
Sonoma,2021-08-26,1294,660311,963,369035,277,270141,54,21135,434,35503,603,320206,488,355709,California
Sonoma,2021-08-27,1442,661753,1063,370098,328,270469,51,21186,474,35316,709,320915,522,356231,California
Sonoma,2021-08-28,1001,662754,760,370858,220,270689,21,21207,326,35174,489,321404,347,356578,California
Sonoma,2021-08-29,342,663096,228,371086,110,270799,4,21211,114,35141,151,321555,118,356696,California
Sonoma,2021-08-30,724,663820,496,371582,204,271003,24,21235,204,35045,324,321879,228,356924,California
Stanislaus,2020-12-15,6,6,6,6,0,0,0,0,6,6,0,0,6,6,California
Stanislaus,2020-12-16,43,49,43,49,0,0,0,0,43,49,0,0,43,49,California
Stanislaus,2020-12-17,77,126,77,126,0,0,0,0,77,126,0,0,77,126,California
Stanislaus,2020-12-18,353,479,347,473,6,6,0,0,353,479,0,0,353,479,California
Stanislaus,2020-12-19,134,613,134,607,0,6,0,0,134,613,0,0,134,613,California
Stanislaus,2020-12-20,90,703,89,696,1,7,0,0,90,703,0,0,90,703,California
Stanislaus,2020-12-21,1011,1714,1010,1706,1,8,0,0,1010,1713,1,1,1011,1714,California
Stanislaus,2020-12-22,805,2519,792,2498,13,21,0,0,805,2518,0,1,805,2519,California
Stanislaus,2020-12-23,456,2975,436,2934,20,41,0,0,455,2973,1,2,456,2975,California
Stanislaus,2020-12-24,96,3071,88,3022,8,49,0,0,96,3069,0,2,96,3071,California
Stanislaus,2020-12-26,55,3126,11,3033,44,93,0,0,55,3124,0,2,55,3126,California
Stanislaus,2020-12-27,11,3137,6,3039,5,98,0,0,11,3135,0,2,11,3137,California
Stanislaus,2020-12-28,490,3627,397,3436,93,191,0,0,489,3623,1,3,489,3626,California
Stanislaus,2020-12-29,504,4131,416,3852,88,279,0,0,504,4127,0,3,504,4130,California
Stanislaus,2020-12-30,547,4678,291,4143,256,535,0,0,546,4672,1,4,546,4676,California
Stanislaus,2020-12-31,284,4962,162,4305,122,657,0,0,284,4956,0,4,284,4960,California
Stanislaus,2021-01-01,23,4985,10,4315,13,670,0,0,22,4977,1,5,22,4982,California
Stanislaus,2021-01-02,34,5019,26,4341,8,678,0,0,34,5011,0,5,34,5016,California
Stanislaus,2021-01-03,89,5108,86,4427,3,681,0,0,89,5100,0,5,89,5105,California
Stanislaus,2021-01-04,242,5350,161,4588,81,762,0,0,242,5342,0,5,242,5347,California
Stanislaus,2021-01-05,867,6217,367,4955,500,1262,0,0,838,6162,29,34,849,6196,California
Stanislaus,2021-01-06,1020,7237,610,5565,410,1672,0,0,936,7026,81,115,945,7141,California
Stanislaus,2021-01-07,1096,8333,716,6281,380,2052,0,0,896,7731,196,311,901,8042,California
Stanislaus,2021-01-08,1316,9649,753,7034,563,2615,0,0,952,8337,361,672,967,9009,California
Stanislaus,2021-01-09,296,9945,147,7181,149,2764,0,0,207,8455,89,761,207,9216,California
Stanislaus,2021-01-10,50,9995,21,7202,29,2793,0,0,30,8465,20,781,30,9246,California
Stanislaus,2021-01-11,1536,11531,1246,8448,290,3083,0,0,580,8117,948,1729,600,9846,California
Stanislaus,2021-01-12,1497,13028,880,9328,617,3700,0,0,833,8313,660,2389,856,10702,California
Stanislaus,2021-01-13,1472,14500,696,10024,776,4476,0,0,1130,9125,341,2730,1153,11855,California
Stanislaus,2021-01-14,2291,16791,291,10315,2000,6476,0,0,2077,11096,209,2939,2180,14035,California
Stanislaus,2021-01-15,2872,19663,1176,11491,1696,8172,0,0,2683,13706,183,3122,2793,16828,California
Stanislaus,2021-01-16,476,20139,51,11542,425,8597,0,0,457,14147,18,3140,459,17287,California
Stanislaus,2021-01-17,243,20382,203,11745,40,8637,0,0,234,14373,8,3148,234,17521,California
Stanislaus,2021-01-18,2217,22599,1032,12777,1185,9822,0,0,1801,15859,410,3558,1896,19417,California
Stanislaus,2021-01-19,1281,23880,729,13506,552,10374,0,0,822,16229,454,4012,824,20241,California
Stanislaus,2021-01-20,1051,24931,500,14006,551,10925,0,0,752,16685,296,4308,752,20993,California
Stanislaus,2021-01-21,3768,28699,3025,17031,743,11668,0,0,3374,19823,389,4697,3527,24520,California
Stanislaus,2021-01-22,1131,29830,315,17346,816,12484,0,0,1084,20867,43,4740,1087,25607,California
Stanislaus,2021-01-23,379,30209,41,17387,338,12822,0,0,319,21129,58,4798,320,25927,California
Stanislaus,2021-01-24,315,30524,99,17486,216,13038,0,0,249,21315,66,4864,252,26179,California
Stanislaus,2021-01-25,3226,33750,244,17730,2982,16020,0,0,2849,24011,340,5204,3036,29215,California
Stanislaus,2021-01-26,1768,35518,762,18492,1006,17026,0,0,1306,24890,451,5655,1330,30545,California
Stanislaus,2021-01-27,1950,37468,1080,19572,870,17896,0,0,1230,25459,664,6319,1233,31778,California
Stanislaus,2021-01-28,2256,39724,1541,21113,715,18611,0,0,1725,26749,519,6838,1809,33587,California
Stanislaus,2021-01-29,2502,42226,1226,22339,1276,19887,0,0,1919,28214,524,7362,1989,35576,California
Stanislaus,2021-01-30,298,42524,133,22472,165,20052,0,0,229,28388,56,7418,230,35806,California
Stanislaus,2021-01-31,375,42899,318,22790,57,20109,0,0,359,28734,13,7431,359,36165,California
Stanislaus,2021-02-01,1351,44250,581,23371,770,20879,0,0,983,29364,353,7784,983,37148,California
Stanislaus,2021-02-02,1273,45523,359,23730,914,21793,0,0,826,29760,434,8218,830,37978,California
Stanislaus,2021-02-03,2677,48200,1237,24967,1440,23233,0,0,1969,31042,704,8922,1986,39964,California
Stanislaus,2021-02-04,2144,50344,723,25690,1421,24654,0,0,1613,32149,517,9439,1624,41588,California
Stanislaus,2021-02-05,2906,53250,1493,27183,1413,26067,0,0,1614,32572,1210,10649,1633,43221,California
Stanislaus,2021-02-06,903,54153,306,27489,597,26664,0,0,705,33084,195,10844,707,43928,California
Stanislaus,2021-02-07,225,54378,197,27686,28,26692,0,0,35,32935,185,11029,36,43964,California
Stanislaus,2021-02-08,2098,56476,1362,29048,736,27428,0,0,1137,33192,909,11938,1166,45130,California
Stanislaus,2021-02-09,1879,58355,797,29845,1082,28510,0,0,1064,33487,781,12719,1076,46206,California
Stanislaus,2021-02-10,1998,60353,545,30390,1453,29963,0,0,1051,33632,908,13627,1053,47259,California
Stanislaus,2021-02-11,5483,65836,3311,33701,2172,32135,0,0,1239,30937,3944,17571,1249,48508,California
Stanislaus,2021-02-12,3369,69205,931,34632,2438,34573,0,0,1480,30647,1784,19355,1494,50002,California
Stanislaus,2021-02-13,1388,70593,676,35308,712,35285,0,0,1014,31301,365,19720,1019,51021,California
Stanislaus,2021-02-14,426,71019,171,35479,255,35540,0,0,352,31583,71,19791,353,51374,California
Stanislaus,2021-02-15,1851,72870,235,35714,1616,37156,0,0,589,31044,1135,20926,596,51970,California
Stanislaus,2021-02-16,1396,74266,430,36144,966,38122,0,0,590,30847,790,21716,593,52563,California
Stanislaus,2021-02-17,2823,77089,1734,37878,1089,39211,0,0,1927,31911,884,22600,1948,54511,California
Stanislaus,2021-02-18,3431,80520,1943,39821,1488,40699,0,0,1760,32189,1555,24155,1833,56344,California
Stanislaus,2021-02-19,2869,83389,1124,40945,1745,42444,0,0,1542,32492,1261,25416,1564,57908,California
Stanislaus,2021-02-20,767,84156,389,41334,378,42822,0,0,472,32692,273,25689,473,58381,California
Stanislaus,2021-02-21,921,85077,703,42037,218,43040,0,0,536,32887,355,26044,550,58931,California
Stanislaus,2021-02-22,2398,87475,1716,43753,682,43722,0,0,1633,33783,740,26784,1636,60567,California
Stanislaus,2021-02-23,3773,91248,685,44438,3088,46810,0,0,1710,33647,1857,28641,1721,62288,California
Stanislaus,2021-02-24,4274,95522,2917,47355,1357,48167,0,0,3117,35645,1124,29765,3122,65410,California
Stanislaus,2021-02-25,4020,99542,2761,50116,1259,49426,0,0,3181,38017,813,30578,3185,68595,California
Stanislaus,2021-02-26,4268,103810,1230,51346,3038,52464,0,0,2842,39517,1355,31933,2855,71450,California
Stanislaus,2021-02-27,2112,105922,721,52067,1390,53854,1,1,1872,41183,209,32142,1875,73325,California
Stanislaus,2021-02-28,842,106764,269,52336,573,54427,0,1,782,41919,47,32189,783,74108,California
Stanislaus,2021-03-01,3186,109950,1693,54029,1487,55914,6,7,1687,42186,1442,33631,1709,75817,California
Stanislaus,2021-03-02,2452,112402,1466,55495,984,56898,2,9,1680,43122,752,34383,1688,77505,California
Stanislaus,2021-03-03,3773,116175,2278,57773,1490,58388,5,14,2936,45250,816,35199,2944,80449,California
Stanislaus,2021-03-04,5515,121690,3152,60925,2346,60734,17,31,4222,48238,1247,36446,4235,84684,California
Stanislaus,2021-03-05,4165,125855,1154,62079,2995,63729,16,47,3136,50397,992,37438,3151,87835,California
Stanislaus,2021-03-06,3615,129470,2246,64325,1275,65004,94,141,2743,52371,863,38301,2837,90672,California
Stanislaus,2021-03-07,917,130387,394,64719,445,65449,78,219,684,52905,227,38528,761,91433,California
Stanislaus,2021-03-08,2036,132423,881,65600,1057,66506,98,317,1342,53675,670,39198,1440,92873,California
Stanislaus,2021-03-09,2702,135125,1028,66628,1583,68089,91,408,1644,54374,1041,40239,1740,94613,California
Stanislaus,2021-03-10,5606,140731,2741,69369,2634,70723,231,639,3774,56590,1801,42040,4017,98630,California
Stanislaus,2021-03-11,6206,146937,3385,72754,2337,73060,484,1123,4146,59358,1865,43905,4633,103263,California
Stanislaus,2021-03-12,6372,153309,1373,74127,3018,76078,1981,3104,2931,60859,3402,47307,4903,108166,California
Stanislaus,2021-03-13,3758,157067,2347,76474,1339,77417,72,3176,2841,62869,908,48215,2918,111084,California
Stanislaus,2021-03-14,1004,158071,595,77069,352,77769,57,3233,493,62915,505,48720,551,111635,California
Stanislaus,2021-03-15,3849,161920,2013,79082,1472,79241,364,3597,1660,62860,2084,50804,2029,113664,California
Stanislaus,2021-03-16,5141,167061,2524,81606,2176,81417,441,4038,3682,65547,1433,52237,4120,117784,California
Stanislaus,2021-03-17,4970,172031,2958,84564,1832,83249,180,4218,2994,66799,1925,54162,3177,120961,California
Stanislaus,2021-03-18,5596,177627,3477,88041,2052,85301,67,4285,3051,67529,2391,56553,3121,124082,California
Stanislaus,2021-03-19,6056,183683,1597,89638,2937,88238,1522,5807,3206,69441,2805,59358,4717,128799,California
Stanislaus,2021-03-20,3868,187551,3031,92669,769,89007,68,5875,3384,72415,479,59837,3453,132252,California
Stanislaus,2021-03-21,1024,188575,915,93584,45,89052,64,5939,776,73015,240,60077,840,133092,California
Stanislaus,2021-03-22,3034,191609,1407,94991,902,89954,725,6664,1411,73574,1580,61657,2139,135231,California
Stanislaus,2021-03-23,4147,195756,2118,97109,1769,91723,260,6924,2971,75679,1146,62803,3251,138482,California
Stanislaus,2021-03-24,4736,200492,3302,100411,1355,93078,79,7003,2755,76588,1929,64732,2838,141320,California
Stanislaus,2021-03-25,4455,204947,3023,103434,1418,94496,14,7017,1963,76164,2406,67138,1982,143302,California
Stanislaus,2021-03-26,4982,209929,1431,104865,3478,97974,73,7090,2547,76402,2393,69531,2631,145933,California
Stanislaus,2021-03-27,4449,214378,2777,107642,1589,99563,83,7173,1391,74847,3034,72565,1479,147412,California
Stanislaus,2021-03-28,1121,215499,449,108091,564,100127,108,7281,319,74494,785,73350,432,147844,California
Stanislaus,2021-03-29,3199,218698,1853,109944,1305,101432,41,7322,2170,75694,1015,74365,2215,150059,California
Stanislaus,2021-03-30,3881,222579,2090,112034,1765,103197,26,7348,2390,76641,1475,75840,2422,152481,California
Stanislaus,2021-03-31,5650,228229,3894,115928,1627,104824,129,7477,2934,77019,2689,78529,3067,155548,California
Stanislaus,2021-04-01,5963,234192,3882,119810,1965,106789,116,7593,2759,76733,3168,81697,2882,158430,California
Stanislaus,2021-04-02,5228,239420,1239,121049,3821,110610,168,7761,2379,76545,2744,84441,2556,160986,California
Stanislaus,2021-04-03,4701,244121,3449,124498,1215,111825,37,7798,2253,76411,2433,86874,2299,163285,California
Stanislaus,2021-04-04,1344,245465,480,124978,834,112659,30,7828,652,76414,683,87557,686,163971,California
Stanislaus,2021-04-05,3772,249237,2564,127542,950,113609,258,8086,2451,77817,1308,88865,2711,166682,California
Stanislaus,2021-04-06,5983,255220,4251,131793,1445,115054,287,8373,3220,78585,2741,91606,3509,170191,California
Stanislaus,2021-04-07,6557,261777,3686,135479,2429,117483,442,8815,2900,78303,3631,95237,3349,173540,California
Stanislaus,2021-04-08,5945,267722,3438,138917,2060,119543,447,9262,2955,78748,2957,98194,3402,176942,California
Stanislaus,2021-04-09,5029,272751,2192,141109,2455,121998,382,9644,2291,78719,2706,100900,2677,179619,California
Stanislaus,2021-04-10,6530,279281,4006,145115,881,122879,1643,11287,1998,77848,4503,105403,3632,183251,California
Stanislaus,2021-04-11,1531,280812,856,145971,542,123421,133,11420,660,77777,866,106269,795,184046,California
Stanislaus,2021-04-12,3803,284615,2130,148101,1225,124646,448,11868,1955,78380,1813,108082,2416,186462,California
Stanislaus,2021-04-13,5424,290039,3511,151612,1899,126545,14,11882,2972,78966,2398,110480,2984,189446,California
Stanislaus,2021-04-14,4877,294916,3384,154996,1491,128036,2,11884,2404,78945,2431,112911,2410,191856,California
Stanislaus,2021-04-15,5660,300576,3466,158462,2191,130227,3,11887,3319,79985,2282,115193,3322,195178,California
Stanislaus,2021-04-16,4586,305162,1142,159604,3443,133670,1,11888,1939,79343,2586,117779,1944,197122,California
Stanislaus,2021-04-17,3199,308361,2159,161763,1040,134710,0,11888,1862,79885,1322,119101,1864,198986,California
Stanislaus,2021-04-18,825,309186,500,162263,324,135034,1,11889,512,80099,301,119402,515,199501,California
Stanislaus,2021-04-19,3713,312899,2530,164793,1181,136215,2,11891,1703,79846,1963,121365,1710,201211,California
Stanislaus,2021-04-20,4262,317161,2576,167369,1686,137901,0,11891,1818,79269,2398,123763,1821,203032,California
Stanislaus,2021-04-21,4200,321361,2824,170193,1375,139276,1,11892,1740,78610,2404,126167,1745,204777,California
Stanislaus,2021-04-22,4262,325623,2575,172768,1685,140961,2,11894,1716,77838,2492,128659,1720,206497,California
Stanislaus,2021-04-23,3966,329589,1039,173807,2925,143886,2,11896,1641,77266,2221,130880,1649,208146,California
Stanislaus,2021-04-24,3949,333538,3035,176842,914,144800,0,11896,1872,77088,2055,132935,1877,210023,California
Stanislaus,2021-04-25,974,334512,518,177360,456,145256,0,11896,704,77532,264,133199,708,210731,California
Stanislaus,2021-04-26,3744,338256,2517,179877,1221,146477,6,11902,1177,76183,2537,135736,1188,211919,California
Stanislaus,2021-04-27,4383,342639,2963,182840,1372,147849,48,11950,1271,74427,3078,138814,1322,213241,California
Stanislaus,2021-04-28,4700,347339,3238,186078,1398,149247,64,12014,1979,73786,2693,141507,2052,215293,California
Stanislaus,2021-04-29,4067,351406,2526,188604,1493,150740,48,12062,1607,73016,2433,143940,1663,216956,California
Stanislaus,2021-04-30,4945,356351,2253,190857,2606,153346,86,12148,1972,72138,2944,146884,2066,219022,California
Stanislaus,2021-05-01,2846,359197,2047,192904,758,154104,41,12189,1050,71454,1783,148667,1099,220121,California
Stanislaus,2021-05-02,1184,360381,719,193623,428,154532,37,12226,548,71416,628,149295,590,220711,California
Stanislaus,2021-05-03,2745,363126,2163,195786,509,155041,73,12299,1013,70792,1714,151009,1090,221801,California
Stanislaus,2021-05-04,3894,367020,2691,198477,1097,156138,106,12405,1205,69438,2671,153680,1317,223118,California
Stanislaus,2021-05-05,3591,370611,2374,200851,1141,157279,76,12481,1196,68347,2367,156047,1276,224394,California
Stanislaus,2021-05-06,3836,374447,2918,203769,794,158073,124,12605,1142,66953,2665,158712,1271,225665,California
Stanislaus,2021-05-07,2640,377087,1078,204847,1401,159474,161,12766,1039,66568,1586,160298,1201,226866,California
Stanislaus,2021-05-08,2090,379177,1469,206316,588,160062,33,12799,757,66054,1311,161609,797,227663,California
Stanislaus,2021-05-09,778,379955,405,206721,347,160409,26,12825,303,65912,472,162081,330,227993,California
Stanislaus,2021-05-10,1884,381839,1214,207935,571,160980,99,12924,507,65159,1361,163442,608,228601,California
Stanislaus,2021-05-11,2647,384486,1695,209630,792,161772,160,13084,784,64257,1851,165293,949,229550,California
Stanislaus,2021-05-12,2497,386983,1463,211093,923,162695,111,13195,949,63788,1531,166824,1062,230612,California
Stanislaus,2021-05-13,2297,389280,1405,212498,774,163469,118,13313,1074,63774,1212,168036,1198,231810,California
Stanislaus,2021-05-14,2924,392204,1392,213890,1396,164865,136,13449,1365,63741,1537,169573,1504,233314,California
Stanislaus,2021-05-15,2606,394810,1891,215781,664,165529,51,13500,1291,63791,1301,170874,1351,234665,California
Stanislaus,2021-05-16,1169,395979,812,216593,349,165878,8,13508,631,63900,534,171408,643,235308,California
Stanislaus,2021-05-17,2120,398099,1448,218041,588,166466,84,13592,1017,63913,1096,172504,1109,236417,California
Stanislaus,2021-05-18,2401,400500,1678,219719,608,167074,115,13707,1247,64132,1142,173646,1361,237778,California
Stanislaus,2021-05-19,3219,403719,2221,221940,843,167917,155,13862,1417,63925,1783,175429,1576,239354,California
Stanislaus,2021-05-20,2320,406039,1289,223229,921,168838,110,13972,926,63583,1382,176811,1040,240394,California
Stanislaus,2021-05-21,2574,408613,1294,224523,1181,170019,99,14071,1014,63158,1540,178351,1115,241509,California
Stanislaus,2021-05-22,2072,410685,1277,225800,724,170743,71,14142,909,62986,1154,179505,982,242491,California
Stanislaus,2021-05-23,1107,411792,733,226533,358,171101,16,14158,529,62959,573,180078,546,243037,California
Stanislaus,2021-05-24,1864,413656,1304,227837,479,171580,81,14239,744,62675,1115,181193,831,243868,California
Stanislaus,2021-05-25,1859,415515,1280,229117,478,172058,101,14340,894,62718,956,182149,999,244867,California
Stanislaus,2021-05-26,2086,417601,1314,230431,717,172775,55,14395,981,62657,1096,183245,1035,245902,California
Stanislaus,2021-05-27,1842,419443,1029,231460,728,173503,85,14480,635,62184,1194,184439,721,246623,California
Stanislaus,2021-05-28,2247,421690,1087,232547,1074,174577,86,14566,963,61956,1277,185716,1049,247672,California
Stanislaus,2021-05-29,1342,423032,871,233418,428,175005,43,14609,596,61855,742,186458,641,248313,California
Stanislaus,2021-05-30,478,423510,296,233714,149,175154,33,14642,216,61847,257,186715,249,248562,California
Stanislaus,2021-05-31,273,423783,136,233850,130,175284,7,14649,107,61795,166,186881,114,248676,California
Stanislaus,2021-06-01,1733,425516,1097,234947,581,175865,55,14704,646,61422,1075,187956,702,249378,California
Stanislaus,2021-06-02,1869,427385,1205,236152,593,176458,71,14775,780,61205,1072,189028,855,250233,California
Stanislaus,2021-06-03,1460,428845,885,237037,525,176983,50,14825,534,60882,910,189938,587,250820,California
Stanislaus,2021-06-04,1994,430839,1223,238260,702,177685,69,14894,748,60466,1237,191175,821,251641,California
Stanislaus,2021-06-05,1650,432489,1306,239566,301,177986,43,14937,530,59930,1109,192284,573,252214,California
Stanislaus,2021-06-06,568,433057,477,240043,82,178068,9,14946,195,59764,371,192655,205,252419,California
Stanislaus,2021-06-07,1657,434714,1276,241319,336,178404,45,14991,612,59388,1032,193687,656,253075,California
Stanislaus,2021-06-08,1978,436692,1504,242823,395,178799,79,15070,692,58885,1275,194962,772,253847,California
Stanislaus,2021-06-09,1896,438588,1353,244176,462,179261,81,15151,647,58369,1245,196207,729,254576,California
Stanislaus,2021-06-10,1531,440119,987,245163,479,179740,65,15216,624,58163,899,197106,693,255269,California
Stanislaus,2021-06-11,1548,441667,948,246111,550,180290,50,15266,571,57824,963,198069,624,255893,California
Stanislaus,2021-06-12,1085,442752,805,246916,254,180544,26,15292,402,57579,677,198746,432,256325,California
Stanislaus,2021-06-13,573,443325,429,247345,137,180681,7,15299,184,57386,385,199131,192,256517,California
Stanislaus,2021-06-14,1392,444717,996,248341,371,181052,25,15324,502,57034,879,200010,527,257044,California
Stanislaus,2021-06-15,1631,446348,1184,249525,400,181452,47,15371,545,56553,1077,201087,596,257640,California
Stanislaus,2021-06-16,1998,448346,1443,250968,486,181938,69,15440,794,56217,1200,202287,864,258504,California
Stanislaus,2021-06-17,1219,449565,793,251761,375,182313,51,15491,575,56207,639,202926,629,259133,California
Stanislaus,2021-06-18,1423,450988,892,252653,446,182759,85,15576,573,56023,845,203771,661,259794,California
Stanislaus,2021-06-19,879,451867,652,253305,183,182942,44,15620,385,55963,490,204261,430,260224,California
Stanislaus,2021-06-20,348,452215,254,253559,88,183030,6,15626,160,55942,187,204448,166,260390,California
Stanislaus,2021-06-21,1016,453231,606,254165,280,183310,130,15756,528,56119,483,204931,660,261050,California
Stanislaus,2021-06-22,1269,454500,933,255098,263,183573,73,15829,524,55986,732,205663,599,261649,California
Stanislaus,2021-06-23,1292,455792,880,255978,350,183923,62,15891,552,55863,737,206400,614,262263,California
Stanislaus,2021-06-24,975,456767,653,256631,272,184195,50,15941,492,55931,478,206878,546,262809,California
Stanislaus,2021-06-25,1138,457905,745,257376,331,184526,62,16003,484,55827,648,207526,544,263353,California
Stanislaus,2021-06-26,781,458686,591,257967,159,184685,31,16034,370,55821,407,207933,401,263754,California
Stanislaus,2021-06-27,424,459110,326,258293,87,184772,11,16045,215,55841,206,208139,226,263980,California
Stanislaus,2021-06-28,1072,460182,851,259144,176,184948,45,16090,478,55772,593,208732,524,264504,California
Stanislaus,2021-06-29,1165,461347,923,260067,197,185145,45,16135,536,55732,622,209354,582,265086,California
Stanislaus,2021-06-30,1139,462486,800,260867,303,185448,36,16171,554,55745,579,209933,592,265678,California
Stanislaus,2021-07-01,1161,463647,777,261644,344,185792,40,16211,561,55761,588,210521,604,266282,California
Stanislaus,2021-07-02,928,464575,562,262206,329,186121,37,16248,460,55799,458,210979,496,266778,California
Stanislaus,2021-07-03,533,465108,394,262600,123,186244,16,16264,269,55823,264,211243,288,267066,California
Stanislaus,2021-07-04,79,465187,46,262646,26,186270,7,16271,29,55810,49,211292,36,267102,California
Stanislaus,2021-07-05,637,465824,481,263127,151,186421,5,16276,294,55768,342,211634,300,267402,California
Stanislaus,2021-07-06,1016,466840,741,263868,227,186648,48,16324,468,55744,541,212175,517,267919,California
Stanislaus,2021-07-07,1102,467942,747,264615,300,186948,55,16379,450,55605,648,212823,509,268428,California
Stanislaus,2021-07-08,992,468934,641,265256,302,187250,49,16428,465,55598,521,213344,514,268942,California
Stanislaus,2021-07-09,1064,469998,681,265937,334,187584,49,16477,520,55636,533,213877,571,269513,California
Stanislaus,2021-07-10,610,470608,481,266418,118,187702,11,16488,294,55628,313,214190,305,269818,California
Stanislaus,2021-07-11,349,470957,268,266686,77,187779,4,16492,175,55639,169,214359,180,269998,California
Stanislaus,2021-07-12,1011,471968,758,267444,217,187996,36,16528,502,55675,504,214863,540,270538,California
Stanislaus,2021-07-13,919,472887,697,268141,183,188179,39,16567,474,55748,439,215302,512,271050,California
Stanislaus,2021-07-14,905,473792,611,268752,274,188453,20,16587,452,55770,447,215749,469,271519,California
Stanislaus,2021-07-15,968,474760,658,269410,286,188739,24,16611,471,55775,491,216240,496,272015,California
Stanislaus,2021-07-16,960,475720,623,270033,318,189057,19,16630,547,55933,409,216649,567,272582,California
Stanislaus,2021-07-17,691,476411,519,270552,144,189201,28,16658,377,56029,309,216958,405,272987,California
Stanislaus,2021-07-18,455,476866,364,270916,86,189287,5,16663,256,56094,197,217155,262,273249,California
Stanislaus,2021-07-19,864,477730,661,271577,188,189475,15,16678,470,56190,390,217545,486,273735,California
Stanislaus,2021-07-20,1088,478818,819,272396,220,189695,49,16727,577,56317,496,218041,623,274358,California
Stanislaus,2021-07-21,1183,480001,838,273234,309,190004,36,16763,657,56497,523,218564,703,275061,California
Stanislaus,2021-07-22,1185,481186,840,274074,302,190306,43,16806,661,56687,513,219077,703,275764,California
Stanislaus,2021-07-23,1115,482301,720,274794,373,190679,22,16828,694,56984,417,219494,714,276478,California
Stanislaus,2021-07-24,727,483028,543,275337,157,190836,27,16855,454,57194,271,219765,481,276959,California
Stanislaus,2021-07-25,461,483489,367,275704,85,190921,9,16864,381,57507,79,219844,392,277351,California
Stanislaus,2021-07-26,1031,484520,784,276488,226,191147,21,16885,717,57937,310,220154,740,278091,California
Stanislaus,2021-07-27,1060,485580,824,277312,209,191356,27,16912,654,58219,400,220554,682,278773,California
Stanislaus,2021-07-28,1112,486692,755,278067,308,191664,49,16961,683,58527,422,220976,730,279503,California
Stanislaus,2021-07-29,1282,487974,844,278911,402,192066,36,16997,802,58895,464,221440,832,280335,California
Stanislaus,2021-07-30,1294,489268,815,279726,458,192524,21,17018,880,59391,407,221847,903,281238,California
Stanislaus,2021-07-31,813,490081,622,280348,176,192700,15,17033,543,59687,263,222110,559,281797,California
Stanislaus,2021-08-01,504,490585,393,280741,105,192805,6,17039,377,59947,124,222234,384,282181,California
Stanislaus,2021-08-02,1235,491820,950,281691,251,193056,34,17073,829,60409,402,222636,864,283045,California
Stanislaus,2021-08-03,1256,493076,946,282637,271,193327,39,17112,825,60845,430,223066,866,283911,California
Stanislaus,2021-08-04,1299,494375,937,283574,320,193647,42,17154,866,61327,427,223493,909,284820,California
Stanislaus,2021-08-05,1281,495656,879,284453,377,194024,25,17179,847,61769,431,223924,873,285693,California
Stanislaus,2021-08-06,1384,497040,880,285333,467,194491,37,17216,952,62334,424,224348,989,286682,California
Stanislaus,2021-08-07,899,497939,689,286022,180,194671,30,17246,626,62720,269,224617,655,287337,California
Stanislaus,2021-08-08,608,498547,470,286492,127,194798,11,17257,435,62998,169,224786,447,287784,California
Stanislaus,2021-08-09,1371,499918,1057,287549,265,195063,49,17306,978,63643,383,225169,1028,288812,California
Stanislaus,2021-08-10,1233,501151,955,288504,246,195309,32,17338,805,64059,422,225591,838,289650,California
Stanislaus,2021-08-11,1419,502570,1007,289511,354,195663,58,17396,912,64530,497,226088,968,290618,California
Stanislaus,2021-08-12,1491,504061,999,290510,426,196089,66,17462,940,65000,538,226626,1008,291626,California
Stanislaus,2021-08-13,1655,505716,1100,291610,512,196601,43,17505,1085,65573,556,227182,1129,292755,California
Stanislaus,2021-08-14,1036,506752,782,292392,216,196817,38,17543,618,65826,404,227586,657,293412,California
Stanislaus,2021-08-15,835,507587,683,293075,149,196966,3,17546,544,66093,281,227867,548,293960,California
Stanislaus,2021-08-16,1478,509065,1066,294141,386,197352,26,17572,908,66498,530,228397,935,294895,California
Stanislaus,2021-08-17,1442,510507,1028,295169,366,197718,48,17620,832,66817,563,228960,882,295777,California
Stanislaus,2021-08-18,1593,512100,1100,296269,444,198162,49,17669,893,67148,612,229572,943,296720,California
Stanislaus,2021-08-19,1542,513642,1012,297281,468,198630,62,17731,917,67558,575,230147,985,297705,California
Stanislaus,2021-08-20,1788,515430,1097,298378,636,199266,55,17786,1025,67949,692,230839,1083,298788,California
Stanislaus,2021-08-21,1105,516535,808,299186,266,199532,31,17817,613,68148,446,231285,645,299433,California
Stanislaus,2021-08-22,690,517225,542,299728,147,199679,1,17818,378,68225,302,231587,379,299812,California
Stanislaus,2021-08-23,1620,518845,1192,300920,399,200078,29,17847,986,68660,588,232175,1023,300835,California
Stanislaus,2021-08-24,1548,520393,1259,302179,260,200338,29,17876,900,68990,604,232779,934,301769,California
Stanislaus,2021-08-25,1815,522208,1359,303538,408,200746,48,17924,951,69233,760,233539,1003,302772,California
Stanislaus,2021-08-26,1629,523837,1149,304687,444,201190,36,17960,887,69491,668,234207,926,303698,California
Stanislaus,2021-08-27,1829,525666,1285,305972,511,201701,33,17993,964,69689,803,235010,1001,304699,California
Stanislaus,2021-08-28,1044,526710,819,306791,192,201893,33,18026,482,69669,538,235548,518,305217,California
Stanislaus,2021-08-29,744,527454,586,307377,154,202047,4,18030,410,69761,325,235873,417,305634,California
Stanislaus,2021-08-30,780,528234,559,307936,206,202253,15,18045,407,69847,340,236213,426,306060,California
Sutter,2020-12-15,1,1,1,1,0,0,0,0,1,1,0,0,1,1,California
Sutter,2020-12-16,4,5,4,5,0,0,0,0,4,5,0,0,4,5,California
Sutter,2020-12-17,3,8,3,8,0,0,0,0,3,8,0,0,3,8,California
Sutter,2020-12-18,20,28,20,28,0,0,0,0,20,28,0,0,20,28,California
Sutter,2020-12-19,46,74,46,74,0,0,0,0,46,74,0,0,46,74,California
Sutter,2020-12-20,43,117,43,117,0,0,0,0,43,117,0,0,43,117,California
Sutter,2020-12-21,98,215,98,215,0,0,0,0,98,215,0,0,98,215,California
Sutter,2020-12-22,173,388,173,388,0,0,0,0,173,388,0,0,173,388,California
Sutter,2020-12-23,117,505,112,500,5,5,0,0,117,505,0,0,117,505,California
Sutter,2020-12-24,17,522,11,511,6,11,0,0,17,522,0,0,17,522,California
Sutter,2020-12-26,38,560,34,545,4,15,0,0,38,560,0,0,38,560,California
Sutter,2020-12-27,24,584,23,568,1,16,0,0,24,584,0,0,24,584,California
Sutter,2020-12-28,85,669,57,625,28,44,0,0,85,669,0,0,85,669,California
Sutter,2020-12-29,106,775,15,640,91,135,0,0,106,775,0,0,106,775,California
Sutter,2020-12-30,141,916,36,676,105,240,0,0,141,916,0,0,141,916,California
Sutter,2020-12-31,69,985,6,682,63,303,0,0,69,985,0,0,69,985,California
Sutter,2021-01-01,3,988,3,685,0,303,0,0,3,988,0,0,3,988,California
Sutter,2021-01-02,134,1122,132,817,2,305,0,0,134,1122,0,0,134,1122,California
Sutter,2021-01-03,1,1123,0,817,1,306,0,0,1,1123,0,0,1,1123,California
Sutter,2021-01-04,244,1367,137,954,107,413,0,0,244,1367,0,0,244,1367,California
Sutter,2021-01-05,100,1467,56,1010,44,457,0,0,97,1461,3,3,97,1464,California
Sutter,2021-01-06,202,1669,49,1059,153,610,0,0,197,1653,5,8,197,1661,California
Sutter,2021-01-07,255,1924,154,1213,101,711,0,0,246,1890,9,17,246,1907,California
Sutter,2021-01-08,151,2075,41,1254,110,821,0,0,133,2005,18,35,133,2040,California
Sutter,2021-01-09,45,2120,44,1298,1,822,0,0,3,1966,42,77,3,2043,California
Sutter,2021-01-10,392,2512,38,1336,354,1176,0,0,354,2283,37,114,354,2397,California
Sutter,2021-01-11,132,2644,116,1452,16,1192,0,0,24,2199,108,222,24,2421,California
Sutter,2021-01-12,201,2845,164,1616,37,1229,0,0,57,2112,144,366,57,2478,California
Sutter,2021-01-13,164,3009,100,1716,64,1293,0,0,72,2093,91,457,72,2550,California
Sutter,2021-01-14,148,3157,52,1768,96,1389,0,0,128,2201,20,477,128,2678,California
Sutter,2021-01-15,437,3594,130,1898,307,1696,0,0,422,2608,15,492,422,3100,California
Sutter,2021-01-16,392,3986,42,1940,350,2046,0,0,362,2940,30,522,362,3462,California
Sutter,2021-01-17,28,4014,25,1965,3,2049,0,0,12,2936,16,538,12,3474,California
Sutter,2021-01-18,121,4135,64,2029,57,2106,0,0,71,2957,50,588,71,3545,California
Sutter,2021-01-19,113,4248,46,2075,67,2173,0,0,87,3018,26,614,87,3632,California
Sutter,2021-01-20,275,4523,211,2286,64,2237,0,0,252,3247,23,637,252,3884,California
Sutter,2021-01-21,533,5056,359,2645,174,2411,0,0,514,3742,19,656,514,4398,California
Sutter,2021-01-22,243,5299,52,2697,191,2602,0,0,234,3967,9,665,234,4632,California
Sutter,2021-01-23,397,5696,39,2736,358,2960,0,0,371,4312,26,691,371,5003,California
Sutter,2021-01-24,18,5714,15,2751,3,2963,0,0,16,4326,2,693,16,5019,California
Sutter,2021-01-25,309,6023,195,2946,114,3077,0,0,153,4325,155,848,154,5173,California
Sutter,2021-01-26,255,6278,111,3057,144,3221,0,0,146,4363,108,956,146,5319,California
Sutter,2021-01-27,391,6669,257,3314,134,3355,0,0,319,4610,72,1028,319,5638,California
Sutter,2021-01-28,593,7262,360,3674,233,3588,0,0,412,4844,178,1206,412,6050,California
Sutter,2021-01-29,367,7629,89,3763,278,3866,0,0,244,4966,122,1328,244,6294,California
Sutter,2021-01-30,777,8406,38,3801,739,4605,0,0,766,5721,11,1339,766,7060,California
Sutter,2021-01-31,28,8434,27,3828,1,4606,0,0,28,5749,0,1339,28,7088,California
Sutter,2021-02-01,179,8613,50,3878,129,4735,0,0,139,5849,39,1378,139,7227,California
Sutter,2021-02-02,249,8862,26,3904,223,4958,0,0,212,6024,37,1415,212,7439,California
Sutter,2021-02-03,451,9313,38,3942,413,5371,0,0,216,6006,234,1649,216,7655,California
Sutter,2021-02-04,687,10000,369,4311,318,5689,0,0,630,6580,56,1705,630,8285,California
Sutter,2021-02-05,292,10292,33,4344,259,5948,0,0,140,6568,152,1857,140,8425,California
Sutter,2021-02-06,744,11036,30,4374,714,6662,0,0,724,7272,20,1877,724,9149,California
Sutter,2021-02-07,23,11059,19,4393,4,6666,0,0,18,7285,5,1882,18,9167,California
Sutter,2021-02-08,137,11196,34,4427,103,6769,0,0,99,7346,38,1920,99,9266,California
Sutter,2021-02-09,254,11450,50,4477,204,6973,0,0,189,7470,65,1985,189,9455,California
Sutter,2021-02-10,821,12271,386,4863,435,7408,0,0,179,7008,641,2626,179,9634,California
Sutter,2021-02-11,612,12883,272,5135,340,7748,0,0,317,7030,295,2921,317,9951,California
Sutter,2021-02-12,650,13533,71,5206,579,8327,0,0,320,7021,329,3250,320,10271,California
Sutter,2021-02-13,915,14448,48,5254,867,9194,0,0,794,7694,121,3371,794,11065,California
Sutter,2021-02-14,101,14549,27,5281,74,9268,0,0,89,7771,12,3383,89,11154,California
Sutter,2021-02-15,206,14755,70,5351,136,9404,0,0,125,7815,81,3464,125,11279,California
Sutter,2021-02-16,292,15047,44,5395,248,9652,0,0,205,7935,85,3549,205,11484,California
Sutter,2021-02-17,840,15887,439,5834,401,10053,0,0,138,7372,701,4250,138,11622,California
Sutter,2021-02-18,729,16616,61,5895,668,10721,0,0,505,7655,222,4472,505,12127,California
Sutter,2021-02-19,677,17293,381,6276,296,11017,0,0,466,7913,208,4680,466,12593,California
Sutter,2021-02-20,628,17921,59,6335,569,11586,0,0,519,8324,108,4788,519,13112,California
Sutter,2021-02-21,31,17952,28,6363,3,11589,0,0,9,8311,22,4810,9,13121,California
Sutter,2021-02-22,219,18171,126,6489,93,11682,0,0,87,8267,131,4941,87,13208,California
Sutter,2021-02-23,243,18414,34,6523,209,11891,0,0,106,8238,135,5076,106,13314,California
Sutter,2021-02-24,1061,19475,387,6910,674,12565,0,0,205,7590,854,5930,206,13520,California
Sutter,2021-02-25,884,20359,558,7468,326,12891,0,0,673,8056,207,6137,673,14193,California
Sutter,2021-02-26,422,20781,64,7532,358,13249,0,0,177,7993,240,6377,177,14370,California
Sutter,2021-02-27,929,21710,51,7583,878,14127,0,0,752,8568,177,6554,752,15122,California
Sutter,2021-02-28,100,21810,51,7634,49,14176,0,0,76,8621,23,6577,76,15198,California
Sutter,2021-03-01,280,22090,67,7701,213,14389,0,0,166,8673,114,6691,166,15364,California
Sutter,2021-03-02,366,22456,64,7765,302,14691,0,0,176,8662,187,6878,176,15540,California
Sutter,2021-03-03,1480,23936,538,8303,942,15633,0,0,674,8539,797,7675,674,16214,California
Sutter,2021-03-04,1287,25223,868,9171,419,16052,0,0,954,9164,329,8004,954,17168,California
Sutter,2021-03-05,346,25569,81,9252,264,16316,1,1,211,9242,134,8138,212,17380,California
Sutter,2021-03-06,1030,26599,50,9302,975,17291,5,6,856,9931,172,8310,861,18241,California
Sutter,2021-03-07,67,26666,22,9324,44,17335,1,7,42,9951,23,8333,43,18284,California
Sutter,2021-03-08,235,26901,79,9403,144,17479,12,19,165,10058,70,8403,177,18461,California
Sutter,2021-03-09,400,27301,142,9545,246,17725,12,31,195,10060,205,8608,207,18668,California
Sutter,2021-03-10,1590,28891,683,10228,843,18568,64,95,530,9601,1053,9661,594,19262,California
Sutter,2021-03-11,908,29799,443,10671,448,19016,17,112,656,10026,248,9909,673,19935,California
Sutter,2021-03-12,689,30488,111,10782,398,19414,180,292,202,9923,482,10391,379,20314,California
Sutter,2021-03-13,1004,31492,752,11534,233,19647,19,311,784,10509,217,10608,803,21117,California
Sutter,2021-03-14,140,31632,22,11556,107,19754,11,322,45,10470,95,10703,56,21173,California
Sutter,2021-03-15,335,31967,69,11625,216,19970,50,372,156,10499,177,10880,206,21379,California
Sutter,2021-03-16,393,32360,88,11713,257,20227,48,420,212,10578,180,11060,259,21638,California
Sutter,2021-03-17,1497,33857,561,12274,915,21142,21,441,264,9645,1218,12278,285,21923,California
Sutter,2021-03-18,981,34838,177,12451,601,21743,203,644,572,10014,403,12681,772,22695,California
Sutter,2021-03-19,467,35305,167,12618,270,22013,30,674,282,10142,183,12864,311,23006,California
Sutter,2021-03-20,941,36246,115,12733,816,22829,10,684,848,10909,91,12955,858,23864,California
Sutter,2021-03-21,72,36318,50,12783,19,22848,3,687,28,10897,43,12998,31,23895,California
Sutter,2021-03-22,293,36611,121,12904,145,22993,27,714,208,11050,82,13080,235,24130,California
Sutter,2021-03-23,377,36988,115,13019,227,23220,35,749,243,11194,133,13213,277,24407,California
Sutter,2021-03-24,1704,38692,779,13798,856,24076,69,818,292,10162,1393,14606,361,24768,California
Sutter,2021-03-25,1056,39748,682,14480,330,24406,44,862,360,9876,690,15296,404,25172,California
Sutter,2021-03-26,504,40252,180,14660,308,24714,16,878,284,9962,214,15510,300,25472,California
Sutter,2021-03-27,940,41192,63,14723,875,25589,2,880,816,10664,116,15626,818,26290,California
Sutter,2021-03-28,125,41317,72,14795,53,25642,0,880,74,10690,49,15675,75,26365,California
Sutter,2021-03-29,423,41740,140,14935,227,25869,56,936,209,10743,212,15887,265,26630,California
Sutter,2021-03-30,485,42225,163,15098,312,26181,10,946,308,10885,176,16063,318,26948,California
Sutter,2021-03-31,1247,43472,175,15273,1057,27238,15,961,417,10498,817,16880,430,27378,California
Sutter,2021-04-01,1396,44868,743,16016,465,27703,188,1149,424,10148,961,17841,611,27989,California
Sutter,2021-04-02,522,45390,104,16120,301,28004,117,1266,206,10156,312,18153,320,28309,California
Sutter,2021-04-03,922,46312,80,16200,215,28219,627,1893,125,10117,790,18943,751,29060,California
Sutter,2021-04-04,118,46430,23,16223,89,28308,6,1899,55,10116,62,19005,61,29121,California
Sutter,2021-04-05,377,46807,145,16368,195,28503,37,1936,176,10131,198,19203,213,29334,California
Sutter,2021-04-06,517,47324,198,16566,263,28766,56,1992,271,10214,244,19447,327,29661,California
Sutter,2021-04-07,1488,48812,886,17452,524,29290,78,2070,599,10015,876,20323,677,30338,California
Sutter,2021-04-08,1054,49866,576,18028,365,29655,113,2183,571,10220,476,20799,681,31019,California
Sutter,2021-04-09,577,50443,252,18280,261,29916,64,2247,239,10190,333,21132,303,31322,California
Sutter,2021-04-10,844,51287,109,18389,100,30016,635,2882,118,10212,720,21852,742,32064,California
Sutter,2021-04-11,123,51410,33,18422,44,30060,46,2928,42,10218,80,21932,86,32150,California
Sutter,2021-04-12,344,51754,95,18517,196,30256,53,2981,135,10198,208,22140,188,32338,California
Sutter,2021-04-13,439,52193,129,18646,310,30566,0,2981,214,10190,222,22362,214,32552,California
Sutter,2021-04-14,1322,53515,160,18806,1161,31727,1,2982,222,9322,1091,23453,223,32775,California
Sutter,2021-04-15,539,54054,172,18978,367,32094,0,2982,215,9219,318,23771,215,32990,California
Sutter,2021-04-16,410,54464,128,19106,282,32376,0,2982,191,9192,218,23989,191,33181,California
Sutter,2021-04-17,583,55047,86,19192,497,32873,0,2982,510,9631,71,24060,510,33691,California
Sutter,2021-04-18,95,55142,35,19227,60,32933,0,2982,61,9660,32,24092,61,33752,California
Sutter,2021-04-19,290,55432,108,19335,182,33115,0,2982,118,9609,169,24261,118,33870,California
Sutter,2021-04-20,466,55898,180,19515,286,33401,0,2982,223,9592,240,24501,223,34093,California
Sutter,2021-04-21,1337,57235,501,20016,836,34237,0,2982,519,9309,802,25303,519,34612,California
Sutter,2021-04-22,546,57781,196,20212,350,34587,0,2982,271,9308,272,25575,271,34883,California
Sutter,2021-04-23,443,58224,156,20368,287,34874,0,2982,202,9273,237,25812,202,35085,California
Sutter,2021-04-24,335,58559,109,20477,225,35099,1,2983,188,9316,145,25957,188,35273,California
Sutter,2021-04-25,164,58723,77,20554,87,35186,0,2983,89,9332,73,26030,89,35362,California
Sutter,2021-04-26,324,59047,107,20661,215,35401,2,2985,136,9284,186,26216,138,35500,California
Sutter,2021-04-27,569,59616,290,20951,275,35676,4,2989,257,9238,307,26523,261,35761,California
Sutter,2021-04-28,867,60483,388,21339,471,36147,8,2997,285,8956,575,27098,293,36054,California
Sutter,2021-04-29,825,61308,175,21514,649,36796,1,2998,336,8811,482,27580,337,36391,California
Sutter,2021-04-30,405,61713,146,21660,246,37042,13,3011,178,8779,222,27802,190,36581,California
Sutter,2021-05-01,304,62017,108,21768,156,37198,40,3051,132,8782,169,27971,172,36753,California
Sutter,2021-05-02,80,62097,51,21819,27,37225,2,3053,45,8794,35,28006,47,36800,California
Sutter,2021-05-03,228,62325,117,21936,100,37325,11,3064,92,8762,135,28141,103,36903,California
Sutter,2021-05-04,565,62890,256,22192,244,37569,65,3129,233,8730,328,28469,296,37199,California
Sutter,2021-05-05,569,63459,172,22364,389,37958,8,3137,163,8500,401,28870,171,37370,California
Sutter,2021-05-06,444,63903,237,22601,188,38146,19,3156,197,8470,245,29115,215,37585,California
Sutter,2021-05-07,435,64338,161,22762,253,38399,21,3177,159,8381,270,29385,181,37766,California
Sutter,2021-05-08,245,64583,96,22858,144,38543,5,3182,117,8375,128,29513,122,37888,California
Sutter,2021-05-09,106,64689,78,22936,23,38566,5,3187,58,8391,47,29560,63,37951,California
Sutter,2021-05-10,195,64884,46,22982,131,38697,18,3205,51,8317,143,29703,69,38020,California
Sutter,2021-05-11,479,65363,240,23222,217,38914,22,3227,195,8253,279,29982,215,38235,California
Sutter,2021-05-12,477,65840,269,23491,197,39111,11,3238,159,8111,312,30294,170,38405,California
Sutter,2021-05-13,503,66343,268,23759,213,39324,22,3260,196,8024,305,30599,218,38623,California
Sutter,2021-05-14,451,66794,190,23949,245,39569,16,3276,201,7997,245,30844,218,38841,California
Sutter,2021-05-15,855,67649,320,24269,504,40073,31,3307,312,7800,540,31384,343,39184,California
Sutter,2021-05-16,177,67826,119,24388,50,40123,8,3315,93,7818,83,31467,101,39285,California
Sutter,2021-05-17,293,68119,118,24506,161,40284,14,3329,151,7844,139,31606,165,39450,California
Sutter,2021-05-18,566,68685,321,24827,240,40524,5,3334,304,7895,258,31864,309,39759,California
Sutter,2021-05-19,469,69154,268,25095,194,40718,7,3341,225,7886,241,32105,232,39991,California
Sutter,2021-05-20,478,69632,252,25347,214,40932,12,3353,221,7869,250,32355,233,40224,California
Sutter,2021-05-21,504,70136,230,25577,262,41194,12,3365,220,7818,282,32637,231,40455,California
Sutter,2021-05-22,376,70512,208,25785,165,41359,3,3368,185,7819,186,32823,187,40642,California
Sutter,2021-05-23,192,70704,95,25880,88,41447,9,3377,90,7822,96,32919,99,40741,California
Sutter,2021-05-24,244,70948,93,25973,128,41575,23,3400,99,7802,142,33061,122,40863,California
Sutter,2021-05-25,405,71353,196,26169,197,41772,12,3412,168,7749,233,33294,180,41043,California
Sutter,2021-05-26,319,71672,154,26323,156,41928,9,3421,113,7670,201,33495,122,41165,California
Sutter,2021-05-27,442,72114,120,26443,302,42230,20,3441,125,7502,313,33808,145,41310,California
Sutter,2021-05-28,346,72460,165,26608,163,42393,18,3459,171,7523,168,33976,189,41499,California
Sutter,2021-05-29,254,72714,120,26728,119,42512,15,3474,132,7552,118,34094,147,41646,California
Sutter,2021-05-30,89,72803,64,26792,22,42534,3,3477,40,7549,46,34140,43,41689,California
Sutter,2021-05-31,21,72824,3,26795,14,42548,4,3481,7,7546,14,34154,11,41700,California
Sutter,2021-06-01,312,73136,133,26928,170,42718,9,3490,115,7475,195,34349,124,41824,California
Sutter,2021-06-02,287,73423,122,27050,159,42877,6,3496,100,7399,182,34531,106,41930,California
Sutter,2021-06-03,350,73773,227,27277,113,42990,10,3506,122,7308,223,34754,132,42062,California
Sutter,2021-06-04,344,74117,198,27475,139,43129,7,3513,121,7218,218,34972,128,42190,California
Sutter,2021-06-05,446,74563,375,27850,67,43196,4,3517,157,7095,284,35256,161,42351,California
Sutter,2021-06-06,134,74697,115,27965,16,43212,3,3520,45,7056,87,35343,48,42399,California
Sutter,2021-06-07,167,74864,109,28074,49,43261,9,3529,60,7019,106,35449,69,42468,California
Sutter,2021-06-08,370,75234,210,28284,147,43408,13,3542,157,6978,211,35660,170,42638,California
Sutter,2021-06-09,370,75604,235,28519,130,43538,5,3547,127,6870,240,35900,132,42770,California
Sutter,2021-06-10,392,75996,283,28802,99,43637,10,3557,155,6802,233,36133,165,42935,California
Sutter,2021-06-11,349,76345,224,29026,119,43756,6,3563,118,6700,225,36358,123,43058,California
Sutter,2021-06-12,245,76590,170,29196,60,43816,15,3578,69,6609,175,36533,84,43142,California
Sutter,2021-06-13,83,76673,65,29261,17,43833,1,3579,22,6571,61,36594,23,43165,California
Sutter,2021-06-14,191,76864,112,29373,68,43901,11,3590,75,6542,115,36709,86,43251,California
Sutter,2021-06-15,285,77149,154,29527,118,44019,13,3603,101,6474,182,36891,114,43365,California
Sutter,2021-06-16,226,77375,145,29672,71,44090,10,3613,111,6480,115,37006,121,43486,California
Sutter,2021-06-17,284,77659,173,29845,105,44195,6,3619,122,6447,161,37167,128,43614,California
Sutter,2021-06-18,266,77925,172,30017,79,44274,15,3634,92,6384,170,37337,107,43721,California
Sutter,2021-06-19,209,78134,140,30157,65,44339,4,3638,60,6301,147,37484,64,43785,California
Sutter,2021-06-20,70,78204,49,30206,19,44358,2,3640,30,6293,40,37524,32,43817,California
Sutter,2021-06-21,112,78316,52,30258,48,44406,12,3652,49,6294,60,37584,61,43878,California
Sutter,2021-06-22,221,78537,127,30385,91,44497,3,3655,85,6248,134,37718,88,43966,California
Sutter,2021-06-23,184,78721,107,30492,69,44566,8,3663,77,6226,106,37824,84,44050,California
Sutter,2021-06-24,239,78960,162,30654,67,44633,10,3673,102,6201,137,37961,112,44162,California
Sutter,2021-06-25,225,79185,145,30799,74,44707,6,3679,89,6164,132,38093,95,44257,California
Sutter,2021-06-26,221,79406,179,30978,37,44744,5,3684,76,6103,143,38236,82,44339,California
Sutter,2021-06-27,79,79485,66,31044,12,44756,1,3685,28,6083,49,38285,29,44368,California
Sutter,2021-06-28,127,79612,78,31122,42,44798,7,3692,65,6094,61,38346,72,44440,California
Sutter,2021-06-29,238,79850,155,31277,72,44870,11,3703,85,6040,150,38496,96,44536,California
Sutter,2021-06-30,188,80038,120,31397,58,44928,10,3713,79,6024,105,38601,89,44625,California
Sutter,2021-07-01,207,80245,175,31572,25,44953,7,3720,76,5976,131,38732,83,44708,California
Sutter,2021-07-02,206,80451,137,31709,56,45009,13,3733,99,5989,99,38831,112,44820,California
Sutter,2021-07-03,119,80570,92,31801,24,45033,3,3736,44,5968,68,38899,47,44867,California
Sutter,2021-07-04,6,80576,3,31804,3,45036,0,3736,2,5967,3,38902,2,44869,California
Sutter,2021-07-05,86,80662,58,31862,18,45054,10,3746,39,5969,46,38948,48,44917,California
Sutter,2021-07-06,231,80893,138,32000,72,45126,21,3767,78,5917,151,39099,99,45016,California
Sutter,2021-07-07,191,81084,108,32108,75,45201,8,3775,62,5860,127,39226,70,45086,California
Sutter,2021-07-08,218,81302,134,32242,78,45279,6,3781,75,5800,141,39367,81,45167,California
Sutter,2021-07-09,207,81509,137,32379,63,45342,7,3788,102,5807,102,39469,109,45276,California
Sutter,2021-07-10,152,81661,114,32493,33,45375,5,3793,75,5812,75,39544,80,45356,California
Sutter,2021-07-11,63,81724,45,32538,17,45392,1,3794,34,5818,29,39573,35,45391,California
Sutter,2021-07-12,141,81865,86,32624,44,45436,11,3805,64,5818,75,39648,75,45466,California
Sutter,2021-07-13,158,82023,88,32712,66,45502,4,3809,79,5826,75,39723,83,45549,California
Sutter,2021-07-14,191,82214,97,32809,87,45589,7,3816,91,5825,99,39822,98,45647,California
Sutter,2021-07-15,178,82392,111,32920,60,45649,7,3823,75,5805,102,39924,82,45729,California
Sutter,2021-07-16,179,82571,106,33026,60,45709,13,3836,89,5817,90,40014,102,45831,California
Sutter,2021-07-17,130,82701,98,33124,31,45740,1,3837,63,5815,66,40080,64,45895,California
Sutter,2021-07-18,48,82749,29,33153,16,45756,3,3840,27,5825,20,40100,30,45925,California
Sutter,2021-07-19,96,82845,42,33195,46,45802,8,3848,55,5848,40,40140,63,45988,California
Sutter,2021-07-20,203,83048,126,33321,70,45872,7,3855,98,5849,104,40244,105,46093,California
Sutter,2021-07-21,213,83261,117,33438,79,45951,17,3872,106,5866,105,40349,122,46215,California
Sutter,2021-07-22,190,83451,119,33557,66,46017,5,3877,108,5898,81,40430,113,46328,California
Sutter,2021-07-23,237,83688,145,33702,79,46096,13,3890,128,5932,107,40537,141,46469,California
Sutter,2021-07-24,138,83826,106,33808,29,46125,3,3893,85,5969,51,40588,88,46557,California
Sutter,2021-07-25,97,83923,78,33886,15,46140,4,3897,70,6018,25,40613,74,46631,California
Sutter,2021-07-26,161,84084,89,33975,60,46200,12,3909,95,6059,66,40679,107,46738,California
Sutter,2021-07-27,236,84320,166,34141,55,46255,15,3924,137,6114,97,40776,152,46890,California
Sutter,2021-07-28,181,84501,107,34248,68,46323,6,3930,117,6173,64,40840,123,47013,California
Sutter,2021-07-29,196,84697,144,34392,45,46368,7,3937,132,6248,64,40904,139,47152,California
Sutter,2021-07-30,275,84972,201,34593,63,46431,11,3948,166,6317,108,41012,177,47329,California
Sutter,2021-07-31,200,85172,165,34758,33,46464,2,3950,130,6381,68,41080,132,47461,California
Sutter,2021-08-01,105,85277,80,34838,23,46487,2,3952,67,6413,37,41117,69,47530,California
Sutter,2021-08-02,203,85480,127,34965,68,46555,8,3960,136,6490,67,41184,144,47674,California
Sutter,2021-08-03,224,85704,142,35107,70,46625,12,3972,152,6584,70,41254,164,47838,California
Sutter,2021-08-04,220,85924,135,35242,77,46702,8,3980,142,6658,76,41330,150,47988,California
Sutter,2021-08-05,212,86136,127,35369,75,46777,10,3990,138,6734,72,41402,148,48136,California
Sutter,2021-08-06,340,86476,215,35584,99,46876,26,4016,227,6882,105,41507,253,48389,California
Sutter,2021-08-07,181,86657,119,35703,59,46935,3,4019,123,6951,57,41564,126,48515,California
Sutter,2021-08-08,141,86798,114,35817,27,46962,0,4019,117,7044,24,41588,117,48632,California
Sutter,2021-08-09,202,87000,106,35923,88,47050,8,4027,145,7141,56,41644,153,48785,California
Sutter,2021-08-10,301,87301,189,36112,91,47141,21,4048,181,7223,120,41764,202,48987,California
Sutter,2021-08-11,247,87548,136,36248,98,47239,13,4061,154,7299,91,41855,167,49154,California
Sutter,2021-08-12,273,87821,163,36411,98,47337,12,4073,174,7386,99,41954,186,49340,California
Sutter,2021-08-13,315,88136,179,36590,122,47459,14,4087,208,7505,103,42057,222,49562,California
Sutter,2021-08-14,177,88313,111,36701,65,47524,1,4088,95,7524,77,42134,96,49658,California
Sutter,2021-08-15,153,88466,91,36792,62,47586,0,4088,92,7560,56,42190,92,49750,California
Sutter,2021-08-16,226,88692,114,36906,102,47688,10,4098,144,7638,75,42265,153,49903,California
Sutter,2021-08-17,315,89007,177,37083,122,47810,16,4114,167,7686,135,42400,183,50086,California
Sutter,2021-08-18,277,89284,148,37231,123,47933,6,4120,162,7753,100,42500,167,50253,California
Sutter,2021-08-19,295,89579,146,37377,130,48063,19,4139,151,7799,124,42624,170,50423,California
Sutter,2021-08-20,385,89964,238,37615,126,48189,21,4160,169,7797,192,42816,190,50613,California
Sutter,2021-08-21,193,90157,121,37736,70,48259,2,4162,101,7818,82,42898,103,50716,California
Sutter,2021-08-22,131,90288,91,37827,40,48299,0,4162,80,7849,49,42947,80,50796,California
Sutter,2021-08-23,312,90600,177,38004,124,48423,11,4173,148,7866,142,43089,159,50955,California
Sutter,2021-08-24,316,90916,200,38204,104,48527,12,4185,170,7923,125,43214,182,51137,California
Sutter,2021-08-25,284,91200,183,38387,88,48615,13,4198,150,7974,112,43326,163,51300,California
Sutter,2021-08-26,284,91484,170,38557,93,48708,21,4219,144,8016,123,43449,165,51465,California
Sutter,2021-08-27,411,91895,290,38847,101,48809,20,4239,169,7983,222,43671,189,51654,California
Sutter,2021-08-28,180,92075,124,38971,55,48864,1,4240,76,7965,95,43766,77,51731,California
Sutter,2021-08-29,152,92227,124,39095,28,48892,0,4240,52,7920,97,43863,52,51783,California
Sutter,2021-08-30,125,92352,67,39162,49,48941,9,4249,59,7929,59,43922,68,51851,California
Tehama,2020-12-16,5,5,5,5,0,0,0,0,5,5,0,0,5,5,California
Tehama,2020-12-17,20,25,20,25,0,0,0,0,20,25,0,0,20,25,California
Tehama,2020-12-18,5,30,5,30,0,0,0,0,5,30,0,0,5,30,California
Tehama,2020-12-21,44,74,44,74,0,0,0,0,44,74,0,0,44,74,California
Tehama,2020-12-22,82,156,76,150,6,6,0,0,82,156,0,0,82,156,California
Tehama,2020-12-23,55,211,47,197,8,14,0,0,55,211,0,0,55,211,California
Tehama,2020-12-24,5,216,3,200,2,16,0,0,5,216,0,0,5,216,California
Tehama,2020-12-26,4,220,3,203,1,17,0,0,4,220,0,0,4,220,California
Tehama,2020-12-27,2,222,2,205,0,17,0,0,2,222,0,0,2,222,California
Tehama,2020-12-28,59,281,46,251,13,30,0,0,59,281,0,0,59,281,California
Tehama,2020-12-29,44,325,44,295,0,30,0,0,44,325,0,0,44,325,California
Tehama,2020-12-30,64,389,46,341,18,48,0,0,63,388,0,0,63,388,California
Tehama,2020-12-31,16,405,5,346,11,59,0,0,16,404,0,0,16,404,California
Tehama,2021-01-01,3,408,0,346,3,62,0,0,3,407,0,0,3,407,California
Tehama,2021-01-04,49,457,17,363,32,94,0,0,49,456,0,0,49,456,California
Tehama,2021-01-05,75,532,46,409,29,123,0,0,70,521,5,5,70,526,California
Tehama,2021-01-06,88,620,33,442,55,178,0,0,73,581,13,18,73,599,California
Tehama,2021-01-07,64,684,7,449,57,235,0,0,63,643,1,19,63,662,California
Tehama,2021-01-08,43,727,29,478,14,249,0,0,36,672,7,26,36,698,California
Tehama,2021-01-09,7,734,5,483,2,251,0,0,6,677,1,27,6,704,California
Tehama,2021-01-10,1,735,0,483,1,252,0,0,1,678,0,27,1,705,California
Tehama,2021-01-11,65,800,56,539,9,261,0,0,23,659,42,69,23,728,California
Tehama,2021-01-12,151,951,132,671,19,280,0,0,94,695,58,127,94,822,California
Tehama,2021-01-13,90,1041,62,733,28,308,0,0,38,681,52,179,38,860,California
Tehama,2021-01-14,243,1284,51,784,192,500,0,0,241,920,2,181,241,1101,California
Tehama,2021-01-15,291,1575,75,859,216,716,0,0,287,1203,4,185,287,1388,California
Tehama,2021-01-16,275,1850,20,879,255,971,0,0,272,1472,3,188,272,1660,California
Tehama,2021-01-17,7,1857,3,882,4,975,0,0,4,1473,3,191,4,1664,California
Tehama,2021-01-18,17,1874,8,890,9,984,0,0,11,1478,6,197,11,1675,California
Tehama,2021-01-19,314,2188,81,971,233,1217,0,0,248,1660,66,263,248,1923,California
Tehama,2021-01-20,344,2532,103,1074,241,1458,0,0,287,1891,56,319,287,2210,California
Tehama,2021-01-21,250,2782,21,1095,229,1687,0,0,234,2109,16,335,234,2444,California
Tehama,2021-01-22,247,3029,22,1117,225,1912,0,0,244,2350,3,338,244,2688,California
Tehama,2021-01-23,269,3298,7,1124,262,2174,0,0,268,2617,1,339,268,2956,California
Tehama,2021-01-24,3,3301,1,1125,2,2176,0,0,3,2620,0,339,3,2959,California
Tehama,2021-01-25,46,3347,22,1147,24,2200,0,0,21,2616,25,364,21,2980,California
Tehama,2021-01-26,359,3706,47,1194,312,2512,0,0,321,2899,38,402,321,3301,California
Tehama,2021-01-27,344,4050,24,1218,320,2832,0,0,321,3197,23,425,321,3622,California
Tehama,2021-01-28,376,4426,42,1260,334,3166,0,0,354,3529,22,447,354,3976,California
Tehama,2021-01-29,360,4786,25,1285,335,3501,0,0,340,3849,20,467,340,4316,California
Tehama,2021-01-30,115,4901,2,1287,113,3614,0,0,114,3962,1,468,114,4430,California
Tehama,2021-01-31,1,4902,1,1288,0,3614,0,0,1,3963,0,468,1,4431,California
Tehama,2021-02-01,90,4992,24,1312,66,3680,0,0,40,3953,50,518,40,4471,California
Tehama,2021-02-02,393,5385,73,1385,320,4000,0,0,291,4142,102,620,291,4762,California
Tehama,2021-02-03,463,5848,14,1399,449,4449,0,0,407,4493,56,676,407,5169,California
Tehama,2021-02-04,571,6419,105,1504,466,4915,0,0,481,4884,90,766,481,5650,California
Tehama,2021-02-05,207,6626,71,1575,136,5051,0,0,140,4957,67,833,140,5790,California
Tehama,2021-02-06,49,6675,15,1590,34,5085,0,0,37,4982,12,845,37,5827,California
Tehama,2021-02-07,6,6681,5,1595,1,5086,0,0,2,4981,3,848,2,5829,California
Tehama,2021-02-08,48,6729,13,1608,35,5121,0,0,31,4995,17,865,31,5860,California
Tehama,2021-02-09,96,6825,51,1659,45,5166,0,0,50,4999,46,911,50,5910,California
Tehama,2021-02-10,262,7087,72,1731,190,5356,0,0,168,5073,94,1005,168,6078,California
Tehama,2021-02-11,248,7335,16,1747,232,5588,0,0,93,5013,153,1158,93,6171,California
Tehama,2021-02-12,438,7773,103,1850,335,5923,0,0,214,5003,224,1382,214,6385,California
Tehama,2021-02-13,415,8188,19,1869,396,6319,0,0,163,4914,252,1634,163,6548,California
Tehama,2021-02-14,39,8227,2,1871,37,6356,0,0,36,4947,3,1637,36,6584,California
Tehama,2021-02-15,65,8292,11,1882,54,6410,0,0,56,4994,9,1646,56,6640,California
Tehama,2021-02-16,267,8559,23,1905,244,6654,0,0,74,4875,193,1839,74,6714,California
Tehama,2021-02-17,333,8892,23,1928,310,6964,0,0,67,4676,266,2105,67,6781,California
Tehama,2021-02-18,400,9292,37,1965,363,7327,0,0,153,4582,247,2352,153,6934,California
Tehama,2021-02-19,244,9536,32,1997,212,7539,0,0,53,4444,191,2543,53,6987,California
Tehama,2021-02-20,288,9824,8,2005,280,7819,0,0,33,4222,255,2798,33,7020,California
Tehama,2021-02-21,5,9829,2,2007,3,7822,0,0,2,4221,3,2801,2,7022,California
Tehama,2021-02-22,49,9878,16,2023,33,7855,0,0,30,4232,19,2820,30,7052,California
Tehama,2021-02-23,92,9970,26,2049,66,7921,0,0,34,4208,58,2878,34,7086,California
Tehama,2021-02-24,359,10329,29,2078,330,8251,0,0,41,3931,318,3196,41,7127,California
Tehama,2021-02-25,415,10744,66,2144,349,8600,0,0,47,3610,368,3564,47,7174,California
Tehama,2021-02-26,509,11253,22,2166,487,9087,0,0,81,3263,428,3992,81,7255,California
Tehama,2021-02-27,336,11589,7,2173,329,9416,0,0,42,3012,293,4285,42,7297,California
Tehama,2021-02-28,20,11609,1,2174,19,9435,0,0,18,3028,2,4287,18,7315,California
Tehama,2021-03-01,75,11684,10,2184,65,9500,0,0,33,3019,42,4329,33,7348,California
Tehama,2021-03-02,186,11870,21,2205,165,9665,0,0,39,2912,146,4475,39,7387,California
Tehama,2021-03-03,196,12066,35,2240,161,9826,0,0,61,2838,135,4610,61,7448,California
Tehama,2021-03-04,780,12846,71,2311,709,10535,0,0,244,2551,531,5141,244,7692,California
Tehama,2021-03-05,456,13302,25,2336,431,10966,0,0,224,2546,229,5370,224,7916,California
Tehama,2021-03-06,363,13665,20,2356,340,11306,3,3,89,2366,273,5643,93,8009,California
Tehama,2021-03-07,7,13672,1,2357,6,11312,0,3,4,2367,3,5646,4,8013,California
Tehama,2021-03-08,72,13744,11,2368,44,11356,17,20,29,2371,42,5688,46,8059,California
Tehama,2021-03-09,411,14155,16,2384,375,11731,20,40,351,2682,60,5748,371,8430,California
Tehama,2021-03-10,384,14539,24,2408,337,12068,23,63,77,2476,306,6054,100,8530,California
Tehama,2021-03-11,558,15097,28,2436,465,12533,65,128,387,2757,171,6225,452,8982,California
Tehama,2021-03-12,351,15448,32,2468,246,12779,73,201,200,2881,150,6375,274,9256,California
Tehama,2021-03-13,68,15516,11,2479,48,12827,9,210,11,2844,57,6432,20,9276,California
Tehama,2021-03-14,64,15580,2,2481,53,12880,9,219,21,2831,43,6475,30,9306,California
Tehama,2021-03-15,173,15753,22,2503,125,13005,26,245,88,2860,85,6560,114,9420,California
Tehama,2021-03-16,452,16205,19,2522,395,13400,38,283,341,3129,110,6670,379,9799,California
Tehama,2021-03-17,476,16681,34,2556,411,13811,31,314,385,3456,89,6759,416,10215,California
Tehama,2021-03-18,537,17218,39,2595,471,14282,27,341,348,3644,187,6946,375,10590,California
Tehama,2021-03-19,349,17567,25,2620,310,14592,14,355,307,3923,42,6988,321,10911,California
Tehama,2021-03-20,59,17626,18,2638,37,14629,4,359,41,3950,18,7006,45,10956,California
Tehama,2021-03-21,12,17638,5,2643,7,14636,0,359,12,3962,0,7006,12,10968,California
Tehama,2021-03-22,106,17744,11,2654,78,14714,17,376,60,3993,46,7052,77,11045,California
Tehama,2021-03-23,106,17850,36,2690,63,14777,7,383,77,4048,29,7081,84,11129,California
Tehama,2021-03-24,101,17951,17,2707,79,14856,5,388,65,4082,36,7117,70,11199,California
Tehama,2021-03-25,604,18555,416,3123,175,15031,13,401,544,4580,59,7176,557,11756,California
Tehama,2021-03-26,585,19140,455,3578,117,15148,13,414,493,4997,89,7265,506,12262,California
Tehama,2021-03-27,521,19661,401,3979,84,15232,36,450,436,5385,84,7349,472,12734,California
Tehama,2021-03-28,40,19701,15,3994,25,15257,0,450,23,5391,17,7366,23,12757,California
Tehama,2021-03-29,131,19832,30,4024,101,15358,0,450,83,5427,47,7413,83,12840,California
Tehama,2021-03-30,432,20264,254,4278,176,15534,2,452,286,5569,146,7559,288,13128,California
Tehama,2021-03-31,430,20694,320,4598,107,15641,3,455,347,5836,82,7641,349,13477,California
Tehama,2021-04-01,573,21267,275,4873,293,15934,5,460,426,6121,146,7787,431,13908,California
Tehama,2021-04-02,506,21773,243,5116,254,16188,9,469,307,6237,199,7986,315,14223,California
Tehama,2021-04-03,79,21852,11,5127,60,16248,8,477,40,6246,39,8025,48,14271,California
Tehama,2021-04-04,40,21892,9,5136,28,16276,3,480,27,6263,13,8038,30,14301,California
Tehama,2021-04-05,131,22023,21,5157,74,16350,36,516,63,6294,68,8106,99,14400,California
Tehama,2021-04-06,557,22580,119,5276,375,16725,63,579,147,6093,410,8516,209,14609,California
Tehama,2021-04-07,459,23039,311,5587,94,16819,54,633,329,6345,129,8645,381,14990,California
Tehama,2021-04-08,661,23700,194,5781,422,17241,45,678,246,6221,414,9059,290,15280,California
Tehama,2021-04-09,498,24198,236,6017,220,17461,42,720,254,6274,243,9302,296,15576,California
Tehama,2021-04-10,111,24309,28,6045,42,17503,41,761,52,6308,59,9361,93,15669,California
Tehama,2021-04-11,50,24359,12,6057,27,17530,11,772,11,6291,39,9400,22,15691,California
Tehama,2021-04-12,124,24483,5,6062,96,17626,23,795,43,6276,81,9481,66,15757,California
Tehama,2021-04-13,425,24908,75,6137,350,17976,0,795,69,5990,355,9836,69,15826,California
Tehama,2021-04-14,443,25351,58,6195,385,18361,0,795,53,5655,388,10224,53,15879,California
Tehama,2021-04-15,562,25913,208,6403,354,18715,0,795,79,5252,482,10706,79,15958,California
Tehama,2021-04-16,686,26599,399,6802,287,19002,0,795,92,4750,594,11300,92,16050,California
Tehama,2021-04-17,393,26992,302,7104,91,19093,0,795,53,4465,339,11639,54,16104,California
Tehama,2021-04-18,22,27014,8,7112,14,19107,0,795,14,4471,8,11647,14,16118,California
Tehama,2021-04-19,114,27128,8,7120,106,19213,0,795,49,4455,65,11712,49,16167,California
Tehama,2021-04-20,593,27721,492,7612,101,19314,0,795,172,4208,419,12131,172,16339,California
Tehama,2021-04-21,552,28273,463,8075,89,19403,0,795,179,4016,371,12502,179,16518,California
Tehama,2021-04-22,568,28841,396,8471,172,19575,0,795,164,3779,401,12903,164,16682,California
Tehama,2021-04-23,501,29342,383,8854,118,19693,0,795,217,3714,283,13186,218,16900,California
Tehama,2021-04-24,119,29461,23,8877,96,19789,0,795,28,3651,91,13277,28,16928,California
Tehama,2021-04-25,32,29493,21,8898,11,19800,0,795,9,3638,22,13299,9,16937,California
Tehama,2021-04-26,99,29592,14,8912,85,19885,0,795,55,3649,44,13343,55,16992,California
Tehama,2021-04-27,282,29874,224,9136,55,19940,3,798,107,3584,175,13518,110,17102,California
Tehama,2021-04-28,429,30303,352,9488,59,19999,18,816,73,3319,356,13874,91,17193,California
Tehama,2021-04-29,403,30706,188,9676,207,20206,8,824,79,3083,323,14197,87,17280,California
Tehama,2021-04-30,388,31094,288,9964,93,20299,7,831,129,2960,259,14456,136,17416,California
Tehama,2021-05-01,86,31180,8,9972,72,20371,6,837,20,2921,65,14521,26,17442,California
Tehama,2021-05-02,44,31224,22,9994,10,20381,12,849,24,2937,20,14541,36,17478,California
Tehama,2021-05-03,129,31353,41,10035,77,20458,11,860,63,2946,65,14606,74,17552,California
Tehama,2021-05-04,178,31531,63,10098,106,20564,9,869,75,2929,101,14707,84,17636,California
Tehama,2021-05-05,106,31637,30,10128,65,20629,11,880,48,2931,57,14764,59,17695,California
Tehama,2021-05-06,182,31819,97,10225,66,20695,19,899,112,2992,70,14834,131,17826,California
Tehama,2021-05-07,204,32023,89,10314,103,20798,12,911,59,2920,143,14977,71,17897,California
Tehama,2021-05-08,60,32083,10,10324,48,20846,2,913,18,2898,42,15019,20,17917,California
Tehama,2021-05-09,19,32102,5,10329,14,20860,0,913,8,2895,11,15030,8,17925,California
Tehama,2021-05-10,87,32189,7,10336,71,20931,9,922,40,2897,46,15076,48,17973,California
Tehama,2021-05-11,209,32398,138,10474,55,20986,16,938,41,2786,168,15244,57,18030,California
Tehama,2021-05-12,224,32622,140,10614,73,21059,11,949,52,2678,171,15415,63,18093,California
Tehama,2021-05-13,258,32880,171,10785,76,21135,11,960,116,2664,141,15556,127,18220,California
Tehama,2021-05-14,259,33139,143,10928,95,21230,21,981,61,2549,197,15753,82,18302,California
Tehama,2021-05-15,246,33385,144,11072,61,21291,41,1022,171,2687,74,15827,212,18514,California
Tehama,2021-05-16,30,33415,8,11080,19,21310,3,1025,18,2696,12,15839,21,18535,California
Tehama,2021-05-17,130,33545,35,11115,78,21388,17,1042,61,2706,68,15907,78,18613,California
Tehama,2021-05-18,162,33707,84,11199,63,21451,15,1057,51,2662,110,16017,66,18679,California
Tehama,2021-05-19,138,33845,62,11261,65,21516,11,1068,46,2627,92,16109,57,18736,California
Tehama,2021-05-20,351,34196,255,11516,73,21589,23,1091,246,2792,104,16213,269,19005,California
Tehama,2021-05-21,246,34442,115,11631,118,21707,13,1104,82,2726,161,16374,95,19100,California
Tehama,2021-05-22,70,34512,35,11666,31,21738,4,1108,40,2740,30,16404,44,19144,California
Tehama,2021-05-23,54,34566,25,11691,15,21753,14,1122,14,2728,40,16444,28,19172,California
Tehama,2021-05-24,110,34676,34,11725,67,21820,9,1131,37,2701,73,16517,46,19218,California
Tehama,2021-05-25,85,34761,22,11747,54,21874,9,1140,48,2721,36,16553,56,19274,California
Tehama,2021-05-26,82,34843,34,11781,45,21919,3,1143,54,2750,28,16581,57,19331,California
Tehama,2021-05-27,169,35012,104,11885,61,21980,4,1147,54,2695,113,16694,58,19389,California
Tehama,2021-05-28,150,35162,41,11926,100,22080,9,1156,73,2701,76,16770,82,19471,California
Tehama,2021-05-29,55,35217,9,11935,41,22121,5,1161,33,2717,22,16792,38,19509,California
Tehama,2021-05-30,17,35234,5,11940,11,22132,1,1162,8,2717,9,16801,9,19518,California
Tehama,2021-05-31,18,35252,2,11942,15,22147,1,1163,5,2710,13,16814,6,19524,California
Tehama,2021-06-01,107,35359,19,11961,67,22214,21,1184,34,2693,72,16886,55,19579,California
Tehama,2021-06-02,96,35455,33,11994,58,22272,5,1189,37,2676,59,16945,42,19621,California
Tehama,2021-06-03,145,35600,104,12098,28,22300,13,1202,31,2606,114,17059,44,19665,California
Tehama,2021-06-04,159,35759,42,12140,101,22401,16,1218,65,2593,92,17151,79,19744,California
Tehama,2021-06-05,171,35930,139,12279,24,22425,8,1226,33,2497,137,17288,41,19785,California
Tehama,2021-06-06,18,35948,10,12289,2,22427,6,1232,4,2493,13,17301,9,19794,California
Tehama,2021-06-07,79,36027,31,12320,46,22473,2,1234,22,2460,57,17358,24,19818,California
Tehama,2021-06-08,112,36139,34,12354,68,22541,10,1244,40,2441,69,17427,50,19868,California
Tehama,2021-06-09,99,36238,49,12403,47,22588,3,1247,44,2433,55,17482,47,19915,California
Tehama,2021-06-10,276,36514,225,12628,41,22629,10,1257,39,2246,236,17718,49,19964,California
Tehama,2021-06-11,160,36674,73,12701,78,22707,9,1266,58,2214,99,17817,67,20031,California
Tehama,2021-06-12,66,36740,41,12742,25,22732,0,1266,27,2202,39,17856,27,20058,California
Tehama,2021-06-13,23,36763,6,12748,11,22743,6,1272,5,2195,18,17874,11,20069,California
Tehama,2021-06-14,101,36864,20,12768,73,22816,8,1280,32,2166,69,17943,40,20109,California
Tehama,2021-06-15,118,36982,59,12827,39,22855,20,1300,52,2173,65,18008,72,20181,California
Tehama,2021-06-16,97,37079,65,12892,29,22884,3,1303,49,2177,48,18056,52,20233,California
Tehama,2021-06-17,158,37237,112,13004,30,22914,16,1319,88,2212,68,18124,103,20336,California
Tehama,2021-06-18,110,37347,44,13048,51,22965,15,1334,36,2189,74,18198,51,20387,California
Tehama,2021-06-19,41,37388,15,13063,21,22986,5,1339,18,2189,23,18221,23,20410,California
Tehama,2021-06-20,16,37404,5,13068,10,22996,1,1340,6,2186,10,18231,7,20417,California
Tehama,2021-06-21,70,37474,20,13088,41,23037,9,1349,26,2177,44,18275,35,20452,California
Tehama,2021-06-22,80,37554,25,13113,41,23078,14,1363,33,2177,47,18322,47,20499,California
Tehama,2021-06-23,100,37654,57,13170,39,23117,4,1367,49,2180,49,18371,52,20551,California
Tehama,2021-06-24,89,37743,44,13214,37,23154,8,1375,48,2195,41,18412,56,20607,California
Tehama,2021-06-25,138,37881,76,13290,55,23209,7,1382,60,2185,77,18489,67,20674,California
Tehama,2021-06-26,47,37928,24,13314,23,23232,0,1382,22,2182,25,18514,22,20696,California
Tehama,2021-06-27,8,37936,4,13318,3,23235,1,1383,3,2181,5,18519,4,20700,California
Tehama,2021-06-28,46,37982,18,13336,23,23258,5,1388,23,2186,23,18542,28,20728,California
Tehama,2021-06-29,70,38052,27,13363,39,23297,4,1392,37,2195,32,18574,41,20769,California
Tehama,2021-06-30,92,38144,67,13430,23,23320,2,1394,47,2199,45,18619,49,20818,California
Tehama,2021-07-01,66,38210,33,13463,30,23350,3,1397,40,2216,26,18645,43,20861,California
Tehama,2021-07-02,96,38306,49,13512,45,23395,2,1399,42,2206,54,18699,44,20905,California
Tehama,2021-07-03,38,38344,19,13531,17,23412,2,1401,13,2196,25,18724,15,20920,California
Tehama,2021-07-04,6,38350,6,13537,0,23412,0,1401,3,2196,3,18727,3,20923,California
Tehama,2021-07-05,34,38384,15,13552,17,23429,2,1403,16,2196,18,18745,18,20941,California
Tehama,2021-07-06,96,38480,54,13606,35,23464,7,1410,36,2180,59,18804,43,20984,California
Tehama,2021-07-07,99,38579,74,13680,21,23485,4,1414,41,2167,58,18862,45,21029,California
Tehama,2021-07-08,131,38710,90,13770,34,23519,7,1421,36,2115,95,18957,43,21072,California
Tehama,2021-07-09,99,38809,59,13829,35,23554,5,1426,47,2115,52,19009,52,21124,California
Tehama,2021-07-10,27,38836,17,13846,10,23564,0,1426,12,2112,15,19024,12,21136,California
Tehama,2021-07-11,17,38853,8,13854,9,23573,0,1426,11,2117,6,19030,11,21147,California
Tehama,2021-07-12,50,38903,22,13876,19,23592,9,1435,23,2122,27,19057,32,21179,California
Tehama,2021-07-13,50,38953,19,13895,24,23616,7,1442,21,2121,29,19086,28,21207,California
Tehama,2021-07-14,107,39060,85,13980,22,23638,0,1442,42,2098,65,19151,42,21249,California
Tehama,2021-07-15,45,39105,21,14001,20,23658,4,1446,20,2097,25,19176,24,21273,California
Tehama,2021-07-16,79,39184,36,14037,37,23695,6,1452,44,2112,35,19211,50,21323,California
Tehama,2021-07-17,43,39227,23,14060,18,23713,2,1454,21,2113,22,19233,23,21346,California
Tehama,2021-07-18,13,39240,8,14068,5,23718,0,1454,4,2109,8,19241,4,21350,California
Tehama,2021-07-19,67,39307,32,14100,30,23748,5,1459,40,2127,27,19268,45,21395,California
Tehama,2021-07-20,79,39386,40,14140,37,23785,2,1461,42,2134,37,19305,44,21439,California
Tehama,2021-07-21,113,39499,84,14224,28,23813,1,1462,65,2152,48,19353,66,21505,California
Tehama,2021-07-22,91,39590,49,14273,34,23847,8,1470,52,2174,38,19391,60,21565,California
Tehama,2021-07-23,100,39690,44,14317,51,23898,5,1475,65,2210,34,19425,70,21635,California
Tehama,2021-07-24,24,39714,8,14325,16,23914,0,1475,18,2223,5,19430,18,21653,California
Tehama,2021-07-25,20,39734,5,14330,15,23929,0,1475,17,2237,3,19433,17,21670,California
Tehama,2021-07-26,104,39838,51,14381,43,23972,10,1485,57,2257,47,19480,67,21737,California
Tehama,2021-07-27,97,39935,42,14423,50,24022,5,1490,51,2269,44,19524,56,21793,California
Tehama,2021-07-28,109,40044,76,14499,30,24052,3,1493,68,2299,41,19565,71,21864,California
Tehama,2021-07-29,118,40162,55,14554,53,24105,10,1503,72,2335,46,19611,82,21946,California
Tehama,2021-07-30,123,40285,63,14617,58,24163,2,1505,72,2357,51,19662,73,22019,California
Tehama,2021-07-31,41,40326,14,14631,26,24189,1,1506,23,2363,18,19680,24,22043,California
Tehama,2021-08-01,27,40353,8,14639,19,24208,0,1506,21,2378,6,19686,21,22064,California
Tehama,2021-08-02,83,40436,27,14666,49,24257,7,1513,51,2404,32,19718,58,22122,California
Tehama,2021-08-03,77,40513,23,14689,48,24305,6,1519,54,2441,23,19741,60,22182,California
Tehama,2021-08-04,148,40661,92,14781,50,24355,6,1525,110,2519,38,19779,116,22298,California
Tehama,2021-08-05,130,40791,66,14847,51,24406,13,1538,94,2590,36,19815,107,22405,California
Tehama,2021-08-06,131,40922,72,14919,57,24463,2,1540,100,2661,31,19846,102,22507,California
Tehama,2021-08-07,52,40974,25,14944,26,24489,1,1541,37,2685,14,19860,38,22545,California
Tehama,2021-08-08,42,41016,19,14963,22,24511,1,1542,31,2707,10,19870,32,22577,California
Tehama,2021-08-09,84,41100,38,15001,35,24546,11,1553,54,2741,30,19900,64,22641,California
Tehama,2021-08-10,84,41184,29,15030,46,24592,9,1562,46,2761,35,19935,55,22696,California
Tehama,2021-08-11,145,41329,98,15128,40,24632,7,1569,80,2783,65,20000,87,22783,California
Tehama,2021-08-12,115,41444,63,15191,44,24676,8,1577,60,2796,55,20055,68,22851,California
Tehama,2021-08-13,146,41590,76,15267,65,24741,5,1582,91,2837,55,20110,96,22947,California
Tehama,2021-08-14,71,41661,30,15297,40,24781,1,1583,44,2855,27,20137,45,22992,California
Tehama,2021-08-15,32,41693,18,15315,13,24794,1,1584,22,2869,9,20146,23,23015,California
Tehama,2021-08-16,119,41812,59,15374,50,24844,10,1594,64,2891,52,20198,74,23089,California
Tehama,2021-08-17,83,41895,41,15415,38,24882,4,1598,42,2906,31,20229,46,23135,California
Tehama,2021-08-18,142,42037,90,15505,43,24925,9,1607,82,2941,56,20285,91,23226,California
Tehama,2021-08-19,151,42188,87,15592,59,24984,5,1612,78,2959,65,20350,83,23309,California
Tehama,2021-08-20,175,42363,75,15667,91,25075,9,1621,98,3002,64,20414,107,23416,California
Tehama,2021-08-21,50,42413,21,15688,27,25102,2,1623,28,3011,21,20435,30,23446,California
Tehama,2021-08-22,39,42452,14,15702,25,25127,0,1623,24,3023,12,20447,24,23470,California
Tehama,2021-08-23,91,42543,36,15738,50,25177,5,1628,64,3073,19,20466,69,23539,California
Tehama,2021-08-24,151,42694,88,15826,56,25233,7,1635,97,3128,49,20515,104,23643,California
Tehama,2021-08-25,176,42870,122,15948,50,25283,4,1639,99,3164,67,20582,103,23746,California
Tehama,2021-08-26,177,43047,111,16059,53,25336,13,1652,68,3150,95,20677,81,23827,California
Tehama,2021-08-27,155,43202,66,16125,80,25416,9,1661,70,3153,77,20754,80,23907,California
Tehama,2021-08-28,75,43277,43,16168,30,25446,2,1663,40,3160,35,20789,42,23949,California
Tehama,2021-08-29,44,43321,21,16189,15,25461,8,1671,19,3162,25,20814,27,23976,California
Tehama,2021-08-30,55,43376,18,16207,30,25491,7,1678,21,3157,33,20847,28,24004,California
Trinity,2020-12-17,3,3,3,3,0,0,0,0,3,3,0,0,3,3,California
Trinity,2020-12-18,2,5,2,5,0,0,0,0,2,5,0,0,2,5,California
Trinity,2020-12-21,38,43,38,43,0,0,0,0,38,43,0,0,38,43,California
Trinity,2020-12-22,4,47,4,47,0,0,0,0,4,47,0,0,4,47,California
Trinity,2020-12-23,6,53,5,52,1,1,0,0,6,53,0,0,6,53,California
Trinity,2020-12-28,30,83,30,82,0,1,0,0,30,83,0,0,30,83,California
Trinity,2020-12-29,8,91,7,89,1,2,0,0,8,91,0,0,8,91,California
Trinity,2020-12-30,10,101,8,97,2,4,0,0,10,101,0,0,10,101,California
Trinity,2020-12-31,2,103,1,98,1,5,0,0,2,103,0,0,2,103,California
Trinity,2021-01-04,27,130,0,98,27,32,0,0,26,129,0,0,26,129,California
Trinity,2021-01-05,2,132,1,99,1,33,0,0,2,131,0,0,2,131,California
Trinity,2021-01-06,24,156,4,103,20,53,0,0,20,147,4,4,20,151,California
Trinity,2021-01-08,48,204,1,104,47,100,0,0,48,194,1,5,48,199,California
Trinity,2021-01-11,41,245,38,142,3,103,0,0,4,161,37,42,4,203,California
Trinity,2021-01-12,10,255,6,148,4,107,0,0,5,161,5,47,5,208,California
Trinity,2021-01-13,7,262,4,152,3,110,0,0,4,162,3,50,4,212,California
Trinity,2021-01-14,4,266,1,153,3,113,0,0,4,166,0,50,4,216,California
Trinity,2021-01-15,6,272,0,153,6,119,0,0,6,172,0,50,6,222,California
Trinity,2021-01-16,2,274,0,153,2,121,0,0,2,174,0,50,2,224,California
Trinity,2021-01-18,31,305,31,184,0,121,0,0,1,145,30,80,1,225,California
Trinity,2021-01-19,35,340,15,199,20,141,0,0,21,152,14,94,21,246,California
Trinity,2021-01-20,21,361,4,203,17,158,0,0,18,167,3,97,18,264,California
Trinity,2021-01-21,17,378,7,210,10,168,0,0,17,184,0,97,17,281,California
Trinity,2021-01-22,5,383,1,211,4,172,0,0,5,189,0,97,5,286,California
Trinity,2021-01-23,7,390,3,214,4,176,0,0,7,196,0,97,7,293,California
Trinity,2021-01-25,14,404,1,215,13,189,0,0,13,208,1,98,13,306,California
Trinity,2021-01-26,12,416,1,216,11,200,0,0,11,218,1,99,11,317,California
Trinity,2021-01-27,12,428,0,216,12,212,0,0,12,230,0,99,12,329,California
Trinity,2021-01-28,12,440,2,218,10,222,0,0,9,236,3,102,9,338,California
Trinity,2021-01-29,5,445,0,218,5,227,0,0,4,239,1,103,4,342,California
Trinity,2021-01-30,12,457,11,229,1,228,0,0,12,251,0,103,12,354,California
Trinity,2021-02-01,2,459,1,230,1,229,0,0,1,251,1,104,1,355,California
Trinity,2021-02-02,15,474,3,233,12,241,0,0,14,264,1,105,14,369,California
Trinity,2021-02-03,6,480,1,234,5,246,0,0,4,266,2,107,4,373,California
Trinity,2021-02-04,40,520,31,265,9,255,0,0,33,292,7,114,33,406,California
Trinity,2021-02-05,353,873,0,265,353,608,0,0,322,583,31,145,322,728,California
Trinity,2021-02-06,207,1080,5,270,202,810,0,0,200,776,7,152,200,928,California
Trinity,2021-02-07,1,1081,0,270,1,811,0,0,1,777,0,152,1,929,California
Trinity,2021-02-08,29,1110,2,272,27,838,0,0,16,780,13,165,16,945,California
Trinity,2021-02-09,28,1138,2,274,26,864,0,0,10,772,18,183,10,955,California
Trinity,2021-02-10,122,1260,11,285,111,975,0,0,101,852,21,204,101,1056,California
Trinity,2021-02-11,334,1594,2,287,332,1307,0,0,327,1172,7,211,327,1383,California
Trinity,2021-02-12,24,1618,15,302,9,1316,0,0,18,1184,6,217,18,1401,California
Trinity,2021-02-13,11,1629,6,308,5,1321,0,0,6,1185,5,222,6,1407,California
Trinity,2021-02-14,2,1631,2,310,0,1321,0,0,2,1187,0,222,2,1409,California
Trinity,2021-02-15,46,1677,0,310,46,1367,0,0,46,1233,0,222,46,1455,California
Trinity,2021-02-16,7,1684,2,312,5,1372,0,0,4,1234,3,225,4,1459,California
Trinity,2021-02-17,93,1777,2,314,91,1463,0,0,83,1307,10,235,83,1542,California
Trinity,2021-02-18,3,1780,0,314,3,1466,0,0,1,1306,2,237,1,1543,California
Trinity,2021-02-19,312,2092,1,315,311,1777,0,0,299,1592,13,250,299,1842,California
Trinity,2021-02-20,143,2235,14,329,129,1906,0,0,115,1679,28,278,115,1957,California
Trinity,2021-02-21,1,2236,1,330,0,1906,0,0,1,1680,0,278,1,1958,California
Trinity,2021-02-22,8,2244,0,330,8,1914,0,0,5,1682,3,281,5,1963,California
Trinity,2021-02-23,12,2256,3,333,9,1923,0,0,5,1680,7,288,5,1968,California
Trinity,2021-02-24,30,2286,8,341,22,1945,0,0,7,1664,23,311,7,1975,California
Trinity,2021-02-25,39,2325,25,366,14,1959,0,0,5,1635,34,345,5,1980,California
Trinity,2021-02-26,15,2340,2,368,13,1972,0,0,6,1632,9,354,6,1986,California
Trinity,2021-02-27,11,2351,9,377,2,1974,0,0,5,1631,6,360,5,1991,California
Trinity,2021-03-01,11,2362,1,378,10,1984,0,0,5,1630,6,366,5,1996,California
Trinity,2021-03-02,9,2371,3,381,6,1990,0,0,2,1625,7,373,2,1998,California
Trinity,2021-03-03,4,2375,0,381,4,1994,0,0,3,1627,1,374,3,2001,California
Trinity,2021-03-04,24,2399,20,401,4,1998,0,0,5,1613,19,393,5,2006,California
Trinity,2021-03-05,390,2789,1,402,389,2387,0,0,120,1467,266,659,120,2126,California
Trinity,2021-03-06,198,2987,6,408,192,2579,0,0,25,1319,173,832,25,2151,California
Trinity,2021-03-07,6,2993,3,411,2,2581,1,1,3,1320,3,835,4,2155,California
Trinity,2021-03-08,4,2997,0,411,3,2584,1,2,1,1319,3,838,2,2157,California
Trinity,2021-03-09,99,3096,1,412,96,2680,2,4,93,1408,6,844,95,2252,California
Trinity,2021-03-10,125,3221,3,415,119,2799,3,7,38,1362,87,931,41,2293,California
Trinity,2021-03-11,15,3236,3,418,10,2809,2,9,4,1357,11,942,6,2299,California
Trinity,2021-03-12,400,3636,5,423,389,3198,6,15,98,1159,302,1244,104,2403,California
Trinity,2021-03-13,13,3649,7,430,4,3202,2,17,7,1162,6,1250,9,2412,California
Trinity,2021-03-14,4,3653,1,431,3,3205,0,17,3,1164,1,1251,3,2415,California
Trinity,2021-03-15,67,3720,0,431,66,3271,1,18,15,1128,52,1303,16,2431,California
Trinity,2021-03-16,117,3837,7,438,110,3381,0,18,104,1219,13,1316,104,2535,California
Trinity,2021-03-17,99,3936,3,441,96,3477,0,18,26,1172,73,1389,26,2561,California
Trinity,2021-03-18,14,3950,3,444,8,3485,3,21,7,1175,7,1396,10,2571,California
Trinity,2021-03-19,463,4413,4,448,349,3834,110,131,33,888,430,1826,143,2714,California
Trinity,2021-03-20,109,4522,6,454,103,3937,0,131,70,920,38,1864,70,2784,California
Trinity,2021-03-21,5,4527,0,454,3,3940,2,133,3,923,2,1866,5,2789,California
Trinity,2021-03-22,2,4529,0,454,2,3942,0,133,2,925,0,1866,2,2791,California
Trinity,2021-03-23,95,4624,2,456,92,4034,1,134,77,985,18,1884,78,2869,California
Trinity,2021-03-24,12,4636,1,457,11,4045,0,134,9,991,3,1887,9,2878,California
Trinity,2021-03-25,111,4747,8,465,97,4142,6,140,85,1056,26,1913,91,2969,California
Trinity,2021-03-26,84,4831,8,473,76,4218,0,140,77,1126,7,1920,77,3046,California
Trinity,2021-03-27,28,4859,3,476,16,4234,9,149,18,1143,10,1930,27,3073,California
Trinity,2021-03-28,5,4864,3,479,2,4236,0,149,1,1140,4,1934,1,3074,California
Trinity,2021-03-29,5,4869,0,479,5,4241,0,149,2,1139,3,1937,2,3076,California
Trinity,2021-03-30,79,4948,7,486,72,4313,0,149,68,1196,11,1948,68,3144,California
Trinity,2021-03-31,56,5004,5,491,18,4331,33,182,20,1212,36,1984,52,3196,California
Trinity,2021-04-01,41,5045,10,501,20,4351,11,193,22,1226,19,2003,33,3229,California
Trinity,2021-04-02,261,5306,6,507,180,4531,75,268,87,1215,173,2176,162,3391,California
Trinity,2021-04-03,18,5324,13,520,5,4536,0,268,8,1213,10,2186,8,3399,California
Trinity,2021-04-04,10,5334,8,528,2,4538,0,268,8,1219,2,2188,8,3407,California
Trinity,2021-04-05,60,5394,6,534,51,4589,3,271,53,1269,6,2194,56,3463,California
Trinity,2021-04-06,124,5518,15,549,105,4694,4,275,30,1208,94,2288,33,3496,California
Trinity,2021-04-07,26,5544,11,560,10,4704,5,280,19,1225,7,2295,24,3520,California
Trinity,2021-04-08,91,5635,12,572,77,4781,2,282,53,1242,38,2333,55,3575,California
Trinity,2021-04-09,168,5803,18,590,146,4927,4,286,90,1258,78,2411,94,3669,California
Trinity,2021-04-10,12,5815,7,597,5,4932,0,286,11,1268,1,2412,11,3680,California
Trinity,2021-04-11,10,5825,5,602,3,4935,2,288,4,1268,6,2418,6,3686,California
Trinity,2021-04-12,78,5903,5,607,72,5007,1,289,64,1319,13,2431,64,3750,California
Trinity,2021-04-13,106,6009,6,613,100,5107,0,289,12,1237,94,2525,12,3762,California
Trinity,2021-04-14,10,6019,5,618,5,5112,0,289,6,1239,4,2529,6,3768,California
Trinity,2021-04-15,46,6065,10,628,36,5148,0,289,15,1224,30,2559,15,3783,California
Trinity,2021-04-16,161,6226,13,641,148,5296,0,289,85,1235,74,2633,85,3868,California
Trinity,2021-04-17,11,6237,5,646,6,5302,0,289,9,1242,2,2635,9,3877,California
Trinity,2021-04-18,3,6240,1,647,2,5304,0,289,0,1239,3,2638,0,3877,California
Trinity,2021-04-19,68,6308,2,649,66,5370,0,289,67,1305,1,2639,67,3944,California
Trinity,2021-04-20,94,6402,8,657,86,5456,0,289,20,1251,74,2713,20,3964,California
Trinity,2021-04-21,22,6424,9,666,13,5469,0,289,9,1247,13,2726,9,3973,California
Trinity,2021-04-22,94,6518,6,672,88,5557,0,289,15,1183,79,2805,15,3988,California
Trinity,2021-04-23,182,6700,6,678,176,5733,0,289,112,1225,70,2875,112,4100,California
Trinity,2021-04-24,35,6735,15,693,20,5753,0,289,7,1204,28,2903,7,4107,California
Trinity,2021-04-25,10,6745,9,702,1,5754,0,289,3,1201,6,2909,3,4110,California
Trinity,2021-04-26,49,6794,9,711,40,5794,0,289,41,1234,8,2917,41,4151,California
Trinity,2021-04-27,87,6881,12,723,75,5869,0,289,23,1193,64,2981,23,4174,California
Trinity,2021-04-28,31,6912,10,733,21,5890,0,289,11,1184,20,3001,11,4185,California
Trinity,2021-04-29,36,6948,13,746,23,5913,0,289,12,1172,24,3025,12,4197,California
Trinity,2021-04-30,26,6974,21,767,5,5918,0,289,10,1167,15,3040,10,4207,California
Trinity,2021-05-01,15,6989,8,775,2,5920,5,294,5,1167,10,3050,10,4217,California
Trinity,2021-05-02,8,6997,5,780,1,5921,2,296,2,1165,6,3056,4,4221,California
Trinity,2021-05-03,57,7054,13,793,43,5964,1,297,9,1128,47,3103,10,4231,California
Trinity,2021-05-04,28,7082,11,804,16,5980,1,298,8,1117,20,3123,9,4240,California
Trinity,2021-05-05,11,7093,7,811,4,5984,0,298,4,1114,7,3130,4,4244,California
Trinity,2021-05-06,77,7170,11,822,63,6047,3,301,16,1072,61,3191,19,4263,California
Trinity,2021-05-07,182,7352,12,834,136,6183,34,335,15,954,167,3358,49,4312,California
Trinity,2021-05-08,7,7359,2,836,5,6188,0,335,2,951,5,3363,2,4314,California
Trinity,2021-05-09,11,7370,8,844,3,6191,0,335,7,954,4,3367,7,4321,California
Trinity,2021-05-10,15,7385,4,848,10,6201,1,336,8,956,7,3374,9,4330,California
Trinity,2021-05-11,8,7393,4,852,4,6205,0,336,6,960,2,3376,6,4336,California
Trinity,2021-05-12,19,7412,16,868,2,6207,1,337,14,970,5,3381,15,4351,California
Trinity,2021-05-13,15,7427,10,878,4,6211,1,338,9,974,6,3387,10,4361,California
Trinity,2021-05-14,145,7572,19,897,98,6309,28,366,39,935,106,3493,67,4428,California
Trinity,2021-05-15,17,7589,12,909,4,6313,1,367,8,936,8,3501,9,4437,California
Trinity,2021-05-16,9,7598,7,916,2,6315,0,367,6,939,3,3504,6,4443,California
Trinity,2021-05-17,108,7706,20,936,86,6401,2,369,42,917,66,3570,44,4487,California
Trinity,2021-05-18,39,7745,8,944,30,6431,1,370,11,901,28,3598,12,4499,California
Trinity,2021-05-19,149,7894,16,960,103,6534,30,400,29,841,119,3717,59,4558,California
Trinity,2021-05-20,28,7922,21,981,4,6538,3,403,17,850,11,3728,20,4578,California
Trinity,2021-05-21,21,7943,14,995,7,6545,0,403,12,853,9,3737,12,4590,California
Trinity,2021-05-22,17,7960,14,1009,3,6548,0,403,13,862,4,3741,13,4603,California
Trinity,2021-05-23,6,7966,4,1013,2,6550,0,403,2,860,4,3745,2,4605,California
Trinity,2021-05-24,114,8080,12,1025,101,6651,1,404,9,766,104,3849,10,4615,California
Trinity,2021-05-25,39,8119,14,1039,25,6676,0,404,17,761,22,3871,17,4632,California
Trinity,2021-05-26,12,8131,6,1045,6,6682,0,404,4,757,8,3879,4,4636,California
Trinity,2021-05-27,31,8162,14,1059,12,6694,5,409,8,747,23,3902,13,4649,California
Trinity,2021-05-28,16,8178,11,1070,4,6698,1,410,9,750,7,3909,10,4659,California
Trinity,2021-05-29,10,8188,7,1077,2,6700,1,411,7,755,3,3912,8,4667,California
Trinity,2021-05-30,6,8194,5,1082,1,6701,0,411,0,749,6,3918,0,4667,California
Trinity,2021-05-31,4,8198,3,1085,1,6702,0,411,2,749,2,3920,2,4669,California
Trinity,2021-06-01,14,8212,7,1092,5,6707,2,413,3,744,10,3930,5,4674,California
Trinity,2021-06-02,23,8235,18,1110,3,6710,2,415,8,739,15,3945,10,4684,California
Trinity,2021-06-03,39,8274,13,1123,26,6736,0,415,13,726,26,3971,13,4697,California
Trinity,2021-06-04,46,8320,21,1144,17,6753,8,423,12,712,34,4005,20,4717,California
Trinity,2021-06-05,19,8339,18,1162,1,6754,0,423,13,719,6,4011,13,4730,California
Trinity,2021-06-06,9,8348,6,1168,2,6756,1,424,2,715,7,4018,3,4733,California
Trinity,2021-06-07,30,8378,19,1187,10,6766,1,425,14,714,16,4034,15,4748,California
Trinity,2021-06-08,16,8394,13,1200,1,6767,2,427,4,708,12,4046,6,4754,California
Trinity,2021-06-09,31,8425,14,1214,1,6768,16,443,5,703,26,4072,21,4775,California
Trinity,2021-06-10,28,8453,19,1233,3,6771,6,449,7,695,21,4093,13,4788,California
Trinity,2021-06-11,46,8499,10,1243,34,6805,2,451,15,681,31,4124,17,4805,California
Trinity,2021-06-12,19,8518,10,1253,1,6806,8,459,4,678,15,4139,12,4817,California
Trinity,2021-06-13,4,8522,4,1257,0,6806,0,459,1,676,3,4142,1,4818,California
Trinity,2021-06-14,43,8565,16,1273,27,6833,0,459,11,655,32,4174,11,4829,California
Trinity,2021-06-15,56,8621,21,1294,12,6845,23,482,15,651,41,4215,37,4866,California
Trinity,2021-06-16,14,8635,6,1300,5,6850,3,485,4,648,10,4225,7,4873,California
Trinity,2021-06-17,19,8654,12,1312,1,6851,6,491,6,648,12,4237,12,4885,California
Trinity,2021-06-18,21,8675,11,1323,7,6858,3,494,6,642,15,4252,9,4894,California
Trinity,2021-06-19,15,8690,9,1332,3,6861,3,497,4,638,11,4263,7,4901,California
Trinity,2021-06-20,3,8693,3,1335,0,6861,0,497,3,641,0,4263,3,4904,California
Trinity,2021-06-21,9,8702,6,1341,1,6862,2,499,6,646,3,4266,8,4912,California
Trinity,2021-06-22,33,8735,9,1350,14,6876,10,509,14,651,19,4285,24,4936,California
Trinity,2021-06-23,15,8750,7,1357,2,6878,6,515,3,648,12,4297,9,4945,California
Trinity,2021-06-24,25,8775,15,1372,4,6882,6,521,16,661,9,4306,22,4967,California
Trinity,2021-06-25,10,8785,9,1381,0,6882,1,522,6,663,4,4310,6,4973,California
Trinity,2021-06-26,18,8803,18,1399,0,6882,0,522,8,661,10,4320,8,4981,California
Trinity,2021-06-27,4,8807,4,1403,0,6882,0,522,0,657,4,4324,0,4981,California
Trinity,2021-06-28,11,8818,9,1412,1,6883,1,523,4,655,7,4331,5,4986,California
Trinity,2021-06-29,11,8829,5,1417,3,6886,3,526,5,657,6,4337,8,4994,California
Trinity,2021-06-30,14,8843,10,1427,1,6887,3,529,6,658,8,4345,9,5003,California
Trinity,2021-07-01,32,8875,13,1440,12,6899,7,536,11,655,21,4366,18,5021,California
Trinity,2021-07-02,24,8899,6,1446,6,6905,12,548,6,655,18,4384,18,5039,California
Trinity,2021-07-03,4,8903,1,1447,0,6905,3,551,0,654,4,4388,3,5042,California
Trinity,2021-07-04,2,8905,1,1448,1,6906,0,551,1,654,1,4389,1,5043,California
Trinity,2021-07-05,14,8919,12,1460,2,6908,0,551,7,654,7,4396,7,5050,California
Trinity,2021-07-06,12,8931,10,1470,2,6910,0,551,6,654,6,4402,6,5056,California
Trinity,2021-07-07,13,8944,9,1479,1,6911,3,554,6,656,7,4409,9,5065,California
Trinity,2021-07-08,15,8959,7,1486,1,6912,7,561,2,651,13,4422,8,5073,California
Trinity,2021-07-09,26,8985,8,1494,15,6927,3,564,9,646,17,4439,12,5085,California
Trinity,2021-07-10,9,8994,6,1500,3,6930,0,564,7,651,2,4441,7,5092,California
Trinity,2021-07-11,7,9001,4,1504,0,6930,3,567,4,655,3,4444,7,5099,California
Trinity,2021-07-12,34,9035,11,1515,22,6952,1,568,9,640,25,4469,10,5109,California
Trinity,2021-07-13,17,9052,12,1527,5,6957,0,568,7,637,10,4479,7,5116,California
Trinity,2021-07-14,14,9066,7,1534,1,6958,6,574,5,639,9,4488,11,5127,California
Trinity,2021-07-15,16,9082,13,1547,2,6960,1,575,7,638,9,4497,8,5135,California
Trinity,2021-07-16,11,9093,7,1554,2,6962,2,577,3,635,8,4505,5,5140,California
Trinity,2021-07-17,21,9114,7,1561,7,6969,7,584,6,633,15,4520,13,5153,California
Trinity,2021-07-18,2,9116,2,1563,0,6969,0,584,2,635,0,4520,2,5155,California
Trinity,2021-07-19,12,9128,12,1575,0,6969,0,584,11,645,1,4521,11,5166,California
Trinity,2021-07-20,35,9163,8,1583,23,6992,4,588,20,654,15,4536,24,5190,California
Trinity,2021-07-21,14,9177,9,1592,4,6996,1,589,7,656,6,4542,8,5198,California
Trinity,2021-07-22,21,9198,12,1604,7,7003,2,591,8,653,13,4555,10,5208,California
Trinity,2021-07-23,22,9220,17,1621,2,7005,3,594,15,664,7,4562,18,5226,California
Trinity,2021-07-24,16,9236,11,1632,0,7005,5,599,9,671,7,4569,14,5240,California
Trinity,2021-07-25,3,9239,1,1633,1,7006,1,600,1,671,2,4571,2,5242,California
Trinity,2021-07-26,12,9251,11,1644,1,7007,0,600,11,681,1,4572,11,5253,California
Trinity,2021-07-27,39,9290,25,1669,5,7012,9,609,18,687,21,4593,27,5280,California
Trinity,2021-07-28,38,9328,22,1691,6,7018,10,619,15,689,23,4616,25,5305,California
Trinity,2021-07-29,21,9349,8,1699,2,7020,11,630,9,697,12,4628,20,5325,California
Trinity,2021-07-30,20,9369,16,1715,2,7022,2,632,9,697,11,4639,11,5336,California
Trinity,2021-07-31,9,9378,9,1724,0,7022,0,632,6,700,3,4642,6,5342,California
Trinity,2021-08-01,7,9385,7,1731,0,7022,0,632,3,699,4,4646,3,5345,California
Trinity,2021-08-02,18,9403,13,1744,4,7026,1,633,14,710,4,4650,15,5360,California
Trinity,2021-08-03,9,9412,7,1751,2,7028,0,633,5,711,4,4654,5,5365,California
Trinity,2021-08-04,17,9429,14,1765,2,7030,1,634,11,718,5,4659,12,5377,California
Trinity,2021-08-05,13,9442,10,1775,1,7031,2,636,5,717,8,4667,7,5384,California
Trinity,2021-08-06,15,9457,13,1788,2,7033,0,636,11,724,4,4671,11,5395,California
Trinity,2021-08-07,14,9471,12,1800,2,7035,0,636,4,718,10,4681,4,5399,California
Trinity,2021-08-08,6,9477,5,1805,0,7035,1,637,2,717,4,4685,3,5402,California
Trinity,2021-08-09,17,9494,9,1814,8,7043,0,637,7,714,10,4695,7,5409,California
Trinity,2021-08-10,15,9509,11,1825,3,7046,1,638,6,712,9,4704,7,5416,California
Trinity,2021-08-11,6,9515,4,1829,2,7048,0,638,5,716,1,4705,5,5421,California
Trinity,2021-08-12,11,9526,9,1838,0,7048,2,640,6,720,4,4709,8,5429,California
Trinity,2021-08-13,23,9549,20,1858,3,7051,0,640,11,719,12,4721,11,5440,California
Trinity,2021-08-14,15,9564,14,1872,0,7051,1,641,10,725,5,4726,11,5451,California
Trinity,2021-08-15,7,9571,7,1879,0,7051,0,641,4,726,3,4729,4,5455,California
Trinity,2021-08-16,20,9591,13,1892,7,7058,0,641,12,730,8,4737,12,5467,California
Trinity,2021-08-17,39,9630,10,1902,25,7083,4,645,21,739,16,4753,25,5492,California
Trinity,2021-08-18,13,9643,12,1914,1,7084,0,645,6,738,7,4760,6,5498,California
Trinity,2021-08-19,17,9660,8,1922,9,7093,0,645,7,735,10,4770,7,5505,California
Trinity,2021-08-20,18,9678,8,1930,10,7103,0,645,6,732,9,4779,6,5511,California
Trinity,2021-08-21,11,9689,7,1937,4,7107,0,645,8,737,3,4782,8,5519,California
Trinity,2021-08-22,17,9706,15,1952,2,7109,0,645,12,744,5,4787,12,5531,California
Trinity,2021-08-23,25,9731,21,1973,2,7111,2,647,8,738,17,4804,11,5542,California
Trinity,2021-08-24,20,9751,9,1982,9,7120,2,649,11,743,8,4812,13,5555,California
Trinity,2021-08-25,14,9765,10,1992,4,7124,0,649,6,742,7,4819,6,5561,California
Trinity,2021-08-26,28,9793,20,2012,5,7129,3,652,14,745,14,4833,17,5578,California
Trinity,2021-08-27,21,9814,16,2028,4,7133,1,653,14,754,6,4839,15,5593,California
Trinity,2021-08-28,5,9819,5,2033,0,7133,0,653,2,753,3,4842,2,5595,California
Trinity,2021-08-29,2,9821,2,2035,0,7133,0,653,1,753,1,4843,1,5596,California
Trinity,2021-08-30,17,9838,12,2047,5,7138,0,653,11,759,5,4848,11,5607,California
Tulare,2020-12-15,1,1,1,1,0,0,0,0,1,1,0,0,1,1,California
Tulare,2020-12-16,5,6,5,6,0,0,0,0,5,6,0,0,5,6,California
Tulare,2020-12-17,109,115,109,115,0,0,0,0,109,115,0,0,109,115,California
Tulare,2020-12-18,294,409,293,408,1,1,0,0,294,409,0,0,294,409,California
Tulare,2020-12-19,321,730,321,729,0,1,0,0,321,730,0,0,321,730,California
Tulare,2020-12-20,163,893,163,892,0,1,0,0,163,893,0,0,163,893,California
Tulare,2020-12-21,423,1316,423,1315,0,1,0,0,443,1336,0,0,443,1336,California
Tulare,2020-12-22,478,1794,477,1792,1,2,0,0,477,1813,0,0,477,1813,California
Tulare,2020-12-23,333,2127,324,2116,9,11,0,0,331,2144,0,0,331,2144,California
Tulare,2020-12-24,20,2147,18,2134,2,13,0,0,20,2164,0,0,20,2164,California
Tulare,2020-12-26,7,2154,6,2140,1,14,0,0,7,2171,0,0,7,2171,California
Tulare,2020-12-27,16,2170,12,2152,4,18,0,0,16,2187,0,0,16,2187,California
Tulare,2020-12-28,485,2655,472,2624,13,31,0,0,484,2671,0,0,484,2671,California
Tulare,2020-12-29,553,3208,481,3105,72,103,0,0,553,3224,0,0,553,3224,California
Tulare,2020-12-30,470,3678,427,3532,43,146,0,0,470,3694,0,0,470,3694,California
Tulare,2020-12-31,102,3780,24,3556,78,224,0,0,102,3796,0,0,102,3796,California
Tulare,2021-01-01,5,3785,1,3557,4,228,0,0,5,3801,0,0,5,3801,California
Tulare,2021-01-02,34,3819,20,3577,14,242,0,0,34,3835,0,0,34,3835,California
Tulare,2021-01-03,23,3842,9,3586,14,256,0,0,23,3858,0,0,23,3858,California
Tulare,2021-01-04,98,3940,19,3605,79,335,0,0,98,3956,0,0,98,3956,California
Tulare,2021-01-05,471,4411,283,3888,188,523,0,0,469,4423,2,2,469,4425,California
Tulare,2021-01-06,864,5275,632,4520,232,755,0,0,854,5267,10,12,854,5279,California
Tulare,2021-01-07,793,6068,593,5113,200,955,0,0,685,5844,108,120,685,5964,California
Tulare,2021-01-08,1293,7361,572,5685,721,1676,0,0,954,6460,338,458,954,6918,California
Tulare,2021-01-09,807,8168,209,5894,598,2274,0,0,613,6879,194,652,613,7531,California
Tulare,2021-01-10,59,8227,50,5944,9,2283,0,0,16,6852,43,695,16,7547,California
Tulare,2021-01-11,1282,9509,774,6718,508,2791,0,0,841,7252,441,1136,841,8388,California
Tulare,2021-01-12,1462,10971,517,7235,945,3736,0,0,1042,7877,419,1555,1044,9432,California
Tulare,2021-01-13,418,11389,187,7422,231,3967,0,0,336,8131,82,1637,336,9768,California
Tulare,2021-01-14,501,11890,149,7571,352,4319,0,0,473,8587,17,1654,473,10241,California
Tulare,2021-01-15,1712,13602,161,7732,1551,5870,0,0,1701,10277,11,1665,1701,11942,California
Tulare,2021-01-16,1949,15551,124,7856,1825,7695,0,0,1935,12198,14,1679,1935,13877,California
Tulare,2021-01-17,142,15693,122,7978,20,7715,0,0,132,12320,10,1689,132,14009,California
Tulare,2021-01-18,699,16392,663,8641,36,7751,0,0,297,12215,402,2091,297,14306,California
Tulare,2021-01-19,1039,17431,701,9342,338,8089,0,0,606,12389,433,2524,607,14913,California
Tulare,2021-01-20,2491,19922,664,10006,1827,9916,0,0,2056,14056,390,2914,2057,16970,California
Tulare,2021-01-21,1650,21572,234,10240,1416,11332,0,0,1621,15654,23,2937,1621,18591,California
Tulare,2021-01-22,1106,22678,212,10452,894,12226,0,0,1075,16699,30,2967,1075,19666,California
Tulare,2021-01-23,444,23122,156,10608,288,12514,0,0,423,17101,21,2988,423,20089,California
Tulare,2021-01-24,31,23153,28,10636,3,12517,0,0,29,17128,2,2990,29,20118,California
Tulare,2021-01-25,1364,24517,994,11630,370,12887,0,0,1309,18382,55,3045,1309,21427,California
Tulare,2021-01-26,1521,26038,1108,12738,413,13300,0,0,1175,19212,345,3390,1175,22602,California
Tulare,2021-01-27,1503,27541,1076,13814,427,13727,0,0,921,19552,581,3971,921,23523,California
Tulare,2021-01-28,1228,28769,781,14595,447,14174,0,0,821,19966,407,4378,821,24344,California
Tulare,2021-01-29,1132,29901,718,15313,414,14588,0,0,820,20474,312,4690,820,25164,California
Tulare,2021-01-30,1680,31581,1584,16897,96,14684,0,0,1656,22107,24,4714,1657,26821,California
Tulare,2021-01-31,66,31647,62,16959,4,14688,0,0,62,22165,4,4718,62,26883,California
Tulare,2021-02-01,1188,32835,905,17864,283,14971,0,0,817,22612,370,5088,817,27700,California
Tulare,2021-02-02,704,33539,342,18206,362,15333,0,0,446,22803,256,5344,447,28147,California
Tulare,2021-02-03,576,34115,236,18442,340,15673,0,0,331,22929,205,5549,331,28478,California
Tulare,2021-02-04,597,34712,184,18626,413,16086,0,0,286,22907,310,5859,288,28766,California
Tulare,2021-02-05,1242,35954,236,18862,1006,17092,0,0,403,22473,837,6696,403,29169,California
Tulare,2021-02-06,847,36801,167,19029,680,17772,0,0,211,22050,634,7330,211,29380,California
Tulare,2021-02-07,86,36887,72,19101,14,17786,0,0,24,22012,62,7392,24,29404,California
Tulare,2021-02-08,958,37845,334,19435,624,18410,0,0,240,21537,715,8107,240,29644,California
Tulare,2021-02-09,1436,39281,336,19771,1100,19510,0,0,355,20817,1075,9182,355,29999,California
Tulare,2021-02-10,2501,41782,1996,21767,505,20015,0,0,2090,22500,408,9590,2091,32090,California
Tulare,2021-02-11,1367,43149,383,22150,984,20999,0,0,887,22907,480,10070,887,32977,California
Tulare,2021-02-12,2813,45962,570,22720,2243,23242,0,0,1165,22433,1639,11709,1165,34142,California
Tulare,2021-02-13,2491,48453,157,22877,2334,25576,0,0,641,21229,1845,13554,641,34783,California
Tulare,2021-02-14,340,48793,39,22916,301,25877,0,0,303,21495,37,13591,303,35086,California
Tulare,2021-02-15,929,49722,295,23211,634,26511,0,0,662,21891,266,13857,662,35748,California
Tulare,2021-02-16,2878,52600,1605,24816,1273,27784,0,0,1102,21222,1772,15629,1103,36851,California
Tulare,2021-02-17,2734,55334,523,25339,2211,29995,0,0,457,19408,2271,17900,457,37308,California
Tulare,2021-02-18,2385,57719,460,25799,1925,31920,0,0,652,18337,1723,19623,652,37960,California
Tulare,2021-02-19,2366,60085,881,26680,1485,33405,0,0,970,17916,1391,21014,970,38930,California
Tulare,2021-02-20,3024,63109,1897,28577,1127,34532,0,0,1270,17441,1745,22759,1270,40200,California
Tulare,2021-02-21,99,63208,96,28673,3,34535,0,0,46,17437,50,22809,46,40246,California
Tulare,2021-02-22,1166,64374,741,29414,425,34960,0,0,218,16709,946,23755,218,40464,California
Tulare,2021-02-23,2048,66422,992,30406,1056,36016,0,0,1494,17652,551,24306,1494,41958,California
Tulare,2021-02-24,2550,68972,1585,31991,965,36981,0,0,2150,19406,397,24703,2151,44109,California
Tulare,2021-02-25,3684,72656,2059,34050,1625,38606,0,0,3233,22195,446,25149,3235,47344,California
Tulare,2021-02-26,4020,76676,1952,36002,2068,40674,0,0,3524,25226,494,25643,3525,50869,California
Tulare,2021-02-27,3166,79842,1594,37596,1572,42246,0,0,3023,28119,130,25773,3023,53892,California
Tulare,2021-02-28,1376,81218,1087,38683,289,42535,0,0,1350,29449,20,25793,1350,55242,California
Tulare,2021-03-01,1858,83076,828,39511,1029,43564,1,1,1649,30894,205,25998,1650,56892,California
Tulare,2021-03-02,2897,85973,1297,40808,1600,45164,0,1,2702,33406,191,26189,2703,59595,California
Tulare,2021-03-03,4172,90145,2772,43580,1399,46563,1,2,2187,33620,1978,28167,2192,61787,California
Tulare,2021-03-04,3055,93200,1386,44966,1669,48232,0,2,2697,35967,350,28517,2697,64484,California
Tulare,2021-03-05,3568,96768,1794,46760,1759,49991,15,17,3040,38501,525,29042,3059,67543,California
Tulare,2021-03-06,3122,99890,1461,48221,1602,51593,59,76,2860,41160,259,29301,2918,70461,California
Tulare,2021-03-07,1171,101061,716,48937,423,52016,32,108,1115,42252,55,29356,1147,71608,California
Tulare,2021-03-08,1749,102810,1011,49948,568,52584,170,278,1413,43504,330,29686,1582,73190,California
Tulare,2021-03-09,3310,106120,2258,52206,899,53483,153,431,2876,46097,433,30119,3026,76216,California
Tulare,2021-03-10,3015,109135,1417,53623,1421,54904,177,608,2600,48471,402,30521,2776,78992,California
Tulare,2021-03-11,4294,113429,2022,55645,1962,56866,310,918,3318,51123,976,31497,3628,82620,California
Tulare,2021-03-12,4485,117914,2447,58092,1679,58545,359,1277,3172,53349,1303,32800,3529,86149,California
Tulare,2021-03-13,4191,122105,1961,60053,2126,60671,104,1381,3224,55719,959,33759,3329,89478,California
Tulare,2021-03-14,1868,123973,996,61049,652,61323,220,1601,1338,56745,529,34288,1555,91033,California
Tulare,2021-03-15,2792,126765,1652,62701,1023,62346,117,1718,2005,58089,780,35068,2124,93157,California
Tulare,2021-03-16,3504,130269,2128,64829,1296,63642,80,1798,1920,58515,1577,36645,2003,95160,California
Tulare,2021-03-17,4124,134393,2685,67514,1363,65005,76,1874,2338,59158,1777,38422,2420,97580,California
Tulare,2021-03-18,4741,139134,3450,70964,1217,66222,74,1948,2483,59476,2245,40667,2563,100143,California
Tulare,2021-03-19,5200,144334,3408,74372,1569,67791,223,2171,2728,59978,2451,43118,2953,103096,California
Tulare,2021-03-20,4542,148876,2842,77214,1328,69119,372,2543,2045,59913,2486,45604,2421,105517,California
Tulare,2021-03-21,2027,150903,1738,78952,262,69381,27,2570,1036,59989,986,46590,1062,106579,California
Tulare,2021-03-22,2601,153504,1805,80757,683,70064,113,2683,1701,60913,893,47483,1817,108396,California
Tulare,2021-03-23,3848,157352,2219,82976,1576,71640,53,2736,2096,61327,1738,49221,2152,110548,California
Tulare,2021-03-24,3259,160611,2019,84995,1198,72838,42,2778,1726,61574,1522,50743,1769,112317,California
Tulare,2021-03-25,3561,164172,1841,86836,1556,74394,164,2942,1661,61508,1892,52635,1826,114143,California
Tulare,2021-03-26,5342,169514,3173,90009,2053,76447,116,3058,2519,61338,2804,55439,2634,116777,California
Tulare,2021-03-27,3596,173110,1839,91848,1656,78103,101,3159,943,59739,2642,58081,1043,117820,California
Tulare,2021-03-28,1493,174603,1082,92930,380,78483,31,3190,677,59643,814,58895,718,118538,California
Tulare,2021-03-29,2917,177520,1689,94619,1119,79602,109,3299,1221,59284,1691,60586,1332,119870,California
Tulare,2021-03-30,4991,182511,2823,97442,1929,81531,239,3538,1497,57531,3481,64067,1728,121598,California
Tulare,2021-03-31,4038,186549,2373,99815,1547,83078,118,3656,1552,56725,2476,66543,1670,123268,California
Tulare,2021-04-01,4586,191135,2488,102303,2028,85106,70,3726,1564,55349,3009,69552,1633,124901,California
Tulare,2021-04-02,5436,196571,3089,105392,2217,87323,130,3856,1564,53188,3855,73407,1694,126595,California
Tulare,2021-04-03,3659,200230,2109,107501,1173,88496,377,4233,832,51609,2787,76194,1208,127803,California
Tulare,2021-04-04,1636,201866,1148,108649,480,88976,8,4241,351,50687,1281,77475,359,128162,California
Tulare,2021-04-05,3388,205254,2362,111011,754,89730,272,4513,857,49299,2517,79992,1129,129291,California
Tulare,2021-04-06,3499,208753,1496,112507,1500,91230,503,5016,903,48120,2587,82579,1408,130699,California
Tulare,2021-04-07,3981,212734,1866,114373,1672,92902,443,5459,1185,46953,2786,85365,1619,132318,California
Tulare,2021-04-08,4880,217614,2650,117023,1769,94671,461,5920,1546,45637,3320,88685,2004,134322,California
Tulare,2021-04-09,4914,222528,3028,120051,1439,96110,447,6367,1838,44853,3067,91752,2283,136605,California
Tulare,2021-04-10,3893,226421,2101,122152,1469,97579,323,6690,946,43180,2936,94688,1263,137868,California
Tulare,2021-04-11,1601,228022,1060,123212,464,98043,77,6767,489,42639,1107,95795,566,138434,California
Tulare,2021-04-12,3460,231482,2150,125362,704,98747,606,7373,1069,41934,2380,98175,1675,140109,California
Tulare,2021-04-13,2461,233943,1613,126975,838,99585,10,7383,899,41299,1546,99721,911,141020,California
Tulare,2021-04-14,2912,236855,1714,128689,1197,100782,1,7384,904,40204,2000,101721,905,141925,California
Tulare,2021-04-15,3386,240241,2193,130882,1193,101975,0,7384,1477,39788,1893,103614,1477,143402,California
Tulare,2021-04-16,3743,243984,2259,133141,1484,103459,0,7384,1485,39032,2241,105855,1485,144887,California
Tulare,2021-04-17,2271,246255,1337,134478,934,104393,0,7384,1180,39128,1085,106940,1181,146068,California
Tulare,2021-04-18,1589,247844,1249,135727,340,104733,0,7384,827,39194,761,107701,827,146895,California
Tulare,2021-04-19,2194,250038,1272,136999,921,105654,1,7385,888,38784,1299,109000,889,147784,California
Tulare,2021-04-20,2466,252504,1405,138404,1061,106715,0,7385,1001,38338,1447,110447,1001,148785,California
Tulare,2021-04-21,2343,254847,1446,139850,897,107612,0,7385,839,37722,1456,111903,840,149625,California
Tulare,2021-04-22,2234,257081,1270,141120,964,108576,0,7385,754,37016,1460,113363,754,150379,California
Tulare,2021-04-23,2716,259797,1673,142793,1042,109618,1,7386,1060,36436,1641,115004,1061,151440,California
Tulare,2021-04-24,1691,261488,1077,143870,612,110230,2,7388,873,36498,813,115817,875,152315,California
Tulare,2021-04-25,726,262214,549,144419,177,110407,0,7388,277,36327,448,116265,277,152592,California
Tulare,2021-04-26,1583,263797,960,145379,603,111010,20,7408,663,36095,913,117178,681,153273,California
Tulare,2021-04-27,1733,265530,715,146094,978,111988,40,7448,731,35869,996,118174,770,154043,California
Tulare,2021-04-28,1780,267310,1021,147115,717,112705,42,7490,708,35551,1067,119241,749,154792,California
Tulare,2021-04-29,2095,269405,1266,148381,788,113493,41,7531,815,35138,1267,120508,854,155646,California
Tulare,2021-04-30,2512,271917,1822,150203,638,114131,52,7583,920,34529,1578,122086,969,156615,California
Tulare,2021-05-01,1458,273375,1254,151457,192,114323,12,7595,744,34582,703,122789,756,157371,California
Tulare,2021-05-02,598,273973,511,151968,70,114393,17,7612,190,34383,405,123194,206,157577,California
Tulare,2021-05-03,1644,275617,1114,153082,404,114797,126,7738,349,33569,1288,124482,474,158051,California
Tulare,2021-05-04,1629,277246,877,153959,681,115478,71,7809,642,33303,977,125459,711,158762,California
Tulare,2021-05-05,1347,278593,667,154626,588,116066,92,7901,462,32985,872,126331,554,159316,California
Tulare,2021-05-06,2047,280640,1386,156012,613,116679,48,7949,613,32222,1424,127755,661,159977,California
Tulare,2021-05-07,1890,282530,1287,157299,533,117212,70,8019,532,31473,1349,129104,600,160577,California
Tulare,2021-05-08,1273,283803,835,158134,413,117625,25,8044,549,31332,715,129819,574,161151,California
Tulare,2021-05-09,618,284421,491,158625,106,117731,21,8065,119,30979,494,130313,141,161292,California
Tulare,2021-05-10,1051,285472,610,159235,375,118106,66,8131,313,30627,731,131044,379,161671,California
Tulare,2021-05-11,1337,286809,707,159942,546,118652,84,8215,554,30491,774,131818,638,162309,California
Tulare,2021-05-12,1630,288439,1055,160997,518,119170,57,8272,446,29827,1166,132984,502,162811,California
Tulare,2021-05-13,1623,290062,1043,162040,540,119710,40,8312,739,29727,878,133862,778,163589,California
Tulare,2021-05-14,2023,292085,1316,163356,643,120353,64,8376,920,29621,1088,134950,982,164571,California
Tulare,2021-05-15,1613,293698,915,164271,651,121004,47,8423,686,29430,918,135868,727,165298,California
Tulare,2021-05-16,704,294402,564,164835,128,121132,12,8435,327,29394,375,136243,339,165637,California
Tulare,2021-05-17,1601,296003,1003,165838,521,121653,77,8512,759,29400,829,137072,835,166472,California
Tulare,2021-05-18,1604,297607,867,166705,683,122336,54,8566,796,29446,802,137874,848,167320,California
Tulare,2021-05-19,1495,299102,965,167670,496,122832,34,8600,766,29524,722,138596,800,168120,California
Tulare,2021-05-20,1631,300733,1107,168777,435,123267,89,8689,771,29530,854,139450,860,168980,California
Tulare,2021-05-21,1984,302717,1451,170228,490,123757,43,8732,1073,29742,903,140353,1115,170095,California
Tulare,2021-05-22,1652,304369,1176,171404,452,124209,24,8756,619,29362,1024,141377,644,170739,California
Tulare,2021-05-23,415,304784,329,171733,77,124286,9,8765,209,29376,205,141582,219,170958,California
Tulare,2021-05-24,949,305733,586,172319,301,124587,62,8827,426,29344,520,142102,488,171446,California
Tulare,2021-05-25,1208,306941,721,173040,455,125042,32,8859,518,29210,684,142786,550,171996,California
Tulare,2021-05-26,897,307838,495,173535,361,125403,41,8900,392,29144,498,143284,432,172428,California
Tulare,2021-05-27,1296,309134,821,174356,443,125846,32,8932,586,29061,703,143987,620,173048,California
Tulare,2021-05-28,1210,310344,670,175026,490,126336,50,8982,633,29173,570,144557,682,173730,California
Tulare,2021-05-29,889,311233,659,175685,210,126546,20,9002,507,29319,380,144937,526,174256,California
Tulare,2021-05-30,291,311524,209,175894,74,126620,8,9010,164,29365,126,145063,172,174428,California
Tulare,2021-05-31,133,311657,51,175945,71,126691,11,9021,54,29353,77,145140,65,174493,California
Tulare,2021-06-01,1077,312734,640,176585,406,127097,31,9052,394,29104,673,145813,424,174917,California
Tulare,2021-06-02,812,313546,477,177062,302,127399,33,9085,355,29043,446,146259,385,175302,California
Tulare,2021-06-03,1166,314712,828,177890,280,127679,58,9143,403,28760,743,147002,460,175762,California
Tulare,2021-06-04,1198,315910,858,178748,308,127987,32,9175,363,28326,829,147831,395,176157,California
Tulare,2021-06-05,898,316808,711,179459,172,128159,15,9190,293,28032,602,148433,308,176465,California
Tulare,2021-06-06,427,317235,361,179820,46,128205,20,9210,140,27905,286,148719,159,176624,California
Tulare,2021-06-07,902,318137,705,180525,158,128363,39,9249,281,27607,616,149335,318,176942,California
Tulare,2021-06-08,1066,319203,785,181310,218,128581,63,9312,361,27331,700,150035,424,177366,California
Tulare,2021-06-09,1103,320306,770,182080,296,128877,37,9349,346,26960,752,150787,381,177747,California
Tulare,2021-06-10,1119,321425,899,182979,183,129060,37,9386,383,26645,734,151521,419,178166,California
Tulare,2021-06-11,1248,322673,888,183867,325,129385,35,9421,378,26198,860,152381,413,178579,California
Tulare,2021-06-12,1011,323684,794,184661,206,129591,11,9432,365,25935,639,153020,376,178955,California
Tulare,2021-06-13,316,324000,227,184888,85,129676,4,9436,92,25808,223,153243,96,179051,California
Tulare,2021-06-14,789,324789,580,185468,181,129857,28,9464,303,25659,480,153723,331,179382,California
Tulare,2021-06-15,1018,325807,688,186156,300,130157,30,9494,453,25585,557,154280,483,179865,California
Tulare,2021-06-16,875,326682,595,186751,230,130387,50,9544,389,25542,484,154764,441,180306,California
Tulare,2021-06-17,1041,327723,765,187516,246,130633,30,9574,424,25381,614,155378,453,180759,California
Tulare,2021-06-18,987,328710,696,188212,254,130887,37,9611,368,25168,617,155995,404,181163,California
Tulare,2021-06-19,848,329558,676,188888,158,131045,14,9625,387,25112,457,156452,401,181564,California
Tulare,2021-06-20,249,329807,186,189074,55,131100,8,9633,74,25022,173,156625,83,181647,California
Tulare,2021-06-21,528,330335,344,189418,151,131251,33,9666,307,25141,220,156845,339,181986,California
Tulare,2021-06-22,760,331095,521,189939,215,131466,24,9690,348,25109,404,157249,372,182358,California
Tulare,2021-06-23,735,331830,497,190436,212,131678,26,9716,401,25208,328,157577,427,182785,California
Tulare,2021-06-24,847,332677,639,191075,154,131832,54,9770,420,25259,424,158001,475,183260,California
Tulare,2021-06-25,856,333533,558,191633,278,132110,20,9790,444,25318,405,158406,464,183724,California
Tulare,2021-06-26,939,334472,740,192373,173,132283,26,9816,539,25486,397,158803,565,184289,California
Tulare,2021-06-27,254,334726,186,192559,61,132344,7,9823,118,25477,134,158937,125,184414,California
Tulare,2021-06-28,588,335314,444,193003,115,132459,29,9852,298,25517,288,159225,328,184742,California
Tulare,2021-06-29,737,336051,468,193471,227,132686,42,9894,344,25517,386,159611,386,185128,California
Tulare,2021-06-30,714,336765,484,193955,196,132882,34,9928,391,25622,317,159928,422,185550,California
Tulare,2021-07-01,833,337598,625,194580,174,133056,34,9962,387,25603,439,160367,420,185970,California
Tulare,2021-07-02,737,338335,520,195100,200,133256,17,9979,388,25667,342,160709,406,186376,California
Tulare,2021-07-03,464,338799,336,195436,119,133375,9,9988,226,25669,233,160942,235,186611,California
Tulare,2021-07-04,30,338829,19,195455,10,133385,1,9989,16,25672,14,160956,17,186628,California
Tulare,2021-07-05,409,339238,295,195750,102,133487,12,10001,208,25696,196,161152,220,186848,California
Tulare,2021-07-06,776,340014,560,196310,192,133679,24,10025,331,25609,441,161593,354,187202,California
Tulare,2021-07-07,701,340715,481,196791,183,133862,37,10062,321,25594,372,161965,357,187559,California
Tulare,2021-07-08,715,341430,529,197320,154,134016,32,10094,335,25584,377,162342,367,187926,California
Tulare,2021-07-09,927,342357,717,198037,187,134203,23,10117,481,25645,442,162784,503,188429,California
Tulare,2021-07-10,501,342858,384,198421,103,134306,14,10131,251,25662,248,163032,265,188694,California
Tulare,2021-07-11,213,343071,156,198577,55,134361,2,10133,111,25673,102,163134,113,188807,California
Tulare,2021-07-12,535,343606,403,198980,113,134474,19,10152,266,25693,265,163399,285,189092,California
Tulare,2021-07-13,642,344248,439,199419,181,134655,22,10174,289,25656,348,163747,311,189403,California
Tulare,2021-07-14,707,344955,487,199906,195,134850,25,10199,336,25650,367,164114,361,189764,California
Tulare,2021-07-15,880,345835,657,200563,204,135054,19,10218,407,25608,469,164583,427,190191,California
Tulare,2021-07-16,915,346750,671,201234,219,135273,25,10243,482,25686,429,165012,507,190698,California
Tulare,2021-07-17,705,347455,576,201810,118,135391,11,10254,309,25615,392,165404,321,191019,California
Tulare,2021-07-18,171,347626,131,201941,38,135429,2,10256,94,25636,75,165479,96,191115,California
Tulare,2021-07-19,673,348299,531,202472,134,135563,8,10264,372,25721,295,165774,380,191495,California
Tulare,2021-07-20,819,349118,585,203057,204,135767,30,10294,430,25794,386,166160,459,191954,California
Tulare,2021-07-21,784,349902,550,203607,214,135981,20,10314,406,25846,374,166534,426,192380,California
Tulare,2021-07-22,874,350776,651,204258,208,136189,15,10329,492,25975,377,166911,506,192886,California
Tulare,2021-07-23,1097,351873,767,205025,296,136485,34,10363,616,26148,474,167385,647,193533,California
Tulare,2021-07-24,545,352418,392,205417,135,136620,18,10381,334,26291,209,167594,352,193885,California
Tulare,2021-07-25,257,352675,193,205610,64,136684,0,10381,196,26426,61,167655,196,194081,California
Tulare,2021-07-26,654,353329,425,206035,219,136903,10,10391,417,26619,234,167889,427,194508,California
Tulare,2021-07-27,848,354177,563,206598,255,137158,30,10421,514,26834,329,168218,544,195052,California
Tulare,2021-07-28,873,355050,591,207189,253,137411,29,10450,555,27107,311,168529,584,195636,California
Tulare,2021-07-29,1073,356123,789,207978,265,137676,19,10469,732,27524,334,168863,751,196387,California
Tulare,2021-07-30,1327,357450,944,208922,341,138017,42,10511,798,27842,520,169383,838,197225,California
Tulare,2021-07-31,616,358066,445,209367,159,138176,12,10523,389,28020,223,169606,401,197626,California
Tulare,2021-08-01,275,358341,188,209555,86,138262,1,10524,199,28146,74,169680,200,197826,California
Tulare,2021-08-02,835,359176,579,210134,237,138499,19,10543,578,28490,253,169933,597,198423,California
Tulare,2021-08-03,1043,360219,718,210852,279,138778,46,10589,707,28910,332,170265,752,199175,California
Tulare,2021-08-04,917,361136,622,211474,265,139043,30,10619,585,29205,319,170584,614,199789,California
Tulare,2021-08-05,1138,362274,852,212326,265,139308,21,10640,778,29652,352,170936,799,200588,California
Tulare,2021-08-06,1451,363725,1051,213377,361,139669,39,10679,983,30216,458,171394,1022,201610,California
Tulare,2021-08-07,889,364614,663,214040,217,139886,9,10688,594,30530,289,171683,603,202213,California
Tulare,2021-08-08,440,365054,326,214366,112,139998,2,10690,314,30722,124,171807,316,202529,California
Tulare,2021-08-09,1006,366060,765,215131,217,140215,24,10714,652,31055,343,172150,676,203205,California
Tulare,2021-08-10,1002,367062,722,215853,258,140473,22,10736,624,31328,372,172522,645,203850,California
Tulare,2021-08-11,826,367888,551,216404,245,140718,30,10766,509,31557,310,172832,539,204389,California
Tulare,2021-08-12,1098,368986,753,217157,309,141027,36,10802,672,31847,416,173248,706,205095,California
Tulare,2021-08-13,1299,370285,841,217998,432,141459,26,10828,786,32155,504,173752,812,205907,California
Tulare,2021-08-14,1169,371454,896,218894,263,141722,10,10838,729,32482,412,174164,739,206646,California
Tulare,2021-08-15,420,371874,297,219191,122,141844,1,10839,239,32562,160,174324,240,206886,California
Tulare,2021-08-16,940,372814,597,219788,320,142164,23,10862,537,32775,347,174671,560,207446,California
Tulare,2021-08-17,1110,373924,685,220473,392,142556,33,10895,609,32964,452,175123,641,208087,California
Tulare,2021-08-18,1110,375034,734,221207,355,142911,21,10916,618,33184,419,175542,639,208726,California
Tulare,2021-08-19,1521,376555,991,222198,492,143403,38,10954,866,33511,576,176118,903,209629,California
Tulare,2021-08-20,1561,378116,1063,223261,450,143853,48,11002,919,33890,585,176703,964,210593,California
Tulare,2021-08-21,1080,379196,805,224066,255,144108,20,11022,650,34157,403,177106,670,211263,California
Tulare,2021-08-22,455,379651,321,224387,128,144236,6,11028,247,34225,185,177291,253,211516,California
Tulare,2021-08-23,1180,380831,877,225264,292,144528,11,11039,637,34366,507,177798,648,212164,California
Tulare,2021-08-24,1243,382074,931,226195,291,144819,21,11060,666,34513,540,178338,687,212851,California
Tulare,2021-08-25,1213,383287,886,227081,285,145104,42,11102,646,34674,527,178865,688,213539,California
Tulare,2021-08-26,1555,384842,1223,228304,295,145399,37,11139,803,34822,692,179557,840,214379,California
Tulare,2021-08-27,1883,386725,1463,229767,397,145796,23,11162,1043,35129,759,180316,1066,215445,California
Tulare,2021-08-28,1057,387782,846,230613,194,145990,17,11179,527,35186,487,180803,544,215989,California
Tulare,2021-08-29,520,388302,385,230998,132,146122,3,11182,239,35171,257,181060,242,216231,California
Tulare,2021-08-30,709,389011,520,231518,163,146285,26,11208,320,35172,345,181405,346,216577,California
Tuolumne,2020-12-16,51,51,51,51,0,0,0,0,51,51,0,0,51,51,California
Tuolumne,2020-12-17,18,69,18,69,0,0,0,0,18,69,0,0,18,69,California
Tuolumne,2020-12-18,102,171,101,170,1,1,0,0,102,171,0,0,102,171,California
Tuolumne,2020-12-19,4,175,4,174,0,1,0,0,4,175,0,0,4,175,California
Tuolumne,2020-12-20,2,177,2,176,0,1,0,0,2,177,0,0,2,177,California
Tuolumne,2020-12-21,116,293,102,278,14,15,0,0,116,293,0,0,116,293,California
Tuolumne,2020-12-22,171,464,171,449,0,15,0,0,171,464,0,0,171,464,California
Tuolumne,2020-12-23,185,649,181,630,4,19,0,0,184,647,1,1,184,648,California
Tuolumne,2020-12-25,1,650,1,631,0,19,0,0,1,648,0,1,1,649,California
Tuolumne,2020-12-26,2,652,2,633,0,19,0,0,2,650,0,1,2,651,California
Tuolumne,2020-12-28,74,726,72,705,2,21,0,0,74,724,0,1,74,725,California
Tuolumne,2020-12-29,102,828,38,743,64,85,0,0,102,826,0,1,102,827,California
Tuolumne,2020-12-30,78,906,22,765,56,141,0,0,78,904,0,1,78,905,California
Tuolumne,2020-12-31,27,933,20,785,7,148,0,0,27,931,0,1,27,932,California
Tuolumne,2021-01-01,6,939,5,790,1,149,0,0,6,937,0,1,6,938,California
Tuolumne,2021-01-02,120,1059,117,907,3,152,0,0,120,1057,0,1,120,1058,California
Tuolumne,2021-01-03,2,1061,2,909,0,152,0,0,2,1059,0,1,2,1060,California
Tuolumne,2021-01-04,71,1132,26,935,45,197,0,0,71,1130,0,1,71,1131,California
Tuolumne,2021-01-05,97,1229,30,965,67,264,0,0,94,1222,3,4,95,1226,California
Tuolumne,2021-01-06,138,1367,74,1039,64,328,0,0,72,1228,66,70,72,1298,California
Tuolumne,2021-01-07,124,1491,65,1104,59,387,0,0,67,1239,56,126,67,1365,California
Tuolumne,2021-01-08,108,1599,83,1187,25,412,0,0,28,1190,79,205,30,1395,California
Tuolumne,2021-01-09,3,1602,0,1187,3,415,0,0,3,1193,0,205,3,1398,California
Tuolumne,2021-01-10,3,1605,1,1188,2,417,0,0,3,1196,0,205,3,1401,California
Tuolumne,2021-01-11,114,1719,88,1276,26,443,0,0,32,1146,82,287,32,1433,California
Tuolumne,2021-01-12,104,1823,87,1363,17,460,0,0,20,1082,84,371,20,1453,California
Tuolumne,2021-01-13,233,2056,126,1489,107,567,0,0,183,1216,50,421,184,1637,California
Tuolumne,2021-01-14,154,2210,112,1601,42,609,0,0,46,1157,105,526,46,1683,California
Tuolumne,2021-01-15,480,2690,75,1676,405,1014,0,0,417,1512,62,588,417,2100,California
Tuolumne,2021-01-16,7,2697,3,1679,4,1018,0,0,6,1517,1,589,6,2106,California
Tuolumne,2021-01-17,7,2704,4,1683,3,1021,0,0,7,1524,0,589,7,2113,California
Tuolumne,2021-01-18,47,2751,38,1721,9,1030,0,0,10,1498,36,625,10,2123,California
Tuolumne,2021-01-19,488,3239,76,1797,412,1442,0,0,441,1893,46,671,441,2564,California
Tuolumne,2021-01-20,77,3316,59,1856,18,1460,0,0,25,1867,51,722,25,2589,California
Tuolumne,2021-01-21,59,3375,25,1881,34,1494,0,0,42,1893,16,738,42,2631,California
Tuolumne,2021-01-22,176,3551,18,1899,158,1652,0,0,167,2051,9,747,167,2798,California
Tuolumne,2021-01-23,657,4208,131,2030,526,2178,0,0,544,2500,113,860,562,3360,California
Tuolumne,2021-01-24,527,4735,4,2034,523,2701,0,0,517,3014,10,870,524,3884,California
Tuolumne,2021-01-25,51,4786,28,2062,23,2724,0,0,25,3014,26,896,26,3910,California
Tuolumne,2021-01-26,82,4868,70,2132,12,2736,0,0,40,3012,42,938,40,3950,California
Tuolumne,2021-01-27,65,4933,8,2140,57,2793,0,0,9,2966,55,993,9,3959,California
Tuolumne,2021-01-28,26,4959,6,2146,20,2813,0,0,18,2976,8,1001,18,3977,California
Tuolumne,2021-01-29,78,5037,5,2151,73,2886,0,0,37,2974,41,1042,39,4016,California
Tuolumne,2021-01-30,723,5760,560,2711,163,3049,0,0,699,3668,24,1066,718,4734,California
Tuolumne,2021-01-31,9,5769,2,2713,7,3056,0,0,6,3671,3,1069,6,4740,California
Tuolumne,2021-02-01,32,5801,7,2720,25,3081,0,0,27,3693,5,1074,27,4767,California
Tuolumne,2021-02-02,666,6467,53,2773,613,3694,0,0,649,4330,14,1088,651,5418,California
Tuolumne,2021-02-03,257,6724,115,2888,142,3836,0,0,96,4265,161,1249,96,5514,California
Tuolumne,2021-02-04,127,6851,14,2902,113,3949,0,0,62,4263,64,1313,62,5576,California
Tuolumne,2021-02-05,107,6958,15,2917,92,4041,0,0,38,4233,68,1381,38,5614,California
Tuolumne,2021-02-06,870,7828,590,3507,280,4321,0,0,859,5087,11,1392,865,6479,California
Tuolumne,2021-02-07,8,7836,4,3511,4,4325,0,0,4,5087,4,1396,4,6483,California
Tuolumne,2021-02-08,99,7935,44,3555,55,4380,0,0,73,5134,26,1422,73,6556,California
Tuolumne,2021-02-09,868,8803,53,3608,815,5195,0,0,822,5911,45,1467,822,7378,California
Tuolumne,2021-02-10,103,8906,21,3629,82,5277,0,0,36,5882,65,1532,36,7414,California
Tuolumne,2021-02-11,152,9058,70,3699,82,5359,0,0,86,5902,66,1598,86,7500,California
Tuolumne,2021-02-12,664,9722,25,3724,639,5998,0,0,218,5676,444,2042,218,7718,California
Tuolumne,2021-02-13,155,9877,43,3767,112,6110,0,0,123,5767,32,2074,123,7841,California
Tuolumne,2021-02-14,153,10030,14,3781,139,6249,0,0,151,5916,2,2076,151,7992,California
Tuolumne,2021-02-15,192,10222,12,3793,180,6429,0,0,182,6088,10,2086,182,8174,California
Tuolumne,2021-02-16,538,10760,20,3813,518,6947,0,0,123,5805,408,2494,125,8299,California
Tuolumne,2021-02-17,114,10874,64,3877,50,6997,0,0,64,5821,48,2542,64,8363,California
Tuolumne,2021-02-18,693,11567,33,3910,660,7657,0,0,637,6403,56,2598,638,9001,California
Tuolumne,2021-02-19,149,11716,24,3934,125,7782,0,0,45,6345,103,2701,45,9046,California
Tuolumne,2021-02-20,917,12633,346,4280,571,8353,0,0,384,6223,513,3214,391,9437,California
Tuolumne,2021-02-21,999,13632,44,4324,955,9308,0,0,479,6199,510,3724,486,9923,California
Tuolumne,2021-02-22,83,13715,60,4384,23,9331,0,0,47,6212,34,3758,47,9970,California
Tuolumne,2021-02-23,51,13766,27,4411,24,9355,0,0,24,6210,26,3784,24,9994,California
Tuolumne,2021-02-24,107,13873,58,4469,49,9404,0,0,42,6189,64,3848,43,10037,California
Tuolumne,2021-02-25,1058,14931,34,4503,1024,10428,0,0,1019,7171,38,3886,1020,11057,California
Tuolumne,2021-02-26,162,15093,12,4515,150,10578,0,0,128,7270,30,3916,129,11186,California
Tuolumne,2021-02-27,972,16065,585,5100,387,10965,0,0,253,6829,699,4615,258,11444,California
Tuolumne,2021-02-28,55,16120,5,5105,50,11015,0,0,51,6877,3,4618,51,11495,California
Tuolumne,2021-03-01,123,16243,22,5127,100,11115,1,1,79,6915,43,4661,81,11576,California
Tuolumne,2021-03-02,719,16962,80,5207,639,11754,0,1,111,6424,602,5263,111,11687,California
Tuolumne,2021-03-03,103,17065,22,5229,81,11835,0,1,68,6458,34,5297,68,11755,California
Tuolumne,2021-03-04,1182,18247,77,5306,1105,12940,0,1,1113,7505,67,5364,1114,12869,California
Tuolumne,2021-03-05,98,18345,13,5319,85,13025,0,1,56,7521,41,5405,57,12926,California
Tuolumne,2021-03-06,1069,19414,608,5927,459,13484,2,3,203,6875,856,6261,210,13136,California
Tuolumne,2021-03-07,43,19457,14,5941,15,13499,14,17,20,6886,23,6284,34,13170,California
Tuolumne,2021-03-08,204,19661,92,6033,105,13604,7,24,145,6979,59,6343,152,13322,California
Tuolumne,2021-03-09,879,20540,18,6051,850,14454,11,35,67,6253,804,7147,78,13400,California
Tuolumne,2021-03-10,105,20645,20,6071,74,14528,11,46,55,6270,49,7196,66,13466,California
Tuolumne,2021-03-11,1310,21955,46,6117,1259,15787,5,51,1253,7473,57,7253,1260,14726,California
Tuolumne,2021-03-12,319,22274,45,6162,259,16046,15,66,183,7542,133,7386,202,14928,California
Tuolumne,2021-03-13,124,22398,14,6176,110,16156,0,66,77,7574,46,7432,78,15006,California
Tuolumne,2021-03-14,151,22549,10,6186,132,16288,9,75,7,7451,144,7576,21,15027,California
Tuolumne,2021-03-15,310,22859,85,6271,222,16510,3,78,108,7369,201,7777,119,15146,California
Tuolumne,2021-03-16,826,23685,47,6318,768,17278,11,89,685,7929,139,7916,699,15845,California
Tuolumne,2021-03-17,162,23847,36,6354,113,17391,13,102,81,7943,80,7996,94,15939,California
Tuolumne,2021-03-18,955,24802,28,6382,913,18304,14,116,318,7645,630,8626,332,16271,California
Tuolumne,2021-03-19,140,24942,21,6403,89,18393,30,146,78,7692,61,8687,108,16379,California
Tuolumne,2021-03-20,93,25035,8,6411,75,18468,10,156,38,7685,54,8741,47,16426,California
Tuolumne,2021-03-21,846,25881,395,6806,440,18908,11,167,37,6946,788,9529,49,16475,California
Tuolumne,2021-03-22,162,26043,72,6878,71,18979,19,186,93,6990,68,9597,112,16587,California
Tuolumne,2021-03-23,720,26763,639,7517,67,19046,14,200,680,7646,37,9634,693,17280,California
Tuolumne,2021-03-24,109,26872,20,7537,71,19117,18,218,76,7708,32,9666,94,17374,California
Tuolumne,2021-03-25,1302,28174,25,7562,1274,20391,3,221,322,7062,972,10638,326,17700,California
Tuolumne,2021-03-26,285,28459,19,7581,242,20633,24,245,116,7046,157,10795,141,17841,California
Tuolumne,2021-03-27,589,29048,56,7637,533,21166,0,245,312,7092,271,11066,317,18158,California
Tuolumne,2021-03-28,46,29094,5,7642,41,21207,0,245,8,7064,37,11103,9,18167,California
Tuolumne,2021-03-29,214,29308,90,7732,124,21331,0,245,112,7078,99,11202,113,18280,California
Tuolumne,2021-03-30,169,29477,11,7743,157,21488,1,246,120,7153,46,11248,121,18401,California
Tuolumne,2021-03-31,96,29573,13,7756,81,21569,2,248,39,7139,55,11303,41,18442,California
Tuolumne,2021-04-01,1267,30840,31,7787,1236,22805,0,248,233,6342,1030,12333,233,18675,California
Tuolumne,2021-04-02,171,31011,10,7797,135,22940,26,274,90,6380,78,12411,116,18791,California
Tuolumne,2021-04-03,435,31446,35,7832,399,23339,1,275,237,6424,195,12606,239,19030,California
Tuolumne,2021-04-04,36,31482,6,7838,30,23369,0,275,17,6425,16,12622,17,19047,California
Tuolumne,2021-04-05,138,31620,20,7858,109,23478,9,284,58,6413,80,12702,68,19115,California
Tuolumne,2021-04-06,665,32285,525,8383,113,23591,27,311,515,6808,149,12851,544,19659,California
Tuolumne,2021-04-07,138,32423,42,8425,79,23670,17,328,57,6801,81,12932,74,19733,California
Tuolumne,2021-04-08,1466,33889,43,8468,1407,25077,16,344,255,5868,1204,14136,271,20004,California
Tuolumne,2021-04-09,278,34167,46,8514,187,25264,45,389,129,5896,148,14284,176,20180,California
Tuolumne,2021-04-10,50,34217,1,8515,29,25293,20,409,18,5902,32,14316,38,20218,California
Tuolumne,2021-04-11,23,34240,6,8521,14,25307,3,412,14,5914,7,14323,19,20237,California
Tuolumne,2021-04-12,169,34409,65,8586,99,25406,5,417,81,5917,83,14406,86,20323,California
Tuolumne,2021-04-13,796,35205,36,8622,760,26166,0,417,170,5469,618,15024,170,20493,California
Tuolumne,2021-04-14,164,35369,32,8654,132,26298,0,417,81,5473,78,15102,82,20575,California
Tuolumne,2021-04-15,365,35734,23,8677,342,26640,0,417,65,5246,293,15395,66,20641,California
Tuolumne,2021-04-16,265,35999,58,8735,207,26847,0,417,142,5278,111,15506,143,20784,California
Tuolumne,2021-04-17,44,36043,6,8741,38,26885,0,417,27,5288,17,15523,27,20811,California
Tuolumne,2021-04-18,10,36053,3,8744,7,26892,0,417,5,5289,5,15528,6,20817,California
Tuolumne,2021-04-19,182,36235,83,8827,99,26991,0,417,95,5299,85,15613,95,20912,California
Tuolumne,2021-04-20,714,36949,614,9441,100,27091,0,417,74,4741,632,16245,74,20986,California
Tuolumne,2021-04-21,128,37077,29,9470,99,27190,0,417,68,4755,54,16299,68,21054,California
Tuolumne,2021-04-22,717,37794,49,9519,668,27858,0,417,433,4918,271,16570,434,21488,California
Tuolumne,2021-04-23,177,37971,30,9549,147,28005,0,417,83,4914,88,16658,84,21572,California
Tuolumne,2021-04-24,76,38047,17,9566,59,28064,0,417,47,4933,28,16686,47,21619,California
Tuolumne,2021-04-25,26,38073,9,9575,17,28081,0,417,23,4953,3,16689,23,21642,California
Tuolumne,2021-04-26,161,38234,58,9633,103,28184,0,417,75,4946,83,16772,76,21718,California
Tuolumne,2021-04-27,146,38380,23,9656,116,28300,7,424,66,4943,76,16848,73,21791,California
Tuolumne,2021-04-28,121,38501,28,9684,81,28381,12,436,61,4958,58,16906,73,21864,California
Tuolumne,2021-04-29,294,38795,28,9712,258,28639,8,444,59,4797,228,17134,67,21931,California
Tuolumne,2021-04-30,374,39169,27,9739,335,28974,12,456,73,4588,294,17428,85,22016,California
Tuolumne,2021-05-01,25,39194,6,9745,14,28988,5,461,17,4602,8,17436,22,22038,California
Tuolumne,2021-05-02,27,39221,3,9748,22,29010,2,463,20,4617,7,17443,22,22060,California
Tuolumne,2021-05-03,113,39334,15,9763,93,29103,5,468,40,4591,71,17514,45,22105,California
Tuolumne,2021-05-04,713,40047,599,10362,110,29213,4,472,218,4319,493,18007,221,22326,California
Tuolumne,2021-05-05,113,40160,27,10389,80,29293,6,478,58,4332,51,18058,64,22390,California
Tuolumne,2021-05-06,293,40453,15,10404,262,29555,16,494,46,4153,240,18298,61,22451,California
Tuolumne,2021-05-07,330,40783,26,10430,296,29851,8,502,62,3959,264,18562,70,22521,California
Tuolumne,2021-05-08,47,40830,6,10436,37,29888,4,506,31,3979,15,18577,35,22556,California
Tuolumne,2021-05-09,19,40849,2,10438,15,29903,2,508,3,3968,16,18593,5,22561,California
Tuolumne,2021-05-10,116,40965,46,10484,63,29966,7,515,34,3928,81,18674,41,22602,California
Tuolumne,2021-05-11,209,41174,64,10548,133,30099,12,527,59,3851,148,18822,71,22673,California
Tuolumne,2021-05-12,138,41312,26,10574,109,30208,3,530,54,3824,84,18906,57,22730,California
Tuolumne,2021-05-13,121,41433,20,10594,93,30301,8,538,72,3855,48,18954,79,22809,California
Tuolumne,2021-05-14,202,41635,73,10667,119,30420,10,548,102,3869,98,19052,112,22921,California
Tuolumne,2021-05-15,59,41694,15,10682,38,30458,6,554,22,3862,36,19088,29,22950,California
Tuolumne,2021-05-16,28,41722,8,10690,18,30476,2,556,13,3863,14,19102,15,22965,California
Tuolumne,2021-05-17,112,41834,32,10722,77,30553,3,559,46,3848,65,19167,50,23015,California
Tuolumne,2021-05-18,185,42019,55,10777,83,30636,47,606,62,3837,120,19287,109,23124,California
Tuolumne,2021-05-19,120,42139,21,10798,66,30702,33,639,46,3842,74,19361,79,23203,California
Tuolumne,2021-05-20,412,42551,21,10819,383,31085,8,647,50,3541,359,19720,58,23261,California
Tuolumne,2021-05-21,210,42761,94,10913,109,31194,7,654,117,3575,90,19810,124,23385,California
Tuolumne,2021-05-22,58,42819,19,10932,33,31227,6,660,25,3573,32,19842,30,23415,California
Tuolumne,2021-05-23,27,42846,7,10939,19,31246,1,661,10,3567,17,19859,11,23426,California
Tuolumne,2021-05-24,137,42983,43,10982,88,31334,6,667,52,3541,84,19943,58,23484,California
Tuolumne,2021-05-25,300,43283,221,11203,73,31407,6,673,111,3472,186,20129,117,23601,California
Tuolumne,2021-05-26,86,43369,23,11226,61,31468,2,675,35,3458,51,20180,37,23638,California
Tuolumne,2021-05-27,77,43446,15,11241,58,31526,4,679,29,3444,47,20227,33,23671,California
Tuolumne,2021-05-28,115,43561,51,11292,63,31589,1,680,65,3464,46,20273,66,23737,California
Tuolumne,2021-05-29,39,43600,7,11299,26,31615,6,686,17,3466,21,20294,23,23760,California
Tuolumne,2021-05-30,18,43618,1,11300,14,31629,3,689,4,3459,14,20308,7,23767,California
Tuolumne,2021-05-31,9,43627,1,11301,7,31636,1,690,1,3453,8,20316,2,23769,California
Tuolumne,2021-06-01,81,43708,22,11323,55,31691,4,694,24,3425,56,20372,28,23797,California
Tuolumne,2021-06-02,76,43784,8,11331,59,31750,9,703,22,3403,53,20425,31,23828,California
Tuolumne,2021-06-03,78,43862,25,11356,38,31788,15,718,24,3391,52,20477,40,23868,California
Tuolumne,2021-06-04,133,43995,59,11415,71,31859,3,721,38,3341,91,20568,41,23909,California
Tuolumne,2021-06-05,43,44038,12,11427,29,31888,2,723,16,3332,27,20595,18,23927,California
Tuolumne,2021-06-06,20,44058,6,11433,7,31895,7,730,4,3327,16,20611,11,23938,California
Tuolumne,2021-06-07,62,44120,14,11447,40,31935,8,738,27,3327,35,20646,35,23973,California
Tuolumne,2021-06-08,77,44197,24,11471,52,31987,1,739,28,3309,47,20693,29,24002,California
Tuolumne,2021-06-09,89,44286,44,11515,35,32022,10,749,41,3313,47,20740,51,24053,California
Tuolumne,2021-06-10,99,44385,16,11531,76,32098,7,756,27,3275,72,20812,34,24087,California
Tuolumne,2021-06-11,103,44488,47,11578,53,32151,3,759,25,3229,74,20886,28,24115,California
Tuolumne,2021-06-12,61,44549,19,11597,26,32177,16,775,18,3222,41,20927,34,24149,California
Tuolumne,2021-06-13,17,44566,2,11599,11,32188,4,779,4,3217,13,20940,8,24157,California
Tuolumne,2021-06-14,101,44667,33,11632,64,32252,4,783,52,3224,49,20989,56,24213,California
Tuolumne,2021-06-15,129,44796,81,11713,39,32291,9,792,20,3145,108,21097,29,24242,California
Tuolumne,2021-06-16,96,44892,47,11760,46,32337,3,795,54,3162,41,21138,58,24300,California
Tuolumne,2021-06-17,46,44938,10,11770,35,32372,1,796,18,3153,28,21166,19,24319,California
Tuolumne,2021-06-18,172,45110,93,11863,65,32437,14,810,62,3120,108,21274,75,24394,California
Tuolumne,2021-06-19,25,45135,9,11872,13,32450,3,813,10,3118,15,21289,13,24407,California
Tuolumne,2021-06-20,12,45147,2,11874,10,32460,0,813,8,3122,4,21293,8,24415,California
Tuolumne,2021-06-21,40,45187,3,11877,36,32496,1,814,21,3125,19,21312,22,24437,California
Tuolumne,2021-06-22,43,45230,10,11887,33,32529,0,814,20,3122,23,21335,20,24457,California
Tuolumne,2021-06-23,72,45302,13,11900,39,32568,20,834,34,3138,38,21373,54,24511,California
Tuolumne,2021-06-24,57,45359,24,11924,27,32595,6,840,26,3141,30,21403,33,24544,California
Tuolumne,2021-06-25,57,45416,31,11955,21,32616,5,845,30,3148,27,21430,34,24578,California
Tuolumne,2021-06-26,29,45445,9,11964,20,32636,0,845,15,3149,14,21444,15,24593,California
Tuolumne,2021-06-27,9,45454,2,11966,7,32643,0,845,7,3155,1,21445,7,24600,California
Tuolumne,2021-06-28,47,45501,25,11991,17,32660,5,850,33,3179,14,21459,38,24638,California
Tuolumne,2021-06-29,49,45550,20,12011,27,32687,2,852,28,3188,21,21480,30,24668,California
Tuolumne,2021-06-30,85,45635,35,12046,49,32736,1,853,23,3153,59,21539,24,24692,California
Tuolumne,2021-07-01,48,45683,21,12067,20,32756,7,860,29,3170,19,21558,36,24728,California
Tuolumne,2021-07-02,71,45754,30,12097,35,32791,6,866,47,3199,24,21582,53,24781,California
Tuolumne,2021-07-03,23,45777,8,12105,15,32806,0,866,8,3192,15,21597,8,24789,California
Tuolumne,2021-07-04,4,45781,1,12106,3,32809,0,866,2,3192,2,21599,2,24791,California
Tuolumne,2021-07-05,20,45801,4,12110,16,32825,0,866,9,3190,11,21610,9,24800,California
Tuolumne,2021-07-06,73,45874,26,12136,44,32869,3,869,36,3193,34,21644,37,24837,California
Tuolumne,2021-07-07,80,45954,35,12171,37,32906,8,877,35,3191,44,21688,42,24879,California
Tuolumne,2021-07-08,38,45992,14,12185,22,32928,2,879,23,3202,14,21702,25,24904,California
Tuolumne,2021-07-09,54,46046,17,12202,35,32963,2,881,27,3205,26,21728,29,24933,California
Tuolumne,2021-07-10,16,46062,4,12206,12,32975,0,881,6,3201,10,21738,6,24939,California
Tuolumne,2021-07-11,4,46066,1,12207,3,32978,0,881,3,3203,1,21739,3,24942,California
Tuolumne,2021-07-12,52,46118,12,12219,40,33018,0,881,16,3183,36,21775,16,24958,California
Tuolumne,2021-07-13,36,46154,11,12230,24,33042,1,882,22,3194,12,21787,23,24981,California
Tuolumne,2021-07-14,48,46202,15,12245,32,33074,1,883,24,3198,22,21809,26,25007,California
Tuolumne,2021-07-15,28,46230,9,12254,14,33088,5,888,12,3200,15,21824,17,25024,California
Tuolumne,2021-07-16,145,46375,97,12351,36,33124,12,900,72,3213,70,21894,83,25107,California
Tuolumne,2021-07-17,32,46407,3,12354,29,33153,0,900,22,3225,10,21904,22,25129,California
Tuolumne,2021-07-18,8,46415,6,12360,2,33155,0,900,4,3225,4,21908,4,25133,California
Tuolumne,2021-07-19,65,46480,24,12384,40,33195,1,901,40,3245,21,21929,41,25174,California
Tuolumne,2021-07-20,54,46534,19,12403,35,33230,0,901,37,3267,15,21944,37,25211,California
Tuolumne,2021-07-21,67,46601,14,12417,49,33279,4,905,39,3282,28,21972,43,25254,California
Tuolumne,2021-07-22,55,46656,14,12431,31,33310,10,915,32,3301,23,21995,42,25296,California
Tuolumne,2021-07-23,104,46760,59,12490,40,33350,5,920,65,3335,37,22032,71,25367,California
Tuolumne,2021-07-24,34,46794,4,12494,30,33380,0,920,24,3349,10,22042,24,25391,California
Tuolumne,2021-07-25,21,46815,12,12506,8,33388,1,921,18,3365,3,22045,19,25410,California
Tuolumne,2021-07-26,90,46905,43,12549,39,33427,8,929,57,3398,33,22078,66,25476,California
Tuolumne,2021-07-27,83,46988,25,12574,52,33479,6,935,52,3426,30,22108,58,25534,California
Tuolumne,2021-07-28,92,47080,13,12587,55,33534,24,959,47,3453,44,22152,71,25605,California
Tuolumne,2021-07-29,59,47139,22,12609,36,33570,1,960,40,3476,18,22170,41,25646,California
Tuolumne,2021-07-30,166,47305,81,12690,71,33641,14,974,111,3549,54,22224,127,25773,California
Tuolumne,2021-07-31,35,47340,10,12700,23,33664,2,976,26,3568,9,22233,28,25801,California
Tuolumne,2021-08-01,15,47355,3,12703,12,33676,0,976,12,3578,3,22236,13,25814,California
Tuolumne,2021-08-02,37,47392,13,12716,21,33697,3,979,25,3595,11,22247,28,25842,California
Tuolumne,2021-08-03,69,47461,23,12739,44,33741,2,981,49,3627,20,22267,52,25894,California
Tuolumne,2021-08-04,102,47563,39,12778,46,33787,17,998,58,3657,44,22311,74,25968,California
Tuolumne,2021-08-05,81,47644,30,12808,47,33834,4,1002,64,3709,16,22327,68,26036,California
Tuolumne,2021-08-06,129,47773,70,12878,56,33890,3,1005,91,3766,37,22364,94,26130,California
Tuolumne,2021-08-07,48,47821,10,12888,35,33925,3,1008,32,3787,14,22378,35,26165,California
Tuolumne,2021-08-08,28,47849,11,12899,17,33942,0,1008,24,3807,4,22382,24,26189,California
Tuolumne,2021-08-09,97,47946,47,12946,49,33991,1,1009,73,3858,23,22405,74,26263,California
Tuolumne,2021-08-10,80,48026,48,12994,31,34022,1,1010,60,3899,20,22425,61,26324,California
Tuolumne,2021-08-11,69,48095,23,13017,39,34061,7,1017,42,3921,27,22452,49,26373,California
Tuolumne,2021-08-12,82,48177,34,13051,33,34094,15,1032,49,3953,32,22484,64,26437,California
Tuolumne,2021-08-13,205,48382,104,13155,94,34188,7,1039,126,4008,78,22562,133,26570,California
Tuolumne,2021-08-14,37,48419,15,13170,20,34208,2,1041,21,4015,16,22578,23,26593,California
Tuolumne,2021-08-15,27,48446,12,13182,15,34223,0,1041,16,4021,10,22588,16,26609,California
Tuolumne,2021-08-16,109,48555,50,13232,55,34278,4,1045,70,4062,33,22621,74,26683,California
Tuolumne,2021-08-17,110,48665,38,13270,68,34346,4,1049,64,4094,37,22658,69,26752,California
Tuolumne,2021-08-18,106,48771,39,13309,61,34407,6,1055,69,4134,35,22693,75,26827,California
Tuolumne,2021-08-19,91,48862,36,13345,37,34444,18,1073,48,4159,40,22733,65,26892,California
Tuolumne,2021-08-20,202,49064,107,13452,77,34521,18,1091,121,4228,70,22803,139,27031,California
Tuolumne,2021-08-21,63,49127,35,13487,26,34547,2,1093,29,4233,26,22829,31,27062,California
Tuolumne,2021-08-22,26,49153,7,13494,18,34565,1,1094,15,4241,8,22837,16,27078,California
Tuolumne,2021-08-23,172,49325,87,13581,83,34648,2,1096,121,4321,45,22882,125,27203,California
Tuolumne,2021-08-24,124,49449,73,13654,50,34698,1,1097,85,4376,37,22919,92,27295,California
Tuolumne,2021-08-25,89,49538,51,13705,35,34733,3,1100,44,4394,38,22957,56,27351,California
Tuolumne,2021-08-26,50,49588,20,13725,28,34761,2,1102,27,4407,21,22978,34,27385,California
Tuolumne,2021-08-27,172,49760,114,13839,54,34815,4,1106,61,4381,98,23076,72,27457,California
Tuolumne,2021-08-28,47,49807,23,13862,22,34837,2,1108,17,4378,28,23104,25,27482,California
Tuolumne,2021-08-29,36,49843,25,13887,11,34848,0,1108,26,4397,9,23113,28,27510,California
Tuolumne,2021-08-30,61,49904,20,13907,39,34887,2,1110,31,4413,25,23138,41,27551,California
Ventura,2020-12-15,5,5,5,5,0,0,0,0,5,5,0,0,5,5,California
Ventura,2020-12-16,74,79,74,79,0,0,0,0,74,79,0,0,74,79,California
Ventura,2020-12-17,323,402,323,402,0,0,0,0,323,402,0,0,323,402,California
Ventura,2020-12-18,1604,2006,1604,2006,0,0,0,0,1604,2006,0,0,1604,2006,California
Ventura,2020-12-19,979,2985,978,2984,1,1,0,0,979,2985,0,0,979,2985,California
Ventura,2020-12-20,459,3444,459,3443,0,1,0,0,459,3444,0,0,459,3444,California
Ventura,2020-12-21,1515,4959,1514,4957,1,2,0,0,1515,4959,0,0,1515,4959,California
Ventura,2020-12-22,1170,6129,1164,6121,6,8,0,0,1170,6129,0,0,1170,6129,California
Ventura,2020-12-23,1095,7224,1043,7164,52,60,0,0,1096,7225,0,0,1096,7225,California
Ventura,2020-12-24,480,7704,380,7544,100,160,0,0,480,7705,0,0,480,7705,California
Ventura,2020-12-25,12,7716,7,7551,5,165,0,0,12,7717,0,0,12,7717,California
Ventura,2020-12-26,120,7836,98,7649,22,187,0,0,120,7837,0,0,120,7837,California
Ventura,2020-12-27,62,7898,29,7678,33,220,0,0,62,7899,0,0,62,7899,California
Ventura,2020-12-28,1098,8996,954,8632,144,364,0,0,1098,8997,0,0,1098,8997,California
Ventura,2020-12-29,1291,10287,803,9435,488,852,0,0,1291,10288,0,0,1291,10288,California
Ventura,2020-12-30,2221,12508,1538,10973,683,1535,0,0,2221,12509,0,0,2221,12509,California
Ventura,2020-12-31,486,12994,166,11139,320,1855,0,0,481,12985,5,5,481,12990,California
Ventura,2021-01-01,57,13051,28,11167,29,1884,0,0,57,13042,0,5,57,13047,California
Ventura,2021-01-02,170,13221,77,11244,93,1977,0,0,170,13212,0,5,170,13217,California
Ventura,2021-01-03,23,13244,11,11255,12,1989,0,0,23,13235,0,5,23,13240,California
Ventura,2021-01-04,1043,14287,494,11749,549,2538,0,0,1041,14276,0,5,1041,14281,California
Ventura,2021-01-05,1396,15683,796,12545,600,3138,0,0,1282,15447,111,116,1282,15563,California
Ventura,2021-01-06,2044,17727,1172,13717,872,4010,0,0,1555,16524,480,596,1557,17120,California
Ventura,2021-01-07,2089,19816,1333,15050,756,4766,0,0,1045,16531,1039,1635,1046,18166,California
Ventura,2021-01-08,2227,22043,1500,16550,727,5493,0,0,915,16140,1309,2944,918,19084,California
Ventura,2021-01-09,729,22772,503,17053,226,5719,0,0,323,16057,406,3350,323,19407,California
Ventura,2021-01-10,345,23117,326,17379,19,5738,0,0,135,15982,210,3560,135,19542,California
Ventura,2021-01-11,2464,25581,1502,18881,962,6700,0,0,1508,16539,955,4515,1512,21054,California
Ventura,2021-01-12,3054,28635,1631,20512,1423,8123,0,0,1922,17330,1132,5647,1923,22977,California
Ventura,2021-01-13,2949,31584,1443,21955,1506,9629,0,0,2027,18437,921,6568,2028,25005,California
Ventura,2021-01-14,2787,34371,1108,23063,1679,11308,0,0,2325,20302,461,7029,2326,27331,California
Ventura,2021-01-15,2908,37279,976,24039,1932,13240,0,0,2683,22761,225,7254,2684,30015,California
Ventura,2021-01-16,482,37761,190,24229,292,13532,0,0,403,23085,79,7333,403,30418,California
Ventura,2021-01-17,275,38036,148,24377,127,13659,0,0,266,23343,8,7341,266,30684,California
Ventura,2021-01-18,2236,40272,1684,26061,552,14211,0,0,1682,24473,553,7894,1683,32367,California
Ventura,2021-01-19,3096,43368,2147,28208,949,15160,0,0,2155,25691,940,8834,2158,34525,California
Ventura,2021-01-20,4181,47549,3228,31436,953,16113,0,0,3067,27649,1110,9944,3068,37593,California
Ventura,2021-01-21,3872,51421,2715,34151,1157,17270,0,0,3186,30159,679,10623,3189,40782,California
Ventura,2021-01-22,3597,55018,2479,36630,1118,18388,0,0,3428,33418,169,10792,3428,44210,California
Ventura,2021-01-23,1163,56181,640,37270,523,18911,0,0,1066,34390,96,10888,1068,45278,California
Ventura,2021-01-24,451,56632,131,37401,320,19231,0,0,435,34810,15,10903,435,45713,California
Ventura,2021-01-25,3132,59764,2026,39427,1106,20337,0,0,2575,36830,556,11459,2576,48289,California
Ventura,2021-01-26,3681,63445,2203,41630,1478,21815,0,0,2566,38285,1111,12570,2566,50855,California
Ventura,2021-01-27,3457,66902,1561,43191,1896,23711,0,0,2583,39999,871,13441,2585,53440,California
Ventura,2021-01-28,3884,70786,2003,45194,1881,25592,0,0,3200,42535,668,14109,3204,56644,California
Ventura,2021-01-29,4302,75088,2544,47738,1758,27350,0,0,3757,45763,530,14639,3758,60402,California
Ventura,2021-01-30,3038,78126,1964,49702,1074,28424,0,0,2863,48457,170,14809,2864,63266,California
Ventura,2021-01-31,808,78934,426,50128,382,28806,0,0,714,49078,93,14902,714,63980,California
Ventura,2021-02-01,4020,82954,2142,52270,1878,30684,0,0,3213,51495,798,15700,3215,67195,California
Ventura,2021-02-02,4430,87384,2353,54623,2077,32761,0,0,3373,53824,1047,16747,3376,70571,California
Ventura,2021-02-03,4429,91813,2064,56687,2365,35126,0,0,3402,56206,1022,17769,3404,73975,California
Ventura,2021-02-04,4803,96616,2284,58971,2519,37645,0,0,3510,58434,1286,19055,3514,77489,California
Ventura,2021-02-05,4928,101544,2390,61361,2538,40183,0,0,3372,60261,1548,20603,3375,80864,California
Ventura,2021-02-06,2865,104409,1505,62866,1360,41543,0,0,2448,62293,417,21020,2449,83313,California
Ventura,2021-02-07,747,105156,230,63096,517,42060,0,0,614,62775,133,21153,615,83928,California
Ventura,2021-02-08,3585,108741,1661,64757,1924,43984,0,0,2463,64127,1113,22266,2465,86393,California
Ventura,2021-02-09,4765,113506,1986,66743,2779,46763,0,0,2480,64331,2280,24546,2484,88877,California
Ventura,2021-02-10,4775,118281,2259,69002,2516,49279,0,0,2407,64386,2353,26899,2408,91285,California
Ventura,2021-02-11,4711,122992,1878,70880,2833,52112,0,0,2476,64639,2226,29125,2479,93764,California
Ventura,2021-02-12,6414,129406,2677,73557,3737,55849,0,0,3297,64829,3109,32234,3299,97063,California
Ventura,2021-02-13,3381,132787,1838,75395,1543,57392,0,0,1914,65286,1460,33694,1917,98980,California
Ventura,2021-02-14,1215,134002,123,75518,1092,58484,0,0,1008,66091,205,33899,1010,99990,California
Ventura,2021-02-15,4045,138047,1826,77344,2219,60703,0,0,2123,66301,1915,35814,2125,102115,California
Ventura,2021-02-16,5613,143660,2730,80074,2883,63586,0,0,3036,66774,2564,38378,3037,105152,California
Ventura,2021-02-17,5355,149015,1930,82004,3425,67011,0,0,3374,68179,1969,40347,3374,108526,California
Ventura,2021-02-18,5831,154846,1831,83835,4000,71011,0,0,3680,69724,2135,42482,3680,112206,California
Ventura,2021-02-19,6568,161414,3826,87661,2742,73753,0,0,3042,69256,3517,45999,3049,115255,California
Ventura,2021-02-20,4996,166410,3226,90887,1770,75523,0,0,2760,69805,2215,48214,2764,118019,California
Ventura,2021-02-21,1113,167523,821,91708,292,75815,0,0,466,69630,641,48855,466,118485,California
Ventura,2021-02-22,5739,173262,2556,94264,3183,78998,0,0,3659,71233,2058,50913,3661,122146,California
Ventura,2021-02-23,6215,179477,3078,97342,3137,82135,0,0,3576,72202,2611,53524,3580,125726,California
Ventura,2021-02-24,7336,186813,2684,100026,4652,86787,0,0,4417,73729,2894,56418,4421,130147,California
Ventura,2021-02-25,7925,194738,2716,102742,5209,91996,0,0,4790,75410,3114,59532,4795,134942,California
Ventura,2021-02-26,9817,204555,2893,105635,6924,98920,0,0,6382,78394,3402,62934,6386,141328,California
Ventura,2021-02-27,11050,215605,5515,111150,5535,104455,0,0,8294,83966,2732,65666,8304,149632,California
Ventura,2021-02-28,2654,218259,1721,112871,933,105388,0,0,2161,85646,482,66148,2162,151794,California
Ventura,2021-03-01,7461,225720,2970,115841,4484,109872,7,7,4929,88104,2490,68638,4948,156742,California
Ventura,2021-03-02,7992,233712,4186,120027,3804,113676,2,9,5590,91312,2385,71023,5593,162335,California
Ventura,2021-03-03,8947,242659,4053,124080,4891,118567,3,12,6294,94987,2627,73650,6302,168637,California
Ventura,2021-03-04,8437,251096,3924,128004,4513,123080,0,12,5686,97945,2733,76383,5691,174328,California
Ventura,2021-03-05,10136,261232,4834,132838,5290,128370,12,24,7177,102207,2940,79323,7202,181530,California
Ventura,2021-03-06,7763,268995,4399,137237,3208,131578,156,180,5702,106022,2048,81371,5863,187393,California
Ventura,2021-03-07,1722,270717,618,137855,957,132535,147,327,1255,106962,467,81838,1407,188800,California
Ventura,2021-03-08,6873,277590,3455,141310,3253,135788,165,492,4733,109736,2125,83963,4899,193699,California
Ventura,2021-03-09,6876,284466,3034,144344,3647,139435,195,687,3957,110992,2903,86866,4159,197858,California
Ventura,2021-03-10,7081,291547,3029,147373,3812,143247,240,927,4700,113566,2364,89230,4938,202796,California
Ventura,2021-03-11,6583,298130,2911,150284,3353,146600,319,1246,3558,114441,3001,92231,3876,206672,California
Ventura,2021-03-12,8779,306909,3064,153348,4864,151464,851,2097,4263,115051,4489,96720,5099,211771,California
Ventura,2021-03-13,7296,314205,2503,155851,3955,155419,838,2935,4286,117177,2993,99713,5119,216890,California
Ventura,2021-03-14,2117,316322,474,156325,1145,156564,498,3433,717,116996,1396,101109,1215,218105,California
Ventura,2021-03-15,7111,323433,2029,158354,3735,160299,1347,4780,3104,117461,3975,105084,4440,222545,California
Ventura,2021-03-16,8179,331612,2464,160818,4597,164896,1118,5898,4180,118763,3978,109062,5280,227825,California
Ventura,2021-03-17,7787,339399,2811,163629,4633,169529,343,6241,4700,120744,3063,112125,5044,232869,California
Ventura,2021-03-18,7599,346998,3301,166930,4148,173677,150,6391,4937,123185,2645,114770,5086,237955,California
Ventura,2021-03-19,8740,355738,3833,170763,4789,178466,118,6509,5219,125033,3484,118254,5332,243287,California
Ventura,2021-03-20,8932,364670,5954,176717,2954,181420,24,6533,4578,125314,4321,122575,4602,247889,California
Ventura,2021-03-21,2813,367483,1539,178256,902,182322,372,6905,1273,125435,1520,124095,1641,249530,California
Ventura,2021-03-22,7471,374954,3719,181975,3645,185967,107,7012,4862,127829,2577,126672,4971,254501,California
Ventura,2021-03-23,8314,383268,3946,185921,4296,190263,72,7084,4568,128768,3701,130373,4640,259141,California
Ventura,2021-03-24,9011,392279,3449,189370,5481,195744,81,7165,4340,128574,4620,134993,4426,263567,California
Ventura,2021-03-25,8855,401134,3922,193292,4821,200565,112,7277,4360,128580,4464,139457,4470,268037,California
Ventura,2021-03-26,10078,411212,3404,196696,6017,206582,657,7934,3912,127021,6125,145582,4566,272603,California
Ventura,2021-03-27,8806,420018,3948,200644,4817,211399,41,7975,2299,122903,6457,152039,2339,274942,California
Ventura,2021-03-28,2524,422542,1416,202060,1098,212497,10,7985,1349,123092,1169,153208,1358,276300,California
Ventura,2021-03-29,8660,431202,4332,206392,4280,216777,48,8033,4195,122906,4430,157638,4244,280544,California
Ventura,2021-03-30,9059,440261,4488,210880,4440,221217,131,8164,4323,122647,4711,162349,4452,284996,California
Ventura,2021-03-31,10895,451156,4899,215779,5369,226586,627,8791,4616,121647,6237,168586,5237,290233,California
Ventura,2021-04-01,10995,462151,5307,221086,4800,231386,888,9679,5464,122528,5459,174045,6340,296573,California
Ventura,2021-04-02,11901,474052,4663,225749,5884,237270,1354,11033,5642,123309,6207,180252,6988,303561,California
Ventura,2021-04-03,8124,482176,4041,229790,2890,240160,1193,12226,3409,123201,4697,184949,4589,308150,California
Ventura,2021-04-04,1728,483904,966,230756,625,240785,137,12363,1151,123920,567,185516,1286,309436,California
Ventura,2021-04-05,9497,493401,4882,235638,3484,244269,1131,13494,4802,125169,4675,190191,5924,315360,California
Ventura,2021-04-06,11048,504449,5600,241238,3940,248209,1508,15002,5658,126975,5356,195547,7162,322522,California
Ventura,2021-04-07,11521,515970,5422,246660,4585,252794,1514,16516,5208,127397,6286,201833,6708,329230,California
Ventura,2021-04-08,10497,526467,5288,251948,4209,257003,1000,17516,5199,128314,5265,207098,6182,335412,California
Ventura,2021-04-09,11451,537918,4403,256351,5296,262299,1752,19268,4985,128606,6429,213527,6721,342133,California
Ventura,2021-04-10,9909,547827,4201,260552,3539,265838,2169,21437,3046,126970,6840,220367,5204,347337,California
Ventura,2021-04-11,2457,550284,865,261417,1013,266851,579,22016,691,126484,1754,222121,1268,348605,California
Ventura,2021-04-12,9130,559414,4537,265954,3744,270595,849,22865,3805,125826,5304,227425,4646,353251,California
Ventura,2021-04-13,8976,568390,4575,270529,4395,274990,6,22871,3763,124433,5165,232590,3772,357023,California
Ventura,2021-04-14,8903,577293,4142,274671,4745,279735,16,22887,3386,122372,5467,238057,3406,360429,California
Ventura,2021-04-15,9512,586805,4610,279281,4875,284610,27,22914,4070,121077,5395,243452,4100,364529,California
Ventura,2021-04-16,10269,597074,4510,283791,5757,290367,2,22916,4768,120384,5468,248920,4775,369304,California
Ventura,2021-04-17,9098,606172,5428,289219,3656,294023,14,22930,5256,121829,3824,252744,5269,374573,California
Ventura,2021-04-18,2227,608399,1098,290317,1129,295152,0,22930,967,121548,1249,253993,968,375541,California
Ventura,2021-04-19,8194,616593,4896,295213,3295,298447,3,22933,4686,122763,3475,257468,4690,380231,California
Ventura,2021-04-20,9603,626196,5084,300297,4514,302961,5,22938,4456,122111,5113,262581,4461,384692,California
Ventura,2021-04-21,9295,635491,4810,305107,4479,307440,6,22944,4388,121635,4869,267450,4393,389085,California
Ventura,2021-04-22,10279,645770,5617,310724,4661,312101,1,22945,4577,120547,5669,273119,4581,393666,California
Ventura,2021-04-23,11187,656957,5554,316278,5632,317733,1,22946,5553,120506,5597,278716,5556,399222,California
Ventura,2021-04-24,10699,667656,5970,322248,4729,322462,0,22946,6288,122408,4388,283104,6290,405512,California
Ventura,2021-04-25,2507,670163,1741,323989,765,323227,1,22947,1168,122244,1333,284437,1169,406681,California
Ventura,2021-04-26,8096,678259,4629,328618,3400,326627,67,23014,3371,120988,4688,289125,3432,410113,California
Ventura,2021-04-27,9330,687589,5210,333828,3894,330521,226,23240,3506,118921,5798,294923,3731,413844,California
Ventura,2021-04-28,8566,696155,4949,338777,3289,333810,328,23568,3366,117451,5163,300086,3693,417537,California
Ventura,2021-04-29,8092,704247,4359,343136,3470,337280,263,23831,2881,115414,5180,305266,3143,420680,California
Ventura,2021-04-30,9691,713938,5583,348719,3829,341109,279,24110,3993,114019,5657,310923,4262,424942,California
Ventura,2021-05-01,5254,719192,3687,352406,1455,342564,112,24222,2074,113072,3126,314049,2179,427121,California
Ventura,2021-05-02,2147,721339,1429,353835,627,343191,91,24313,1032,113092,1104,315153,1124,428245,California
Ventura,2021-05-03,6392,727731,3932,357767,2168,345359,292,24605,1993,111010,4367,319520,2285,430530,California
Ventura,2021-05-04,6505,734236,3406,361173,2806,348165,293,24898,2323,109463,4164,323684,2617,433147,California
Ventura,2021-05-05,5559,739795,3098,364271,2199,350364,262,25160,1977,108148,3545,327229,2230,435377,California
Ventura,2021-05-06,6331,746126,3258,367529,2808,353172,265,25425,2017,106140,4290,331519,2282,437659,California
Ventura,2021-05-07,6962,753088,3432,370961,3257,356429,273,25698,2374,104231,4554,336073,2645,440304,California
Ventura,2021-05-08,5531,758619,4277,375238,1090,357519,164,25862,1240,101358,4274,340347,1401,441705,California
Ventura,2021-05-09,1131,759750,821,376059,263,357782,47,25909,425,101130,698,341045,470,442175,California
Ventura,2021-05-10,6212,765962,4145,380204,1853,359635,214,26123,1392,97934,4801,345846,1605,443780,California
Ventura,2021-05-11,5475,771437,3359,383563,1884,361519,232,26355,1527,95762,3932,349778,1760,445540,California
Ventura,2021-05-12,5141,776578,3004,386567,1914,363433,223,26578,1559,93987,3557,353335,1782,447322,California
Ventura,2021-05-13,6504,783082,3929,390496,2363,365796,212,26790,2314,92346,4170,357505,2529,449851,California
Ventura,2021-05-14,7648,790730,4714,395210,2705,368501,229,27019,2880,90703,4750,362255,3107,452958,California
Ventura,2021-05-15,6835,797565,5444,400654,1307,369808,84,27103,2813,89613,3987,366242,2897,455855,California
Ventura,2021-05-16,2226,799791,1730,402384,441,370249,55,27158,1043,89532,1178,367420,1097,456952,California
Ventura,2021-05-17,5977,805768,3591,405975,2167,372416,219,27377,2433,88658,3525,370945,2651,459603,California
Ventura,2021-05-18,5519,811287,3194,409169,2143,374559,182,27559,2154,87653,3340,374285,2335,461938,California
Ventura,2021-05-19,5982,817269,3578,412747,2192,376751,212,27771,2390,86695,3555,377840,2597,464535,California
Ventura,2021-05-20,5619,822888,3079,415826,2374,379125,166,27937,2139,85552,3443,381283,2300,466835,California
Ventura,2021-05-21,8107,830995,4552,420378,3372,382497,183,28120,2599,82867,5468,386751,2783,469618,California
Ventura,2021-05-22,5766,836761,2912,423290,2776,385273,78,28198,1779,80753,3972,390723,1858,471476,California
Ventura,2021-05-23,2003,838764,1532,424822,399,385672,72,28270,751,80333,1243,391966,823,472299,California
Ventura,2021-05-24,4628,843392,2498,427320,1963,387635,167,28437,1472,78837,3130,395096,1634,473933,California
Ventura,2021-05-25,4406,847798,2260,429580,1993,389628,153,28590,1442,77488,2943,398039,1594,475527,California
Ventura,2021-05-26,4389,852187,2304,431884,1918,391546,167,28757,1667,76629,2695,400734,1836,477363,California
Ventura,2021-05-27,3964,856151,1942,433826,1892,393438,130,28887,1409,75626,2539,403273,1536,478899,California
Ventura,2021-05-28,4680,860831,2517,436343,1968,395406,195,29082,2041,75244,2613,405886,2231,481130,California
Ventura,2021-05-29,2212,863043,1367,437710,778,396184,67,29149,1083,75279,1115,407001,1150,482280,California
Ventura,2021-05-30,923,863966,584,438294,285,396469,54,29203,361,75139,554,407555,414,482694,California
Ventura,2021-05-31,265,864231,142,438436,113,396582,10,29213,62,75009,202,407757,72,482766,California
Ventura,2021-06-01,4091,868322,2321,440757,1604,398186,166,29379,1319,73751,2743,410500,1485,484251,California
Ventura,2021-06-02,3035,871357,1669,442426,1226,399412,140,29519,1026,72927,1989,412489,1165,485416,California
Ventura,2021-06-03,3332,874689,2053,444479,1122,400534,157,29676,896,71555,2424,414913,1052,486468,California
Ventura,2021-06-04,4702,879391,3091,447570,1450,401984,161,29837,1452,69936,3231,418144,1612,488080,California
Ventura,2021-06-05,3865,883256,3213,450783,587,402571,65,29902,1158,68468,2692,420836,1224,489304,California
Ventura,2021-06-06,1264,884520,1080,451863,139,402710,45,29947,280,67823,970,421806,325,489629,California
Ventura,2021-06-07,3211,887731,2383,454246,713,403423,115,30062,953,66647,2243,424049,1067,490696,California
Ventura,2021-06-08,3108,890839,2041,456287,930,404353,137,30199,894,65481,2197,426246,1031,491727,California
Ventura,2021-06-09,3005,893844,2086,458373,808,405161,111,30310,772,64146,2218,428464,883,492610,California
Ventura,2021-06-10,3080,896924,2149,460522,830,405991,101,30411,820,62819,2246,430710,919,493529,California
Ventura,2021-06-11,3581,900505,2456,462978,985,406976,140,30551,1014,61418,2552,433262,1151,494680,California
Ventura,2021-06-12,2208,902713,1729,464707,433,407409,46,30597,516,60300,1680,434942,562,495242,California
Ventura,2021-06-13,1029,903742,795,465502,169,407578,65,30662,236,59812,791,435733,303,495545,California
Ventura,2021-06-14,2685,906427,1836,467338,720,408298,129,30791,822,58911,1851,437584,950,496495,California
Ventura,2021-06-15,2521,908948,1615,468953,789,409087,117,30908,862,58252,1635,439219,976,497471,California
Ventura,2021-06-16,2540,911488,1859,470812,572,409659,109,31017,840,57525,1674,440893,947,498418,California
Ventura,2021-06-17,2254,913742,1574,472386,577,410236,103,31120,820,57023,1425,442318,923,499341,California
Ventura,2021-06-18,3013,916755,2118,474504,767,411003,128,31248,976,56106,2021,444339,1104,500445,California
Ventura,2021-06-19,1406,918161,1087,475591,293,411296,26,31274,525,55789,868,445207,551,500996,California
Ventura,2021-06-20,697,918858,538,476129,116,411412,43,31317,261,55660,433,445640,304,501300,California
Ventura,2021-06-21,1697,920555,1082,477211,494,411906,121,31438,837,55769,848,446488,957,502257,California
Ventura,2021-06-22,2012,922567,1407,478618,503,412409,102,31540,736,55343,1263,447751,837,503094,California
Ventura,2021-06-23,1833,924400,1244,479862,463,412872,126,31666,744,55134,1078,448829,869,503963,California
Ventura,2021-06-24,1867,926267,1222,481084,524,413396,121,31787,730,54858,1127,449956,851,504814,California
Ventura,2021-06-25,2461,928728,1635,482719,650,414046,176,31963,888,54360,1562,451518,1064,505878,California
Ventura,2021-06-26,1587,930315,1287,484006,237,414283,63,32026,528,53901,1050,452568,591,506469,California
Ventura,2021-06-27,589,930904,455,484461,107,414390,27,32053,264,53869,324,452892,292,506761,California
Ventura,2021-06-28,1809,932713,1445,485906,258,414648,106,32159,736,53652,1059,453951,842,507603,California
Ventura,2021-06-29,1697,934410,1133,487039,472,415120,92,32251,701,53455,987,454938,790,508393,California
Ventura,2021-06-30,1621,936031,1136,488175,383,415503,102,32353,795,53531,817,455755,893,509286,California
Ventura,2021-07-01,1499,937530,1109,489284,312,415815,78,32431,639,53399,848,456603,716,510002,California
Ventura,2021-07-02,1806,939336,1232,490516,476,416291,98,32529,836,53370,961,457564,932,510934,California
Ventura,2021-07-03,904,940240,675,491191,192,416483,37,32566,449,53409,446,458010,485,511419,California
Ventura,2021-07-04,62,940302,46,491237,12,416495,4,32570,26,53405,34,458044,30,511449,California
Ventura,2021-07-05,956,941258,698,491935,190,416685,68,32638,401,53321,550,458594,466,511915,California
Ventura,2021-07-06,1540,942798,1070,493005,396,417081,74,32712,662,53189,868,459462,736,512651,California
Ventura,2021-07-07,1550,944348,1073,494078,373,417454,104,32816,591,52933,951,460413,695,513346,California
Ventura,2021-07-08,1764,946112,1347,495425,339,417793,78,32894,718,52692,1037,461450,796,514142,California
Ventura,2021-07-09,1655,947767,1194,496619,353,418146,108,33002,684,52528,953,462403,789,514931,California
Ventura,2021-07-10,962,948729,736,497355,177,418323,49,33051,468,52556,489,462892,517,515448,California
Ventura,2021-07-11,471,949200,387,497742,67,418390,17,33068,182,52468,287,463179,199,515647,California
Ventura,2021-07-12,1394,950594,1069,498811,260,418650,65,33133,586,52314,804,463983,650,516297,California
Ventura,2021-07-13,1437,952031,926,499737,452,419102,59,33192,667,52275,765,464748,726,517023,California
Ventura,2021-07-14,1217,953248,821,500558,329,419431,67,33259,508,52150,699,465447,574,517597,California
Ventura,2021-07-15,1528,954776,1133,501691,325,419756,70,33329,730,52165,785,466232,800,518397,California
Ventura,2021-07-16,1797,956573,1260,502951,464,420220,73,33402,841,52139,939,467171,913,519310,California
Ventura,2021-07-17,992,957565,720,503671,218,420438,54,33456,475,52155,513,467684,529,519839,California
Ventura,2021-07-18,590,958155,466,504137,108,420546,16,33472,296,52176,290,467974,311,520150,California
Ventura,2021-07-19,1402,959557,1088,505225,261,420807,53,33525,663,52157,736,468710,717,520867,California
Ventura,2021-07-20,1504,961061,1044,506269,400,421207,60,33585,769,52260,726,469436,829,521696,California
Ventura,2021-07-21,1573,962634,1152,507421,348,421555,73,33658,770,52314,788,470224,842,522538,California
Ventura,2021-07-22,1575,964209,1140,508561,369,421924,66,33724,837,52490,726,470950,902,523440,California
Ventura,2021-07-23,1917,966126,1291,509852,532,422456,94,33818,953,52587,949,471899,1046,524486,California
Ventura,2021-07-24,1066,967192,806,510658,232,422688,28,33846,606,52768,453,472352,634,525120,California
Ventura,2021-07-25,530,967722,417,511075,107,422795,6,33852,388,53023,139,472491,394,525514,California
Ventura,2021-07-26,1606,969328,1248,512323,304,423099,54,33906,957,53393,639,473130,1009,526523,California
Ventura,2021-07-27,1673,971001,1189,513512,402,423501,82,33988,950,53707,716,473846,1030,527553,California
Ventura,2021-07-28,1598,972599,1124,514636,391,423892,83,34071,936,54073,655,474501,1021,528574,California
Ventura,2021-07-29,1784,974383,1308,515944,391,424283,85,34156,999,54384,773,475274,1084,529658,California
Ventura,2021-07-30,1892,976275,1315,517259,465,424748,112,34268,1089,54808,776,476050,1200,530858,California
Ventura,2021-07-31,1187,977462,895,518154,258,425006,34,34302,683,55038,487,476537,717,531575,California
Ventura,2021-08-01,591,978053,474,518628,98,425104,19,34321,367,55212,211,476748,385,531960,California
Ventura,2021-08-02,1646,979699,1292,519920,286,425390,68,34389,1003,55648,632,477380,1068,533028,California
Ventura,2021-08-03,1478,981177,1033,520953,383,425773,62,34451,881,56003,587,477967,942,533970,California
Ventura,2021-08-04,1423,982600,1015,521968,347,426120,61,34512,884,56419,528,478495,944,534914,California
Ventura,2021-08-05,1760,984360,1352,523320,322,426442,86,34598,1005,56780,729,479224,1090,536004,California
Ventura,2021-08-06,2085,986445,1550,524870,443,426885,92,34690,1250,57308,814,480038,1342,537346,California
Ventura,2021-08-07,1081,987526,815,525685,235,427120,31,34721,617,57503,453,480491,648,537994,California
Ventura,2021-08-08,705,988231,565,526250,122,427242,18,34739,444,57707,258,480749,462,538456,California
Ventura,2021-08-09,1722,989953,1399,527649,269,427511,54,34793,1041,58134,668,481417,1095,539551,California
Ventura,2021-08-10,1669,991622,1205,528854,400,427911,64,34857,968,58481,685,482102,1032,540583,California
Ventura,2021-08-11,1635,993257,1233,530087,310,428221,92,34949,908,58773,707,482809,999,541582,California
Ventura,2021-08-12,1805,995062,1310,531397,399,428620,96,35045,990,59062,797,483606,1086,542668,California
Ventura,2021-08-13,2066,997128,1429,532826,561,429181,76,35121,1184,59477,841,484447,1256,543924,California
Ventura,2021-08-14,1324,998452,992,533818,277,429458,55,35176,650,59595,586,485033,704,544628,California
Ventura,2021-08-15,798,999250,636,534454,147,429605,15,35191,402,59695,317,485350,417,545045,California
Ventura,2021-08-16,2143,1001393,1538,535992,511,430116,94,35285,1028,59913,902,486252,1120,546165,California
Ventura,2021-08-17,2048,1003441,1411,537403,572,430688,65,35350,970,60132,815,487067,1034,547199,California
Ventura,2021-08-18,2125,1005566,1500,538903,557,431245,68,35418,988,60291,896,487963,1055,548254,California
Ventura,2021-08-19,2131,1007697,1593,540496,459,431704,79,35497,1005,60530,845,488808,1084,549338,California
Ventura,2021-08-20,2487,1010184,1683,542179,734,432438,70,35567,1127,60725,1002,489810,1197,550535,California
Ventura,2021-08-21,1445,1011629,1047,543226,371,432809,27,35594,607,60761,598,490408,634,551169,California
Ventura,2021-08-22,930,1012559,704,543930,219,433028,7,35601,392,60783,377,490785,399,551568,California
Ventura,2021-08-23,2208,1014767,1643,545573,516,433544,49,35650,977,60899,909,491694,1025,552593,California
Ventura,2021-08-24,1998,1016765,1440,547013,494,434038,64,35714,895,61015,842,492536,958,553551,California
Ventura,2021-08-25,1886,1018651,1363,548376,478,434516,45,35759,821,61089,791,493327,865,554416,California
Ventura,2021-08-26,1978,1020629,1420,549796,461,434977,97,35856,813,61127,875,494202,913,555329,California
Ventura,2021-08-27,2650,1023279,1919,551715,636,435613,95,35951,1029,60994,1253,495455,1120,556449,California
Ventura,2021-08-28,1603,1024882,1202,552917,357,435970,44,35995,600,60858,780,496235,644,557093,California
Ventura,2021-08-29,855,1025737,647,553564,191,436161,17,36012,340,60810,405,496640,357,557450,California
Ventura,2021-08-30,1399,1027136,1020,554584,332,436493,47,36059,431,60520,768,497408,478,557928,California
Yolo,2020-12-15,39,39,39,39,0,0,0,0,39,39,0,0,39,39,California
Yolo,2020-12-16,80,119,80,119,0,0,0,0,80,119,0,0,80,119,California
Yolo,2020-12-17,110,229,110,229,0,0,0,0,110,229,0,0,110,229,California
Yolo,2020-12-18,233,462,233,462,0,0,0,0,233,462,0,0,233,462,California
Yolo,2020-12-19,88,550,88,550,0,0,0,0,88,550,0,0,88,550,California
Yolo,2020-12-20,106,656,106,656,0,0,0,0,106,656,0,0,106,656,California
Yolo,2020-12-21,258,914,258,914,0,0,0,0,258,914,0,0,258,914,California
Yolo,2020-12-22,391,1305,389,1303,2,2,0,0,391,1305,0,0,391,1305,California
Yolo,2020-12-23,442,1747,420,1723,22,24,0,0,442,1747,0,0,442,1747,California
Yolo,2020-12-24,157,1904,96,1819,61,85,0,0,157,1904,0,0,157,1904,California
Yolo,2020-12-25,1,1905,1,1820,0,85,0,0,1,1905,0,0,1,1905,California
Yolo,2020-12-26,76,1981,26,1846,50,135,0,0,76,1981,0,0,76,1981,California
Yolo,2020-12-27,48,2029,21,1867,27,162,0,0,48,2029,0,0,48,2029,California
Yolo,2020-12-28,406,2435,235,2102,171,333,0,0,406,2435,0,0,406,2435,California
Yolo,2020-12-29,540,2975,272,2374,268,601,0,0,540,2975,0,0,540,2975,California
Yolo,2020-12-30,651,3626,277,2651,374,975,0,0,651,3626,0,0,651,3626,California
Yolo,2020-12-31,188,3814,93,2744,95,1070,0,0,188,3814,0,0,188,3814,California
Yolo,2021-01-01,56,3870,55,2799,1,1071,0,0,56,3870,0,0,56,3870,California
Yolo,2021-01-02,72,3942,28,2827,44,1115,0,0,71,3941,0,0,71,3941,California
Yolo,2021-01-03,44,3986,19,2846,25,1140,0,0,44,3985,0,0,44,3985,California
Yolo,2021-01-04,196,4182,42,2888,154,1294,0,0,196,4181,0,0,196,4181,California
Yolo,2021-01-05,621,4803,241,3129,380,1674,0,0,558,4676,63,63,558,4739,California
Yolo,2021-01-06,492,5295,186,3315,306,1980,0,0,352,4888,140,203,352,5091,California
Yolo,2021-01-07,721,6016,235,3550,486,2466,0,0,527,5222,193,396,527,5618,California
Yolo,2021-01-08,644,6660,320,3870,324,2790,0,0,407,5394,236,632,408,6026,California
Yolo,2021-01-09,425,7085,72,3942,353,3143,0,0,378,5725,47,679,378,6404,California
Yolo,2021-01-10,408,7493,80,4022,328,3471,0,0,337,5991,71,750,337,6741,California
Yolo,2021-01-11,574,8067,332,4354,242,3713,0,0,295,6009,279,1029,297,7038,California
Yolo,2021-01-12,562,8629,444,4798,118,3831,0,0,190,5829,371,1400,191,7229,California
Yolo,2021-01-13,768,9397,314,5112,454,4285,0,0,516,6093,252,1652,516,7745,California
Yolo,2021-01-14,386,9783,185,5297,201,4486,0,0,283,6273,103,1755,283,8028,California
Yolo,2021-01-15,640,10423,326,5623,314,4800,0,0,556,6746,84,1839,557,8585,California
Yolo,2021-01-16,753,11176,92,5715,661,5461,0,0,721,7435,32,1871,721,9306,California
Yolo,2021-01-17,189,11365,119,5834,70,5531,0,0,181,7608,8,1879,181,9487,California
Yolo,2021-01-18,486,11851,309,6143,177,5708,0,0,327,7776,159,2038,327,9814,California
Yolo,2021-01-19,557,12408,366,6509,191,5899,0,0,376,7971,181,2219,376,10190,California
Yolo,2021-01-20,671,13079,386,6895,285,6184,0,0,471,8243,199,2418,471,10661,California
Yolo,2021-01-21,650,13729,383,7278,267,6451,0,0,457,8507,193,2611,457,11118,California
Yolo,2021-01-22,762,14491,256,7534,506,6957,0,0,629,9005,131,2742,629,11747,California
Yolo,2021-01-23,627,15118,126,7660,501,7458,0,0,579,9536,48,2790,579,12326,California
Yolo,2021-01-24,212,15330,123,7783,89,7547,0,0,171,9666,41,2831,171,12497,California
Yolo,2021-01-25,749,16079,165,7948,584,8131,0,0,515,9946,235,3066,515,13012,California
Yolo,2021-01-26,833,16912,327,8275,506,8637,0,0,425,9963,408,3474,425,13437,California
Yolo,2021-01-27,677,17589,224,8499,453,9090,0,0,389,10064,288,3762,389,13826,California
Yolo,2021-01-28,1089,18678,562,9061,527,9617,0,0,957,10889,132,3894,957,14783,California
Yolo,2021-01-29,1026,19704,263,9324,763,10380,0,0,939,11742,86,3980,939,15722,California
Yolo,2021-01-30,1526,21230,924,10248,602,10982,0,0,1404,13030,116,4096,1404,17126,California
Yolo,2021-01-31,243,21473,205,10453,38,11020,0,0,213,13215,28,4124,213,17339,California
Yolo,2021-02-01,860,22333,365,10818,495,11515,0,0,621,13601,235,4359,621,17960,California
Yolo,2021-02-02,1348,23681,764,11582,584,12099,0,0,930,14114,418,4777,931,18891,California
Yolo,2021-02-03,1528,25209,397,11979,1131,13230,0,0,1177,14943,348,5125,1177,20068,California
Yolo,2021-02-04,1804,27013,282,12261,1522,14752,0,0,1243,15638,550,5675,1245,21313,California
Yolo,2021-02-05,1619,28632,923,13184,696,15448,0,0,1208,16437,410,6085,1209,22522,California
Yolo,2021-02-06,1977,30609,1266,14450,711,16159,0,0,1599,17659,378,6463,1600,24122,California
Yolo,2021-02-07,538,31147,254,14704,284,16443,0,0,174,17470,363,6826,174,24296,California
Yolo,2021-02-08,946,32093,329,15033,617,17060,0,0,606,17741,335,7161,606,24902,California
Yolo,2021-02-09,862,32955,387,15420,475,17535,0,0,572,18023,290,7451,572,25474,California
Yolo,2021-02-10,1483,34438,478,15898,1005,18540,0,0,843,18228,640,8091,845,26319,California
Yolo,2021-02-11,1580,36018,810,16708,770,19310,0,0,1180,19008,400,8491,1180,27499,California
Yolo,2021-02-12,1950,37968,769,17477,1181,20491,0,0,1460,19983,486,8977,1461,28960,California
Yolo,2021-02-13,2070,40038,713,18190,1357,21848,0,0,1376,20665,694,9671,1376,30336,California
Yolo,2021-02-14,568,40606,155,18345,413,22261,0,0,442,20982,125,9796,442,30778,California
Yolo,2021-02-15,551,41157,210,18555,341,22602,0,0,279,20990,272,10068,280,31058,California
Yolo,2021-02-16,1140,42297,429,18984,711,23313,0,0,813,21477,327,10395,814,31872,California
Yolo,2021-02-17,1392,43689,702,19686,690,24003,0,0,984,22055,407,10802,985,32857,California
Yolo,2021-02-18,2493,46182,808,20494,1685,25688,0,0,1714,22992,778,11580,1715,34572,California
Yolo,2021-02-19,1771,47953,745,21239,1026,26714,0,0,1135,23493,634,12214,1135,35707,California
Yolo,2021-02-20,2578,50531,963,22202,1615,28329,0,0,1383,23687,1190,13404,1384,37091,California
Yolo,2021-02-21,336,50867,240,22442,96,28425,0,0,109,23570,226,13630,109,37200,California
Yolo,2021-02-22,1419,52286,618,23060,801,29226,0,0,708,23569,709,14339,708,37908,California
Yolo,2021-02-23,1170,53456,882,23942,288,29514,0,0,429,23259,740,15079,430,38338,California
Yolo,2021-02-24,2127,55583,611,24553,1516,31030,0,0,1367,23868,758,15837,1367,39705,California
Yolo,2021-02-25,1446,57029,505,25058,941,31971,0,0,938,24299,507,16344,938,40643,California
Yolo,2021-02-26,2742,59771,1078,26136,1664,33635,0,0,1294,24149,1444,17788,1294,41937,California
Yolo,2021-02-27,1780,61551,820,26956,960,34595,0,0,1299,24967,481,18269,1299,43236,California
Yolo,2021-02-28,1914,63465,1602,28558,312,34907,0,0,737,24531,1174,19443,738,43974,California
Yolo,2021-03-01,1175,64640,387,28945,788,35695,0,0,705,24770,466,19909,705,44679,California
Yolo,2021-03-02,1599,66239,776,29721,823,36518,0,0,1001,25174,597,20506,1001,45680,California
Yolo,2021-03-03,1946,68185,674,30395,1271,37789,1,1,868,24968,1075,21581,869,46549,California
Yolo,2021-03-04,3079,71264,1500,31895,1579,39368,0,1,1597,25086,1479,23060,1597,48146,California
Yolo,2021-03-05,2532,73796,1429,33324,1092,40460,11,12,1504,25575,1026,24086,1515,49661,California
Yolo,2021-03-06,1528,75324,1171,34495,328,40788,29,41,871,25820,655,24741,900,50561,California
Yolo,2021-03-07,952,76276,690,35185,236,41024,26,67,795,26483,157,24898,820,51381,California
Yolo,2021-03-08,1359,77635,508,35693,807,41831,44,111,882,26936,474,25372,927,52308,California
Yolo,2021-03-09,1594,79229,691,36384,840,42671,63,174,967,27341,624,25996,1029,53337,California
Yolo,2021-03-10,2249,81478,1084,37468,873,43544,292,466,992,27363,1253,27249,1275,54612,California
Yolo,2021-03-11,2711,84189,1609,39077,1028,44572,74,540,1809,28344,901,28150,1882,56494,California
Yolo,2021-03-12,2919,87108,1356,40433,1480,46052,83,623,1379,28273,1531,29681,1460,57954,California
Yolo,2021-03-13,1954,89062,728,41161,1049,47101,177,800,1021,28539,930,30611,1196,59150,California
Yolo,2021-03-14,1079,90141,212,41373,716,47817,151,951,543,28692,533,31144,686,59836,California
Yolo,2021-03-15,1683,91824,775,42148,725,48542,183,1134,1069,29325,613,31757,1246,61082,California
Yolo,2021-03-16,2078,93902,760,42908,1245,49787,73,1207,1286,29892,790,32547,1357,62439,California
Yolo,2021-03-17,2564,96466,1018,43926,1471,51258,75,1282,1791,30988,769,33316,1865,64304,California
Yolo,2021-03-18,3058,99524,1046,44972,1784,53042,228,1510,1274,30706,1780,35096,1498,65802,California
Yolo,2021-03-19,2117,101641,879,45851,1167,54209,71,1581,1080,30829,1029,36125,1152,66954,California
Yolo,2021-03-20,2776,104417,823,46674,1909,56118,44,1625,1062,30229,1708,37833,1108,68062,California
Yolo,2021-03-21,324,104741,222,46896,94,56212,8,1633,176,30266,147,37980,184,68246,California
Yolo,2021-03-22,1411,106152,497,47393,855,57067,59,1692,911,30737,498,38478,969,69215,California
Yolo,2021-03-23,1766,107918,956,48349,752,57819,58,1750,1072,31173,692,39170,1128,70343,California
Yolo,2021-03-24,2894,110812,1413,49762,1429,59248,52,1802,1374,31094,1506,40676,1427,71770,California
Yolo,2021-03-25,2569,113381,1427,51189,1113,60361,29,1831,1250,31064,1308,41984,1278,73048,California
Yolo,2021-03-26,2413,115794,1275,52464,1119,61480,19,1850,1028,30732,1378,43362,1046,74094,California
Yolo,2021-03-27,1690,117484,472,52936,1200,62680,18,1868,729,30519,960,44322,747,74841,California
Yolo,2021-03-28,1113,118597,868,53804,225,62905,20,1888,238,29904,872,45194,257,75098,California
Yolo,2021-03-29,2040,120637,825,54629,1186,64091,29,1917,968,29833,1068,46262,997,76095,California
Yolo,2021-03-30,2327,122964,1132,55761,1178,65269,17,1934,1182,29894,1140,47402,1201,77296,California
Yolo,2021-03-31,2381,125345,1250,57011,1094,66363,37,1971,1172,29894,1208,48610,1208,78504,California
Yolo,2021-04-01,3876,129221,1877,58888,1518,67881,481,2452,1584,29669,2288,50898,2063,80567,California
Yolo,2021-04-02,3420,132641,1518,60406,1753,69634,149,2601,2049,30503,1363,52261,2197,82764,California
Yolo,2021-04-03,1834,134475,1101,61507,514,70148,219,2820,810,30508,1022,53283,1027,83791,California
Yolo,2021-04-04,394,134869,158,61665,172,70320,64,2884,145,30466,248,53531,206,83997,California
Yolo,2021-04-05,1947,136816,748,62413,1100,71420,99,2983,899,30422,1043,54574,999,84996,California
Yolo,2021-04-06,2615,139431,1342,63755,1096,72516,177,3160,1122,30233,1484,56058,1295,86291,California
Yolo,2021-04-07,3005,142436,1530,65285,1119,73635,356,3516,1731,31053,1269,57327,2089,88380,California
Yolo,2021-04-08,2443,144879,1018,66303,948,74583,477,3993,859,30804,1581,58908,1332,89712,California
Yolo,2021-04-09,2596,147475,931,67234,1100,75683,565,4558,835,30435,1757,60665,1388,91100,California
Yolo,2021-04-10,1764,149239,827,68061,754,76437,183,4741,1021,30898,739,61404,1202,92302,California
Yolo,2021-04-11,937,150176,286,68347,579,77016,72,4813,370,30775,564,61968,441,92743,California
Yolo,2021-04-12,1788,151964,530,68877,1116,78132,142,4955,791,30716,993,62961,934,93677,California
Yolo,2021-04-13,2012,153976,925,69802,1087,79219,0,4955,918,30541,1093,64054,918,94595,California
Yolo,2021-04-14,2867,156843,774,70576,2093,81312,0,4955,1373,30427,1487,65541,1373,95968,California
Yolo,2021-04-15,3370,160213,1141,71717,2229,83541,0,4955,2276,31617,1086,66627,2276,98244,California
Yolo,2021-04-16,3076,163289,1995,73712,1081,84622,0,4955,1965,32480,1102,67729,1965,100209,California
Yolo,2021-04-17,1622,164911,478,74190,1144,85766,0,4955,845,32553,772,68501,845,101054,California
Yolo,2021-04-18,644,165555,317,74507,327,86093,0,4955,358,32630,281,68782,358,101412,California
Yolo,2021-04-19,1677,167232,728,75235,948,87041,1,4956,752,32464,919,69701,753,102165,California
Yolo,2021-04-20,2062,169294,1075,76310,987,88028,0,4956,1046,32497,1013,70714,1046,103211,California
Yolo,2021-04-21,2077,171371,1069,77379,1008,89036,0,4956,1104,32634,968,71682,1105,104316,California
Yolo,2021-04-22,2007,173378,920,78299,1087,90123,0,4956,988,32611,1012,72694,989,105305,California
Yolo,2021-04-23,2694,176072,1593,79892,1101,91224,0,4956,1178,32286,1503,74197,1178,106483,California
Yolo,2021-04-24,1184,177256,650,80542,531,91755,3,4959,462,32037,714,74911,465,106948,California
Yolo,2021-04-25,963,178219,412,80954,551,92306,0,4959,731,32537,231,75142,731,107679,California
Yolo,2021-04-26,1265,179484,510,81464,752,93058,3,4962,539,32356,724,75866,543,108222,California
Yolo,2021-04-27,1577,181061,750,82214,805,93863,22,4984,609,32020,967,76833,631,108853,California
Yolo,2021-04-28,2096,183157,1041,83255,1027,94890,28,5012,756,31468,1336,78169,784,109637,California
Yolo,2021-04-29,1810,184967,854,84109,870,95760,86,5098,706,31159,1099,79268,790,110427,California
Yolo,2021-04-30,2145,187112,1103,85212,985,96745,57,5155,1060,31198,1078,80346,1117,111544,California
Yolo,2021-05-01,1302,188414,1007,86219,275,97020,20,5175,377,30672,923,81269,397,111941,California
Yolo,2021-05-02,524,188938,430,86649,71,97091,23,5198,320,30812,203,81472,343,112284,California
Yolo,2021-05-03,1152,190090,420,87069,698,97789,34,5232,301,30299,847,82319,334,112618,California
Yolo,2021-05-04,1466,191556,689,87758,754,98543,23,5255,498,29857,963,83282,521,113139,California
Yolo,2021-05-05,1606,193162,455,88213,1085,99628,66,5321,473,29270,1126,84408,539,113678,California
Yolo,2021-05-06,1514,194676,703,88916,730,100358,81,5402,486,28827,1009,85417,566,114244,California
Yolo,2021-05-07,2338,197014,1416,90332,871,101229,51,5453,463,27473,1866,87283,512,114756,California
Yolo,2021-05-08,870,197884,379,90711,434,101663,57,5510,329,27320,537,87820,384,115140,California
Yolo,2021-05-09,409,198293,178,90889,218,101881,13,5523,90,27106,317,88137,103,115243,California
Yolo,2021-05-10,1201,199494,362,91251,793,102674,46,5569,214,26380,985,89122,259,115502,California
Yolo,2021-05-11,1196,200690,709,91960,465,103139,22,5591,294,25802,894,90016,316,115818,California
Yolo,2021-05-12,1850,202540,719,92679,1098,104237,33,5624,341,24672,1504,91520,374,116192,California
Yolo,2021-05-13,2659,205199,871,93550,1730,105967,58,5682,679,23436,1974,93494,738,116930,California
Yolo,2021-05-14,2477,207676,1552,95102,893,106860,32,5714,1226,23450,1244,94738,1258,118188,California
Yolo,2021-05-15,1283,208959,741,95843,494,107354,48,5762,667,23549,616,95354,715,118903,California
Yolo,2021-05-16,1473,210432,1256,97099,211,107565,6,5768,1031,24148,438,95792,1037,119940,California
Yolo,2021-05-17,1153,211585,458,97557,674,108239,21,5789,355,23730,794,96586,376,120316,California
Yolo,2021-05-18,1818,213403,1115,98672,682,108921,21,5810,924,23788,887,97473,945,121261,California
Yolo,2021-05-19,1315,214718,593,99265,683,109604,39,5849,533,23581,779,98252,572,121833,California
Yolo,2021-05-20,1357,216075,702,99967,629,110233,26,5875,392,23041,958,99210,418,122251,California
Yolo,2021-05-21,1724,217799,999,100966,698,110931,27,5902,386,22122,1331,100541,412,122663,California
Yolo,2021-05-22,837,218636,554,101520,275,111206,8,5910,289,21881,539,101080,298,122961,California
Yolo,2021-05-23,637,219273,165,101685,455,111661,17,5927,106,21476,529,101609,124,123085,California
Yolo,2021-05-24,774,220047,350,102035,405,112066,19,5946,243,21214,526,102135,264,123349,California
Yolo,2021-05-25,895,220942,518,102553,355,112421,22,5968,348,21043,541,102676,370,123719,California
Yolo,2021-05-26,823,221765,271,102824,518,112939,34,6002,248,20754,571,103247,282,124001,California
Yolo,2021-05-27,765,222530,385,103209,332,113271,48,6050,304,20651,455,103702,352,124353,California
Yolo,2021-05-28,892,223422,407,103616,455,113726,30,6080,382,20556,505,104207,410,124763,California
Yolo,2021-05-29,606,224028,350,103966,219,113945,37,6117,276,20539,327,104534,310,125073,California
Yolo,2021-05-30,134,224162,71,104037,56,114001,7,6124,55,20524,77,104611,62,125135,California
Yolo,2021-05-31,76,224238,23,104060,49,114050,4,6128,18,20487,58,104669,21,125156,California
Yolo,2021-06-01,764,225002,332,104392,404,114454,28,6156,249,20256,507,105176,276,125432,California
Yolo,2021-06-02,768,225770,308,104700,439,114893,21,6177,232,19977,532,105708,253,125685,California
Yolo,2021-06-03,928,226698,599,105299,306,115199,23,6200,214,19506,708,106416,237,125922,California
Yolo,2021-06-04,1521,228219,1240,106539,258,115457,23,6223,383,18777,1134,107550,405,126327,California
Yolo,2021-06-05,737,228956,563,107102,157,115614,17,6240,151,18359,586,108136,168,126495,California
Yolo,2021-06-06,1134,230090,1069,108171,57,115671,8,6248,155,17547,976,109112,164,126659,California
Yolo,2021-06-07,527,230617,272,108443,233,115904,22,6270,117,17279,405,109517,137,126796,California
Yolo,2021-06-08,1040,231657,808,109251,212,116116,20,6290,192,16643,847,110364,211,127007,California
Yolo,2021-06-09,791,232448,489,109740,272,116388,30,6320,215,16317,570,110934,244,127251,California
Yolo,2021-06-10,578,233026,364,110104,180,116568,34,6354,166,16107,410,111344,200,127451,California
Yolo,2021-06-11,667,233693,454,110558,189,116757,24,6378,199,15864,466,111810,223,127674,California
Yolo,2021-06-12,488,234181,284,110842,179,116936,25,6403,146,15696,338,112148,170,127844,California
Yolo,2021-06-13,157,234338,119,110961,37,116973,1,6404,63,15668,93,112241,65,127909,California
Yolo,2021-06-14,413,234751,255,111216,127,117100,31,6435,133,15554,279,112520,165,128074,California
Yolo,2021-06-15,776,235527,405,111621,344,117444,27,6462,212,15233,560,113080,239,128313,California
Yolo,2021-06-16,482,236009,247,111868,193,117637,42,6504,170,15133,310,113390,210,128523,California
Yolo,2021-06-17,500,236509,316,112184,127,117764,57,6561,174,15039,325,113715,231,128754,California
Yolo,2021-06-18,561,237070,401,112585,138,117902,22,6583,207,14916,351,114066,228,128982,California
Yolo,2021-06-19,327,237397,209,112794,100,118002,18,6601,119,14846,207,114273,137,129119,California
Yolo,2021-06-20,116,237513,74,112868,38,118040,4,6605,63,14862,51,114324,67,129186,California
Yolo,2021-06-21,210,237723,91,112959,99,118139,20,6625,114,14902,94,114418,134,129320,California
Yolo,2021-06-22,529,238252,301,113260,209,118348,19,6644,217,14829,310,114728,237,129557,California
Yolo,2021-06-23,378,238630,214,113474,147,118495,17,6661,151,14774,223,114951,168,129725,California
Yolo,2021-06-24,403,239033,249,113723,109,118604,45,6706,176,14769,226,115177,221,129946,California
Yolo,2021-06-25,553,239586,391,114114,119,118723,43,6749,192,14647,357,115534,235,130181,California
Yolo,2021-06-26,276,239862,172,114286,81,118804,23,6772,114,14624,160,115694,137,130318,California
Yolo,2021-06-27,180,240042,143,114429,32,118836,5,6777,64,14576,116,115810,68,130386,California
Yolo,2021-06-28,256,240298,130,114559,53,118889,73,6850,108,14609,147,115957,180,130566,California
Yolo,2021-06-29,424,240722,265,114824,110,118999,49,6899,159,14556,261,116218,208,130774,California
Yolo,2021-06-30,365,241087,204,115028,134,119133,27,6926,132,14482,232,116450,158,130932,California
Yolo,2021-07-01,315,241402,179,115207,104,119237,32,6958,117,14435,195,116645,148,131080,California
Yolo,2021-07-02,348,241750,236,115443,102,119339,10,6968,143,14383,205,116850,153,131233,California
Yolo,2021-07-03,210,241960,132,115575,74,119413,4,6972,92,14363,116,116966,96,131329,California
Yolo,2021-07-04,72,242032,41,115616,26,119439,5,6977,22,14340,50,117016,27,131356,California
Yolo,2021-07-05,144,242176,87,115703,52,119491,5,6982,70,14343,72,117088,75,131431,California
Yolo,2021-07-06,363,242539,241,115944,102,119593,20,7002,137,14278,223,117311,158,131589,California
Yolo,2021-07-07,371,242910,196,116140,110,119703,65,7067,141,14254,229,117540,205,131794,California
Yolo,2021-07-08,348,243258,200,116340,89,119792,59,7126,122,14212,221,117761,179,131973,California
Yolo,2021-07-09,366,243624,252,116592,98,119890,16,7142,142,14152,218,117979,158,132131,California
Yolo,2021-07-10,197,243821,138,116730,44,119934,15,7157,79,14130,116,118095,94,132225,California
Yolo,2021-07-11,80,243901,59,116789,21,119955,0,7157,40,14131,39,118134,40,132265,California
Yolo,2021-07-12,201,244102,144,116933,47,120002,10,7167,94,14130,105,118239,104,132369,California
Yolo,2021-07-13,327,244429,199,117132,96,120098,32,7199,133,14106,179,118418,155,132524,California
Yolo,2021-07-14,239,244668,155,117287,76,120174,8,7207,106,14087,132,118550,113,132637,California
Yolo,2021-07-15,329,244997,243,117530,72,120246,14,7221,146,14064,183,118733,160,132797,California
Yolo,2021-07-16,335,245332,231,117761,94,120340,10,7231,169,14079,163,118896,178,132975,California
Yolo,2021-07-17,210,245542,134,117895,75,120415,1,7232,97,14066,111,119007,98,133073,California
Yolo,2021-07-18,108,245650,73,117968,34,120449,1,7233,51,14062,56,119063,52,133125,California
Yolo,2021-07-19,227,245877,156,118124,65,120514,6,7239,120,14081,107,119170,126,133251,California
Yolo,2021-07-20,349,246226,225,118349,113,120627,11,7250,196,14139,149,119319,207,133458,California
Yolo,2021-07-21,354,246580,193,118542,126,120753,35,7285,161,14144,191,119510,196,133654,California
Yolo,2021-07-22,297,246877,203,118745,86,120839,8,7293,163,14182,133,119643,171,133825,California
Yolo,2021-07-23,355,247232,243,118988,103,120942,9,7302,208,14256,143,119786,217,134042,California
Yolo,2021-07-24,150,247382,94,119082,53,120995,3,7305,80,14270,69,119855,83,134125,California
Yolo,2021-07-25,101,247483,65,119147,35,121030,1,7306,63,14296,38,119893,64,134189,California
Yolo,2021-07-26,253,247736,163,119310,74,121104,16,7322,162,14383,91,119984,178,134367,California
Yolo,2021-07-27,317,248053,210,119520,92,121196,15,7337,185,14452,131,120115,200,134567,California
Yolo,2021-07-28,396,248449,286,119806,95,121291,15,7352,223,14522,168,120283,238,134805,California
Yolo,2021-07-29,393,248842,281,120087,97,121388,15,7367,231,14610,158,120441,246,135051,California
Yolo,2021-07-30,493,249335,329,120416,144,121532,20,7387,305,14758,177,120618,325,135376,California
Yolo,2021-07-31,215,249550,130,120546,78,121610,7,7394,124,14799,90,120708,131,135507,California
Yolo,2021-08-01,117,249667,80,120626,34,121644,3,7397,83,14851,34,120742,86,135593,California
Yolo,2021-08-02,344,250011,223,120849,109,121753,12,7409,204,14930,137,120879,216,135809,California
Yolo,2021-08-03,405,250416,300,121149,84,121837,21,7430,247,15044,154,121033,268,136077,California
Yolo,2021-08-04,381,250797,266,121415,97,121934,18,7448,252,15189,126,121159,271,136348,California
Yolo,2021-08-05,404,251201,277,121692,92,122026,35,7483,226,15275,174,121333,260,136608,California
Yolo,2021-08-06,438,251639,310,122002,108,122134,20,7503,270,15403,161,121494,289,136897,California
Yolo,2021-08-07,218,251857,161,122163,51,122185,6,7509,111,15419,101,121595,117,137014,California
Yolo,2021-08-08,135,251992,92,122255,41,122226,2,7511,83,15455,49,121644,85,137099,California
Yolo,2021-08-09,343,252335,241,122496,77,122303,25,7536,192,15529,143,121787,217,137316,California
Yolo,2021-08-10,390,252725,282,122778,98,122401,10,7546,242,15642,139,121926,252,137568,California
Yolo,2021-08-11,355,253080,268,123046,68,122469,19,7565,215,15740,136,122062,234,137802,California
Yolo,2021-08-12,308,253388,223,123269,75,122544,10,7575,165,15772,143,122205,175,137977,California
Yolo,2021-08-13,567,253955,419,123688,128,122672,20,7595,360,15960,192,122397,380,138357,California
Yolo,2021-08-14,233,254188,137,123825,84,122756,12,7607,119,15991,99,122496,130,138487,California
Yolo,2021-08-15,118,254306,70,123895,45,122801,3,7610,55,16001,48,122544,58,138545,California
Yolo,2021-08-16,355,254661,248,124143,99,122900,8,7618,181,16036,154,122698,189,138734,California
Yolo,2021-08-17,429,255090,283,124426,131,123031,15,7633,223,16099,175,122873,238,138972,California
Yolo,2021-08-18,441,255531,322,124748,104,123135,15,7648,219,16140,194,123067,235,139207,California
Yolo,2021-08-19,416,255947,297,125045,101,123236,18,7666,163,16121,201,123268,182,139389,California
Yolo,2021-08-20,532,256479,373,125418,146,123382,13,7679,223,16118,238,123506,235,139624,California
Yolo,2021-08-21,227,256706,149,125567,75,123457,3,7682,105,16135,91,123597,108,139732,California
Yolo,2021-08-22,134,256840,90,125657,44,123501,0,7682,54,16119,70,123667,54,139786,California
Yolo,2021-08-23,403,257243,265,125922,129,123630,9,7691,166,16120,174,123841,175,139961,California
Yolo,2021-08-24,458,257701,345,126267,107,123737,6,7697,188,16096,218,124059,194,140155,California
Yolo,2021-08-25,467,258168,339,126606,105,123842,23,7720,183,16063,239,124298,206,140361,California
Yolo,2021-08-26,491,258659,369,126975,94,123936,28,7748,216,16088,217,124515,242,140603,California
Yolo,2021-08-27,561,259220,385,127360,157,124093,19,7767,222,16057,272,124787,241,140844,California
Yolo,2021-08-28,276,259496,171,127531,95,124188,10,7777,97,16027,136,124923,106,140950,California
Yolo,2021-08-29,151,259647,95,127626,54,124242,2,7779,67,16027,69,124992,69,141019,California
Yolo,2021-08-30,320,259967,212,127838,104,124346,4,7783,123,16017,137,125129,127,141146,California
Yuba,2020-12-16,4,4,4,4,0,0,0,0,4,4,0,0,4,4,California
Yuba,2020-12-17,4,8,4,8,0,0,0,0,4,8,0,0,4,8,California
Yuba,2020-12-18,8,16,8,16,0,0,0,0,8,16,0,0,8,16,California
Yuba,2020-12-19,12,28,12,28,0,0,0,0,12,28,0,0,12,28,California
Yuba,2020-12-20,19,47,19,47,0,0,0,0,19,47,0,0,19,47,California
Yuba,2020-12-21,43,90,43,90,0,0,0,0,43,90,0,0,43,90,California
Yuba,2020-12-22,81,171,81,171,0,0,0,0,81,171,0,0,81,171,California
Yuba,2020-12-23,65,236,63,234,2,2,0,0,65,236,0,0,65,236,California
Yuba,2020-12-24,21,257,11,245,10,12,0,0,21,257,0,0,21,257,California
Yuba,2020-12-25,1,258,1,246,0,12,0,0,1,258,0,0,1,258,California
Yuba,2020-12-26,14,272,13,259,1,13,0,0,14,272,0,0,14,272,California
Yuba,2020-12-27,15,287,15,274,0,13,0,0,15,287,0,0,15,287,California
Yuba,2020-12-28,50,337,34,308,16,29,0,0,50,337,0,0,50,337,California
Yuba,2020-12-29,76,413,13,321,63,92,0,0,76,413,0,0,76,413,California
Yuba,2020-12-30,65,478,22,343,43,135,0,0,65,478,0,0,65,478,California
Yuba,2020-12-31,39,517,6,349,33,168,0,0,39,517,0,0,39,517,California
Yuba,2021-01-02,21,538,19,368,2,170,0,0,21,538,0,0,21,538,California
Yuba,2021-01-03,10,548,6,374,4,174,0,0,10,548,0,0,10,548,California
Yuba,2021-01-04,93,641,23,397,70,244,0,0,93,641,0,0,93,641,California
Yuba,2021-01-05,74,715,39,436,35,279,0,0,73,713,1,1,73,714,California
Yuba,2021-01-06,154,869,76,512,78,357,0,0,148,855,6,7,148,862,California
Yuba,2021-01-07,77,946,20,532,57,414,0,0,73,924,4,11,73,935,California
Yuba,2021-01-08,77,1023,25,557,52,466,0,0,70,987,7,18,70,1005,California
Yuba,2021-01-09,19,1042,17,574,2,468,0,0,10,988,9,27,10,1015,California
Yuba,2021-01-10,115,1157,22,596,93,561,0,0,94,1061,21,48,94,1109,California
Yuba,2021-01-11,73,1230,50,646,23,584,0,0,33,1054,40,88,33,1142,California
Yuba,2021-01-12,108,1338,76,722,32,616,0,0,45,1036,63,151,45,1187,California
Yuba,2021-01-13,123,1461,75,797,48,664,0,0,56,1026,66,217,56,1243,California
Yuba,2021-01-14,114,1575,43,840,71,735,0,0,103,1118,11,228,103,1346,California
Yuba,2021-01-15,202,1777,87,927,115,850,0,0,192,1300,10,238,192,1538,California
Yuba,2021-01-16,185,1962,21,948,164,1014,0,0,171,1457,14,252,171,1709,California
Yuba,2021-01-17,13,1975,9,957,4,1018,0,0,7,1458,6,258,7,1716,California
Yuba,2021-01-18,60,2035,30,987,30,1048,0,0,36,1470,24,282,36,1752,California
Yuba,2021-01-19,84,2119,33,1020,51,1099,0,0,65,1516,19,301,65,1817,California
Yuba,2021-01-20,138,2257,88,1108,50,1149,0,0,113,1605,25,326,114,1931,California
Yuba,2021-01-21,229,2486,104,1212,125,1274,0,0,220,1816,9,335,220,2151,California
Yuba,2021-01-22,106,2592,7,1219,99,1373,0,0,97,1904,9,344,97,2248,California
Yuba,2021-01-23,203,2795,7,1226,196,1569,0,0,201,2103,2,346,201,2449,California
Yuba,2021-01-24,11,2806,8,1234,3,1572,0,0,9,2110,2,348,9,2458,California
Yuba,2021-01-25,87,2893,31,1265,56,1628,0,0,54,2132,32,380,54,2512,California
Yuba,2021-01-26,148,3041,40,1305,108,1736,0,0,92,2168,56,436,92,2604,California
Yuba,2021-01-27,187,3228,130,1435,57,1793,0,0,119,2219,68,504,119,2723,California
Yuba,2021-01-28,230,3458,93,1528,137,1930,0,0,177,2343,53,557,177,2900,California
Yuba,2021-01-29,154,3612,46,1574,108,2038,0,0,113,2415,41,598,113,3013,California
Yuba,2021-01-30,407,4019,23,1597,384,2422,0,0,396,2800,11,609,396,3409,California
Yuba,2021-01-31,17,4036,11,1608,6,2428,0,0,15,2813,2,611,15,3424,California
Yuba,2021-02-01,161,4197,76,1684,85,2513,0,0,132,2918,28,639,133,3557,California
Yuba,2021-02-02,128,4325,21,1705,107,2620,0,0,102,2994,26,665,102,3659,California
Yuba,2021-02-03,235,4560,30,1735,205,2825,0,0,120,3000,114,779,120,3779,California
Yuba,2021-02-04,296,4856,117,1852,179,3004,0,0,249,3202,47,826,249,4028,California
Yuba,2021-02-05,161,5017,35,1887,126,3130,0,0,79,3200,81,907,79,4107,California
Yuba,2021-02-06,452,5469,23,1910,429,3559,0,0,444,3636,8,915,444,4551,California
Yuba,2021-02-07,20,5489,14,1924,6,3565,0,0,16,3648,4,919,16,4567,California
Yuba,2021-02-08,100,5589,35,1959,65,3630,0,0,69,3686,31,950,69,4636,California
Yuba,2021-02-09,164,5753,60,2019,104,3734,0,0,91,3704,73,1023,91,4727,California
Yuba,2021-02-10,368,6121,178,2197,190,3924,0,0,128,3595,237,1260,128,4855,California
Yuba,2021-02-11,408,6529,67,2264,341,4265,0,0,305,3799,101,1361,305,5160,California
Yuba,2021-02-12,274,6803,26,2290,248,4513,0,0,158,3841,116,1477,158,5318,California
Yuba,2021-02-13,442,7245,36,2326,406,4919,0,0,391,4181,51,1528,391,5709,California
Yuba,2021-02-14,53,7298,11,2337,42,4961,0,0,47,4222,6,1534,47,5756,California
Yuba,2021-02-15,92,7390,37,2374,55,5016,0,0,72,4274,20,1554,72,5828,California
Yuba,2021-02-16,205,7595,56,2430,149,5165,0,0,145,4359,60,1614,145,5973,California
Yuba,2021-02-17,386,7981,156,2586,230,5395,0,0,103,4180,282,1896,103,6076,California
Yuba,2021-02-18,334,8315,54,2640,280,5675,0,0,201,4248,133,2029,201,6277,California
Yuba,2021-02-19,226,8541,77,2717,149,5824,0,0,139,4301,86,2115,139,6416,California
Yuba,2021-02-20,402,8943,29,2746,373,6197,0,0,344,4587,58,2173,344,6760,California
Yuba,2021-02-21,26,8969,15,2761,11,6208,0,0,15,4591,11,2184,15,6775,California
Yuba,2021-02-22,132,9101,81,2842,51,6259,0,0,40,4539,92,2276,40,6815,California
Yuba,2021-02-23,135,9236,30,2872,105,6364,0,0,55,4516,79,2355,56,6871,California
Yuba,2021-02-24,505,9741,145,3017,360,6724,0,0,108,4227,397,2752,108,6979,California
Yuba,2021-02-25,365,10106,139,3156,226,6950,0,0,229,4320,136,2888,229,7208,California
Yuba,2021-02-26,273,10379,75,3231,198,7148,0,0,146,4341,125,3013,146,7354,California
Yuba,2021-02-27,475,10854,51,3282,424,7572,0,0,390,4646,85,3098,390,7744,California
Yuba,2021-02-28,77,10931,23,3305,54,7626,0,0,55,4679,22,3120,55,7799,California
Yuba,2021-03-01,173,11104,48,3353,125,7751,0,0,91,4689,81,3201,91,7890,California
Yuba,2021-03-02,179,11283,45,3398,134,7885,0,0,89,4688,90,3291,89,7979,California
Yuba,2021-03-03,664,11947,164,3562,500,8385,0,0,204,4433,459,3750,204,8183,California
Yuba,2021-03-04,489,12436,283,3845,206,8591,0,0,340,4625,148,3898,340,8523,California
Yuba,2021-03-05,332,12768,58,3903,273,8864,1,1,258,4810,74,3972,259,8782,California
Yuba,2021-03-06,479,13247,32,3935,443,9307,4,5,371,5078,107,4079,375,9157,California
Yuba,2021-03-07,60,13307,31,3966,27,9334,2,7,43,5106,17,4096,45,9202,California
Yuba,2021-03-08,167,13474,52,4018,99,9433,16,23,103,5161,64,4160,119,9321,California
Yuba,2021-03-09,186,13660,48,4066,118,9551,20,43,89,5173,97,4257,109,9430,California
Yuba,2021-03-10,748,14408,237,4303,481,10032,30,73,243,4941,505,4762,273,9703,California
Yuba,2021-03-11,455,14863,205,4508,237,10269,13,86,300,5100,154,4916,313,10016,California
Yuba,2021-03-12,473,15336,84,4592,336,10605,53,139,160,5000,313,5229,213,10229,California
Yuba,2021-03-13,473,15809,340,4932,118,10723,15,154,369,5281,103,5332,384,10613,California
Yuba,2021-03-14,110,15919,20,4952,81,10804,9,163,49,5279,60,5392,58,10671,California
Yuba,2021-03-15,202,16121,55,5007,132,10936,15,178,107,5306,95,5487,122,10793,California
Yuba,2021-03-16,315,16436,82,5089,209,11145,24,202,199,5414,115,5602,223,11016,California
Yuba,2021-03-17,758,17194,172,5261,555,11700,31,233,200,5090,555,6157,231,11247,California
Yuba,2021-03-18,593,17787,162,5423,315,12015,116,349,363,5338,230,6387,478,11725,California
Yuba,2021-03-19,334,18121,118,5541,162,12177,54,403,184,5426,149,6536,237,11962,California
Yuba,2021-03-20,566,18687,84,5625,463,12640,19,422,480,5840,85,6621,499,12461,California
Yuba,2021-03-21,67,18754,40,5665,27,12667,0,422,45,5863,22,6643,45,12506,California
Yuba,2021-03-22,200,18954,73,5738,119,12786,8,430,153,5977,47,6690,161,12667,California
Yuba,2021-03-23,279,19233,83,5821,168,12954,28,458,186,6101,90,6780,214,12881,California
Yuba,2021-03-24,771,20004,257,6078,433,13387,81,539,187,5787,582,7362,268,13149,California
Yuba,2021-03-25,525,20529,276,6354,226,13613,23,562,257,5799,268,7630,280,13429,California
Yuba,2021-03-26,404,20933,141,6495,232,13845,31,593,229,5885,174,7804,260,13689,California
Yuba,2021-03-27,467,21400,30,6525,434,14279,3,596,415,6251,51,7855,417,14106,California
Yuba,2021-03-28,109,21509,44,6569,61,14340,4,600,37,6220,72,7927,41,14147,California
Yuba,2021-03-29,306,21815,90,6659,184,14524,32,632,183,6312,123,8050,215,14362,California
Yuba,2021-03-30,286,22101,74,6733,203,14727,9,641,194,6423,91,8141,202,14564,California
Yuba,2021-03-31,695,22796,122,6855,562,15289,11,652,244,6229,449,8590,255,14819,California
Yuba,2021-04-01,641,23437,295,7150,317,15606,29,681,290,6198,350,8940,319,15138,California
Yuba,2021-04-02,530,23967,105,7255,340,15946,85,766,202,6157,327,9267,286,15424,California
Yuba,2021-04-03,666,24633,58,7313,117,16063,491,1257,89,6161,576,9843,580,16004,California
Yuba,2021-04-04,60,24693,12,7325,41,16104,7,1264,30,6168,30,9873,37,16041,California
Yuba,2021-04-05,259,24952,88,7413,148,16252,23,1287,126,6185,131,10004,148,16189,California
Yuba,2021-04-06,361,25313,118,7531,182,16434,61,1348,171,6227,189,10193,231,16420,California
Yuba,2021-04-07,794,26107,409,7940,331,16765,54,1402,361,6211,430,10623,414,16834,California
Yuba,2021-04-08,774,26881,303,8243,202,16967,269,1671,283,6272,490,11113,551,17385,California
Yuba,2021-04-09,417,27298,173,8416,175,17142,69,1740,173,6271,243,11356,242,17627,California
Yuba,2021-04-10,612,27910,73,8489,88,17230,451,2191,73,6256,537,11893,522,18149,California
Yuba,2021-04-11,111,28021,27,8516,72,17302,12,2203,48,6254,62,11955,60,18209,California
Yuba,2021-04-12,220,28241,49,8565,137,17439,34,2237,81,6230,138,12093,114,18323,California
Yuba,2021-04-13,409,28650,107,8672,302,17741,0,2237,199,6220,209,12302,199,18522,California
Yuba,2021-04-14,724,29374,110,8782,614,18355,0,2237,130,5758,592,12894,130,18652,California
Yuba,2021-04-15,351,29725,134,8916,217,18572,0,2237,152,5712,198,13092,152,18804,California
Yuba,2021-04-16,355,30080,102,9018,253,18825,0,2237,186,5731,167,13259,186,18990,California
Yuba,2021-04-17,417,30497,62,9080,355,19180,0,2237,345,6005,71,13330,345,19335,California
Yuba,2021-04-18,70,30567,22,9102,48,19228,0,2237,36,6008,33,13363,36,19371,California
Yuba,2021-04-19,251,30818,107,9209,144,19372,0,2237,102,5961,149,13512,102,19473,California
Yuba,2021-04-20,353,31171,106,9315,247,19619,0,2237,188,5988,162,13674,189,19662,California
Yuba,2021-04-21,751,31922,326,9641,425,20044,0,2237,323,5883,428,14102,323,19985,California
Yuba,2021-04-22,383,32305,157,9798,226,20270,0,2237,207,5914,176,14278,207,20192,California
Yuba,2021-04-23,382,32687,132,9930,250,20520,0,2237,176,5886,204,14482,176,20368,California
Yuba,2021-04-24,224,32911,69,9999,155,20675,0,2237,123,5908,101,14583,123,20491,California
Yuba,2021-04-25,78,32989,31,10030,47,20722,0,2237,36,5902,42,14625,36,20527,California
Yuba,2021-04-26,261,33250,70,10100,187,20909,4,2241,118,5881,143,14768,122,20649,California
Yuba,2021-04-27,501,33751,175,10275,315,21224,11,2252,248,5889,251,15019,259,20908,California
Yuba,2021-04-28,461,34212,192,10467,264,21488,5,2257,160,5758,296,15315,165,21073,California
Yuba,2021-04-29,473,34685,94,10561,378,21866,1,2258,163,5613,309,15624,164,21237,California
Yuba,2021-04-30,358,35043,109,10670,218,22084,31,2289,153,5594,203,15827,184,21421,California
Yuba,2021-05-01,218,35261,96,10766,103,22187,19,2308,102,5600,115,15942,121,21542,California
Yuba,2021-05-02,72,35333,41,10807,27,22214,4,2312,38,5608,34,15976,42,21584,California
Yuba,2021-05-03,170,35503,69,10876,93,22307,8,2320,55,5558,113,16089,63,21647,California
Yuba,2021-05-04,351,35854,111,10987,218,22525,22,2342,159,5547,192,16281,181,21828,California
Yuba,2021-05-05,341,36195,97,11084,237,22762,7,2349,121,5455,220,16501,128,21956,California
Yuba,2021-05-06,305,36500,125,11209,141,22903,39,2388,103,5398,199,16700,142,22098,California
Yuba,2021-05-07,379,36879,104,11313,247,23150,28,2416,120,5286,259,16959,147,22245,California
Yuba,2021-05-08,138,37017,58,11371,74,23224,6,2422,58,5270,80,17039,64,22309,California
Yuba,2021-05-09,56,37073,25,11396,28,23252,3,2425,33,5283,23,17062,36,22345,California
Yuba,2021-05-10,173,37246,54,11450,101,23353,18,2443,53,5236,118,17180,71,22416,California
Yuba,2021-05-11,393,37639,180,11630,200,23553,13,2456,139,5136,251,17431,151,22567,California
Yuba,2021-05-12,280,37919,149,11779,123,23676,8,2464,104,5072,176,17607,112,22679,California
Yuba,2021-05-13,370,38289,196,11975,129,23805,45,2509,112,4974,255,17862,157,22836,California
Yuba,2021-05-14,380,38669,140,12115,219,24024,21,2530,155,4925,224,18086,175,23011,California
Yuba,2021-05-15,450,39119,115,12230,312,24336,23,2553,113,4725,335,18421,135,23146,California
Yuba,2021-05-16,159,39278,53,12283,97,24433,9,2562,96,4768,62,18483,105,23251,California
Yuba,2021-05-17,222,39500,92,12375,110,24543,20,2582,90,4748,130,18613,110,23361,California
Yuba,2021-05-18,398,39898,165,12540,224,24767,9,2591,166,4691,232,18845,175,23536,California
Yuba,2021-05-19,259,40157,145,12685,108,24875,6,2597,129,4696,130,18975,135,23671,California
Yuba,2021-05-20,441,40598,312,12997,116,24991,13,2610,264,4796,177,19152,277,23948,California
Yuba,2021-05-21,524,41122,276,13273,241,25232,7,2617,314,4909,208,19360,321,24269,California
Yuba,2021-05-22,232,41354,125,13398,98,25330,9,2626,93,4872,139,19499,102,24371,California
Yuba,2021-05-23,75,41429,42,13440,31,25361,2,2628,38,4876,36,19535,40,24411,California
Yuba,2021-05-24,165,41594,56,13496,92,25453,17,2645,47,4824,117,19652,65,24476,California
Yuba,2021-05-25,324,41918,112,13608,195,25648,17,2662,112,4743,209,19861,128,24604,California
Yuba,2021-05-26,249,42167,110,13718,123,25771,16,2678,93,4697,155,20016,109,24713,California
Yuba,2021-05-27,251,42418,76,13794,163,25934,12,2690,100,4661,148,20164,112,24825,California
Yuba,2021-05-28,254,42672,113,13907,134,26068,7,2697,120,4656,132,20296,127,24952,California
Yuba,2021-05-29,169,42841,68,13975,79,26147,22,2719,89,4688,79,20375,111,25063,California
Yuba,2021-05-30,55,42896,25,14000,25,26172,5,2724,23,4684,32,20407,28,25091,California
Yuba,2021-05-31,30,42926,3,14003,20,26192,7,2731,10,4682,19,20426,17,25108,California
Yuba,2021-06-01,253,43179,105,14108,140,26332,8,2739,87,4614,161,20587,93,25201,California
Yuba,2021-06-02,206,43385,81,14189,118,26450,7,2746,59,4536,145,20732,67,25268,California
Yuba,2021-06-03,183,43568,107,14296,70,26520,6,2752,63,4487,118,20850,69,25337,California
Yuba,2021-06-04,246,43814,119,14415,116,26636,11,2763,79,4412,164,21014,89,25426,California
Yuba,2021-06-05,199,44013,149,14564,44,26680,6,2769,89,4398,109,21123,95,25521,California
Yuba,2021-06-06,112,44125,95,14659,14,26694,3,2772,21,4332,90,21213,24,25545,California
Yuba,2021-06-07,119,44244,51,14710,51,26745,17,2789,38,4306,81,21294,55,25600,California
Yuba,2021-06-08,248,44492,115,14825,124,26869,9,2798,71,4211,175,21469,80,25680,California
Yuba,2021-06-09,172,44664,102,14927,62,26931,8,2806,71,4190,99,21568,78,25758,California
Yuba,2021-06-10,392,45056,310,15237,73,27004,9,2815,99,4008,290,21858,108,25866,California
Yuba,2021-06-11,342,45398,245,15482,85,27089,12,2827,73,3826,268,22126,86,25952,California
Yuba,2021-06-12,132,45530,91,15573,35,27124,6,2833,36,3772,96,22222,42,25994,California
Yuba,2021-06-13,48,45578,21,15594,25,27149,2,2835,13,3753,34,22256,15,26009,California
Yuba,2021-06-14,116,45694,57,15651,49,27198,10,2845,35,3718,80,22336,45,26054,California
Yuba,2021-06-15,243,45937,99,15750,136,27334,8,2853,93,3672,147,22483,101,26155,California
Yuba,2021-06-16,158,46095,97,15847,51,27385,10,2863,73,3672,83,22566,83,26238,California
Yuba,2021-06-17,199,46294,116,15963,71,27456,12,2875,86,3657,113,22679,98,26336,California
Yuba,2021-06-18,226,46520,111,16074,94,27550,21,2896,74,3602,150,22829,95,26431,California
Yuba,2021-06-19,134,46654,66,16140,61,27611,7,2903,32,3539,102,22931,39,26470,California
Yuba,2021-06-20,33,46687,19,16159,11,27622,3,2906,13,3535,20,22951,16,26486,California
Yuba,2021-06-21,90,46777,39,16198,42,27664,9,2915,45,3547,41,22992,53,26539,California
Yuba,2021-06-22,178,46955,74,16272,92,27756,12,2927,71,3524,105,23097,82,26621,California
Yuba,2021-06-23,126,47081,71,16343,42,27798,13,2940,51,3513,74,23171,63,26684,California
Yuba,2021-06-24,139,47220,84,16427,47,27845,8,2948,59,3500,80,23251,67,26751,California
Yuba,2021-06-25,168,47388,96,16523,63,27908,9,2957,82,3505,86,23337,91,26842,California
Yuba,2021-06-26,132,47520,105,16628,26,27934,1,2958,43,3461,88,23425,44,26886,California
Yuba,2021-06-27,64,47584,42,16670,20,27954,2,2960,36,3471,28,23453,38,26924,California
Yuba,2021-06-28,61,47645,35,16705,24,27978,2,2962,29,3470,32,23485,31,26955,California
Yuba,2021-06-29,162,47807,85,16790,68,28046,9,2971,61,3440,100,23585,70,27025,California
Yuba,2021-06-30,140,47947,81,16871,52,28098,7,2978,72,3451,68,23653,79,27104,California
Yuba,2021-07-01,125,48072,86,16957,31,28129,8,2986,47,3430,76,23729,55,27159,California
Yuba,2021-07-02,128,48200,55,17012,58,28187,15,3001,42,3401,86,23815,57,27216,California
Yuba,2021-07-03,66,48266,44,17056,22,28209,0,3001,36,3407,30,23845,36,27252,California
Yuba,2021-07-04,6,48272,3,17059,3,28212,0,3001,3,3407,3,23848,3,27255,California
Yuba,2021-07-05,68,48340,47,17106,16,28228,5,3006,38,3420,30,23878,43,27298,California
Yuba,2021-07-06,174,48514,94,17200,66,28294,14,3020,65,3396,103,23981,79,27377,California
Yuba,2021-07-07,144,48658,96,17296,37,28331,11,3031,56,3376,87,24068,67,27444,California
Yuba,2021-07-08,150,48808,88,17384,43,28374,19,3050,58,3361,92,24160,77,27521,California
Yuba,2021-07-09,164,48972,97,17481,53,28427,14,3064,82,3375,82,24242,96,27617,California
Yuba,2021-07-10,87,49059,57,17538,29,28456,1,3065,59,3407,28,24270,60,27677,California
Yuba,2021-07-11,36,49095,17,17555,18,28474,1,3066,15,3402,21,24291,16,27693,California
Yuba,2021-07-12,98,49193,59,17614,24,28498,15,3081,39,3397,59,24350,54,27747,California
Yuba,2021-07-13,128,49321,70,17684,49,28547,9,3090,57,3392,71,24421,66,27813,California
Yuba,2021-07-14,96,49417,60,17744,30,28577,6,3096,48,3398,48,24469,54,27867,California
Yuba,2021-07-15,114,49531,62,17806,44,28621,8,3104,48,3390,64,24533,56,27923,California
Yuba,2021-07-16,158,49689,92,17898,51,28672,15,3119,78,3405,78,24611,93,28016,California
Yuba,2021-07-17,65,49754,40,17938,23,28695,2,3121,34,3410,31,24642,36,28052,California
Yuba,2021-07-18,51,49805,27,17965,19,28714,5,3126,27,3418,24,24666,32,28084,California
Yuba,2021-07-19,72,49877,29,17994,33,28747,10,3136,33,3423,38,24704,43,28127,California
Yuba,2021-07-20,171,50048,97,18091,69,28816,5,3141,88,3434,82,24786,93,28220,California
Yuba,2021-07-21,155,50203,71,18162,55,28871,29,3170,74,3455,81,24867,102,28322,California
Yuba,2021-07-22,148,50351,85,18247,48,28919,15,3185,76,3480,66,24933,91,28413,California
Yuba,2021-07-23,143,50494,70,18317,68,28987,5,3190,82,3506,61,24994,87,28500,California
Yuba,2021-07-24,121,50615,80,18397,32,29019,9,3199,74,3541,48,25042,83,28583,California
Yuba,2021-07-25,55,50670,32,18429,18,29037,5,3204,32,3555,23,25065,37,28620,California
Yuba,2021-07-26,150,50820,86,18515,51,29088,13,3217,92,3602,58,25123,105,28725,California
Yuba,2021-07-27,188,51008,101,18616,79,29167,8,3225,121,3665,66,25189,129,28854,California
Yuba,2021-07-28,203,51211,122,18738,78,29245,3,3228,142,3750,60,25249,145,28999,California
Yuba,2021-07-29,184,51395,98,18836,64,29309,22,3250,114,3816,69,25318,135,29134,California
Yuba,2021-07-30,240,51635,138,18974,73,29382,29,3279,154,3915,84,25402,183,29317,California
Yuba,2021-07-31,141,51776,100,19074,35,29417,6,3285,87,3954,54,25456,93,29410,California
Yuba,2021-08-01,43,51819,30,19104,12,29429,1,3286,34,3980,9,25465,35,29445,California
Yuba,2021-08-02,136,51955,84,19188,41,29470,11,3297,90,4036,44,25509,100,29545,California
Yuba,2021-08-03,200,52155,108,19296,78,29548,14,3311,125,4102,73,25582,139,29684,California
Yuba,2021-08-04,177,52332,100,19396,66,29614,11,3322,116,4168,60,25642,126,29810,California
Yuba,2021-08-05,171,52503,104,19500,50,29664,17,3339,112,4238,59,25701,129,29939,California
Yuba,2021-08-06,228,52731,126,19626,81,29745,21,3360,143,4318,84,25785,164,30103,California
Yuba,2021-08-07,133,52864,89,19715,38,29783,6,3366,85,4362,47,25832,91,30194,California
Yuba,2021-08-08,88,52952,55,19770,29,29812,4,3370,61,4400,27,25859,65,30259,California
Yuba,2021-08-09,156,53108,97,19867,51,29863,8,3378,107,4467,48,25907,115,30374,California
Yuba,2021-08-10,192,53300,102,19969,72,29935,18,3396,106,4504,86,25993,123,30497,California
Yuba,2021-08-11,201,53501,110,20079,72,30007,19,3415,132,4587,67,26060,150,30647,California
Yuba,2021-08-12,179,53680,92,20171,77,30084,10,3425,109,4638,67,26127,118,30765,California
Yuba,2021-08-13,233,53913,144,20315,77,30161,12,3437,154,4725,79,26206,166,30931,California
Yuba,2021-08-14,138,54051,90,20405,47,30208,1,3438,75,4740,61,26267,76,31007,California
Yuba,2021-08-15,85,54136,57,20462,28,30236,0,3438,61,4779,22,26289,61,31068,California
Yuba,2021-08-16,217,54353,100,20562,97,30333,20,3458,137,4860,76,26365,157,31225,California
Yuba,2021-08-17,190,54543,97,20659,88,30421,5,3463,113,4906,72,26437,118,31343,California
Yuba,2021-08-18,248,54791,127,20786,109,30530,12,3475,135,4948,105,26542,147,31490,California
Yuba,2021-08-19,217,55008,115,20901,86,30616,16,3491,115,4986,93,26635,131,31621,California
Yuba,2021-08-20,282,55290,174,21075,92,30708,16,3507,132,4995,139,26774,148,31769,California
Yuba,2021-08-21,146,55436,87,21162,51,30759,8,3515,67,4996,74,26848,75,31844,California
Yuba,2021-08-22,94,55530,63,21225,30,30789,1,3516,64,5038,24,26872,66,31910,California
Yuba,2021-08-23,232,55762,120,21345,102,30891,10,3526,123,5075,97,26969,134,32044,California
Yuba,2021-08-24,254,56016,135,21480,104,30995,15,3541,127,5104,113,27082,142,32186,California
Yuba,2021-08-25,221,56237,133,21613,80,31075,8,3549,125,5148,89,27171,133,32319,California
Yuba,2021-08-26,252,56489,155,21768,79,31154,18,3567,127,5173,120,27291,145,32464,California
Yuba,2021-08-27,289,56778,188,21956,94,31248,7,3574,117,5141,158,27449,126,32590,California
Yuba,2021-08-28,156,56934,104,22060,51,31299,1,3575,64,5121,85,27534,65,32655,California
Yuba,2021-08-29,106,57040,79,22139,25,31324,2,3577,57,5132,48,27582,59,32714,California
Yuba,2021-08-30,120,57160,51,22190,57,31381,12,3589,50,5133,60,27642,61,32775,California
